--------------------------------------------------------------------------------------------------------------------------------------------------------------------------------------------------------
---------------------------------------------------------------------------------------------------------------------------------------------------------------------------B----------------------------
--------------------------------------------------------------------------------------------------------------------------------------------------------------------------------------------------------
--------------------------------------------------------------------------------------------------------------------------------------------------------------------------------------------------------
--------------------------------------------------------------------------------------------------------------------------------------------------------------------------------------------------------
----XXXXXXXXXX------------------------------------------------------------------------------------------------------------------------------------------------------------------------------------------
--------------------------------------------------------------------------------------------------------------------------------------------------------------------------------------------------------
--B---------------------------------------------------------------------------------------------------------------------------------------------------XXXX---------------------------------------------v
---------------------------------------------------------------------------------------------------------------------------------------------------------------------XXXXXX----------------------------f
-----------------------------------------------------------------------------------------------------------------------------------------------------------------------------------------------------X-f
-------------------------------------------------------------------------------------------------------------------------------------------------------------------------------------------------------f
--T----------------------------------------------------------------------------------------------------------------------------------------------------------------------------------------------------f
--|-------------------------------------------------------------------------------------------------------------------------------------------------------------BBBBBB---------------------T-----------f
--|----------------------------------------------------------------------------------------------------------------------------------------------------------------------------------------|--XXXXXXX--f
m-|----------------------------------------------------------------------------------------------------------------------------------------------------------BBBB--------------------------|-----------X
XX|------XXXXXXXXXXXXXXXXXXXXXXXXXXXXXXXXXXXXXXXXXXXXXXXXXXXXXXXXXXXXXXXXXXXXXXXXXXXXXXXXXXXXXXXXXXXXXXXXXXXXXXXXXXXXXXXXXXXXXXXXXXXXXXXXXXXXXXXXXXXXXXXXXXXXXXXXXXXXXXXXXXXXXXXXXXXXXXXXXX|XXXXXXXXXXXX
