----------------o---------------o-o--o---B--X-o---Bo--------X-o----o----------------------B---E--oB--------o----o----B--o---o----------------B----------BB---Bo----B--o--BXo------o----o---o-------o--B-
-B--E-------B--o----ooo----o--o--o---X-----o--B---Bo-o------Boo-o------B----B-----------o-----B--B---o----------oo------------B------o--X-B--------X-o--XX-oBo---o----o------o-o-o-o--X-B----o----------
-B--B----------o----------o---X-B---o--------oB-----------B-o--ooo----o---X-B-B--------oT---o------X-----B---T-o---o----B----------------o-------------X-X----B----------Xo----------B--Bo-B--ooT-o-----
oX---------B------------------B-oo-o--------------o-X-------B---X-----------------B---o-|--o--------B-----oBE|-------------o-----o---o?------B---------X---B----X--o--------o--X------o---------|-o-B---
X------oE---o-----X---?------------o-------X-o------X-----B-----------B---o-------XX----|-o-o-------------o-X|-------------BB---o---------E--o---o-----BX-------------o--o--o---------T-----B---|-----o-
-E------B-XB---B----o----------------------X---------------T-----------------B--BB------|---o----------------|-X-o---Bo-E----B--o-----o---B-------X---oo-------oB---B--------X-----E--|---------|-Boo-o-
-B-Xo--B------B------Bo--B-oXo-------------ooo--oo---------|------o----B-o------X-X-----|-o---o--------------|------o-o-X-o----------Bo---------oB--o---------BB-------------------B--|-X--o----|----o--
---------------B-o-----------X--o-B--o-?-o--o-----------Xoo|---o--Bo----o-oo---------X--|-----o--o---B--o--Xo|-o---o--o-B---o-------B---o-------X------o--------o---o--B--------------|---T-o---|-----ov
--X-------X---------o------------o-o-----B-o------o----o-o-|------B--B----B----B--------|-o----X-o-X------ooo|-----XXB-----o--Bo----E-o------B------o--------B----------o---o-X--Bo--o|---|--oB-|----o-f
o-------------------BX----------X-----o--------B-o--oo-X---|-----------B--B-B-------X---|-o--B-o--------B---o|--------o--B--o---ooB-Xo----XBo-B---o-----------oo-----------o--X-------|-o-|-oo--|------f
---------B---o-o-o------B--------oo------B-X---Xo----------|-X-BX---X---o-B-------------|------o-X-----------|------------------X--o--X----oX--------X----B-X----Bo-------------------|-o-|-----|------f
------------B--X---------------B-----o---------X-B-B--o--o-|------o---o-------o--------B|-------o--oX--------|--------------o-----B-----B--------o-B---o----------B-----B--B-------X--|-BB|-o--o|------f
o-B----B----B------------oT---BB---o---oo-----B--------XB-B|-----X-----o-o--------------|-B-o---Bo----------o|-----o------------------------o--------oo-------Bo----B---o---oo?--o-B--|---|-o-X-|----X-f
-X--o-o----o-o-----BB-----|--oX-------o---B-----oo-----o---|-------o--o---B-----oB---o--|--B--B--B----oo-o---|----Bo---X--B---o-----o-X--o-X-----B-------------------?--B-T-----------|---|-----|----oBf
m-----------BB--o---------|--o---X----B--o-E----oXB--E-Bo--|------o---B-------X-------B-|---o-X---B-oo-XE--o-|-X-----B------------oo------o---------------E-----B-----B--E|---------B-|---|-----|------X
XXXXXXXXXXXXXXXXXXXXXXXXXXXXXXXXXXXXXXXXXXXXXXXXXXXXXXXXXXXXXXXXXXXXXXXXXXXXXXXXXXXXXXXXXXXXXXXXXXXXXXXXXXXXXXXXXXXXXXXXXXXXXXXXXXXXXXXXXXXXXXXXXXXXXXXXXXXXXXXXXXXXXXXXXXXXXXXXXXXXXXXXXXXXXXXXXXXXXXXX
