--------------------------------------------------------------------------------------------------------------------------------------------------------------------------------------------------------
------------------------------------------------------------------------------------B-------------------------------------------------------------------------------------------------------------------
-------------------------------X--------X------------------------B---------------------------------------------------------------B----------------------------------------------------------------------
--------------------------????????-----------------------------o----------------------------------------------------------------------------------------------------------------------------------------
----------X---------------------------------------------------------------------------------------------------------------------------------------------------------------------------------------------
-----------------------------------------------------X-B--------B---------------------------------------------------------------------------------------------------------------------------------------
----------------????????X-------------------------X-----------------------------------------------------------------M-----------------------------------------------------------------------------------
-------------------------------------------X--------X------------------??--------------------T--------B--------BBBBBB----------------------------------------------------------------------------------v
----------------------------------?----------------------------------------------------------|---------------------------------------------------------------------------------------------------------f
--------------????-----------------B---------------------------------------------------------|---------------------------------------------------------------------------------------------------------f
----------------B---------------??--------------------X--------------------B-----------------|--------------------------------------------------------------------------------------------------X------f
----------------------X----------------------------------------------------------------------|------X--------------------------------------------------------------------------------------------------f
----------B----------XX--o---X---------------------------------------???????-----B-----------|---------------------------------------------------------------------------------------------------------f
-------------X------XXX--------------X---------------------------B----------------X----------|---------------------------------------------------------------------------------------------------------f
m-----------E------XXXX--E-----------------B-------B------------B-----------------XX---------|---E-----------------------------E-----------------------------------------------------------------------X
XXXXXXXXXXXXXXXX--XXXXX---X--------XXXXXXXXXXXXXXXXXXXXXXXXXXXXXXXXXXXXXXXXXXXXXXXXXXXXXXXXXX|XXXXXXXXXXXXXXXXXXXXXXXXXXXXXXXXXXXXXXXXXXXXXXXXXXXXXXXXXXXXXXXXXXXXXXXXXXXXXXXXXXXXXXXXXXXXXXXXXXXXXXXXXX
