--------------------------------------------------------------------------------------------------------------------------------------------------------------------------------------------------------
-------------------------------------------------------------------------------------------------------------------------------------------------------------------------------------------------o------
--------------------------------------------------------------------------------------------------------------------------------------------------------------------------------------------?-----------
-------------------------------------------------------------------------------------------------------------------------------------------------------------------X---------------------------------B--
--------------------------------------------------------------------------------------------------------------------------------------------------------------------------------------------------B-----
--------------------------------------------------------------------------------------------------------------------------------------------------------------------------------------------------------
-B--------------------------------------------------------------------------------------------------------------------------------------------------------------o-------------------B-------------------
-------------------------------------------------------------------------------------------------------------------------------------------------------------------------------------------------------v
-------------------------------------------------------------------------------------------------------------------------------------------------------------------------------------------------------f
-------------------------------------------------------------------------------------------------------------------------------------------------------------------------------------------------------f
-----------------------------------------------------------------------------------------------------------------------------------------------------------------------------------------------?-------f
-----------------------------------------------------------------------------------------------------------------------------------------------------------------------------------------XT-?----------f
------------------------------------------------------------------------------------------------------------------------------------------------------------------------------M---------XX|------------f
---------------------------------------------------------------------------------------------------------------------------------------------------------------------------------------XXX|------------f
m--------E-----X----------------------------------------------------------------------------------------------------------------------------------------------------------------------XXXX|------------X
XXXXXXXXXXXXXXXXXXXXXXXXXXXXXXXXXXXXXXXXXXXXXXXXXXXXXXXXXXXXXXXXXXXXXXXXXXXXXXXXXXXXXXXXXXXXXXXXXXXXXXXXXXXXXXXXXXXXXXXXXXXXXXXXXXXXXXXXXXXXXXXXXXXXXXXXXXXXXXXXXXXXXXXXXXXXXXXXXXXXXXXXXX|XXXXXXXXXXXXX
