-----B--------------------------------B---------------------------------X------------------------X------------------------------------X-------------------------------------------X---------------------
-----------------------------------------------------------------------------X------------------------------------------------------------------------X-------------------------------------------------
--------X------------------B----------------------------------------------------------------------------X-------------------------------------------------------B-B-------------------------------------
--------------------------------------------------------------------------------B--------------X---------------------------------------------------------------X----------------B-----------------------
---------B-------------B------------X-------B---------------------------------------------X----------------------X----------------------------------------------------------------------------------X---
---------X--------X-------------------------------------------X---------B------------------------------------B---------B--------------------------------------------------------------------------------
---------------------------X-------------------------------------------------------------------X------------------------------------------------------------B----------B----------------X---------------
-X------B----------------------------X----------------------------------------------------------------------------B--------------------X---------------------------------------------------------------v
---------------X--------B----X-B------------------------------------------------------------------X-------------------------B------B-BB----------------------------X-----X-----------X-----------------f
---X--X------------X-----B-----------------------B-X-B---------X--X---B-B---------------------------B--------------B-------X--BX---------------------------X-------------------------------B--X--------f
--------------------------------------------------------------------B---------------------B-----B-------X------------------------------B-B-B-----------------------X-----------------------------------f
------------------------X--------------B----B--------------------------B--------------------------------------------------X---------------------------------------------------------------X------------f
------------X---X-X------------------------X----------X----------------------------------------------------------------X-------B---------B-----------------------X------------------------------------Xf
----X-----------X-----B--B--------------------X--------------------------------------B-------X--------X--------------------------------------------------------------X---------------------------------f
m-----------------------------------------B-B----------------------X-----------------X---------------------------------------------------------------------------------B--------------X----------------X
XXXXXXXXXXXXXXXXXXXXXXXXXXXXXXXXXXXXXXXXXXXXXXXXXXXXXXXXXXXXXXXXXXXXXBXXXXXXXXXXXXXXXXXXXXXXXXXXXXXXXXXXXXXXXXXXXXXXXXXXXXXXXXBXXXXXXXXXXXXXXXXXXXXXBXXXXXXXXXXXXXXXXXXXXBXXXXXXXXXXXXXXXXXXXXXXXXXXXXXX
