----------------------------------------------------------------------------------------------------------B----------BX-------BBBB-----------X----------------------------------------------------------
--------------------------------------------------------------------------------------------o---------B-M-----BBBBB---Bo-B---X-B-----X-B-X-B--B---------------------------------------------------------
----------------------------------------------------------------------------------------------X--------X---?B--?--------Xo---X--B---X-----B---?B---------------------------B----B----X?XXXXX------------
-------------------------------------------------------------------------------------------T--B------------------X----T----M-----oB------X----------------------------------------?---X----------BX--B--
----------------------------------------------X------------------M-------------------------|------------XXXXXXXXX-----|----XX--X--XB----------B---------------------------------B------X----X-------X---
----------------------------B-------------------------------------------B-M----------------|---B--XX------XX------B-TB|X--X---BB-----T-BBXBBBX--X--------------------X--------B-------?----XX--------T--
-------------------------------------------------------------X------------X---------B------|----------oB-XXX------BX|M|--B---TTXB---X|---XX---XXXXXXX----------------------------------X--XXX--------|--
--------------------------------------------------------------------------T--------------T-|-----B--B-T-XXXX---BB-X-|B|-BB---||-----X|oT-TXXXXXXX--------------------------------X-------XXXX----??X?|?v
----------------------------------------------------------B------------B--|-B------------|B|-X--?----X|XXXXX-----XXX|?|-BB---||----BX|X|-|XXXXXXX-------------------X---------------?---XXXXX-BBB----|-f
--------------------------------------------------------------------------|--------------|-|----------|XXXXXBXB---XX|-|oT-X-T||-BX--X|X|-|XXXXXXX-----------------------BBBBBB---------XXXXXX---X?---|Xf
--------------------------------------------------------------------------|--o-----------|-|------TX-X|XXXTXXXX-B-XX|X|-|B--|||--XX-X|X|X|XXXXXXXX-----------------------------M------XXXXXXXX-------|Xf
---------------------------------------------------------------------?----|--B----X------|-|------|-XX|XXT|XXXXXo-XX|X|-|-M-|||--XXXX|X|X|XXXXXXXXX-------------------------------X--XXXXXXXX-----XBB|Xf
--------------------------------------------------------------------------|---???XXX-----|-|--B-??|XXX|XX||XXXXTX-XX|X|X|--?|||--XXXX|X|X|TXTXXXXXXX------------------------------XXXXXXXXXXX--------|Xf
---------------------------------------------------------------------X----|-------XXX----|X|--B---|XXX|XX||XXXX|TXXX|X|X|---|||-TXTXX|X|X||X|XXXXXXXX--------------------T---T----XXXXXXXXXXXX-------|Xf
m---------------------------------------------------------E---------XX----|--EE---XXXX-E-|X|---E-X|XXX|XX||XXXX||XXX|X|X|XBB|||-|X|XX|X|X||X|XXXXXXXXX----------------X--|-E-|?---XXXXXXXXXXXo----EEE|XX
XXXXXXXXXXXXXXXXXXXXXXXXXXXXXXXXXXXXXXXXXXXXXXXX----XXXXXXXXXX-----XXX----|--XXXXXXXXXXXX|X|XXX-XX|XXX|XX||XXXX||XXX|X|X|XX?|||B|X|XX|X|X||X|XXXXXXXXXXXXXXXXXXXXXXXXXXXX|XXX|XXXXXXXXXXXXXXXX-------|XX
