-----------------------------------------BBBBB----------------------------------??-XXXX--XXX?XX------------?X---BB-------o?--------------------------------------------------------------------M--------
----------------------------------------------------M----B----------------------------------------M---------------oXXXX--B-----M----o--------------------------------------------------X----------------
--------------------------------------------------------------------------B-----------XXXXXXX------o-B-o-------XooXXXX---------B---o-------------------------------------------------BBB----oX----------
--------------------------------------------------------------T-------------T-----X-------B----------------????T?To--o------T------X-----o--------------------------------------------------------------
--------------------------------------------------------------|-------------|------------??--T-------------o---|-|--T-To----|-BT---X-----B-------------------------------------o----------BBBBB---------
---------------------------?----------------------------------|-------------|X-----X---------|--------T----X?--|-|o-|?|-TT--|T-|X-XX-----X------------------------------------------------X-------------
--------------------------------------------------------------|---------o---|XX----XXX----BBB|BB---TXX|XBMXTX-M|o|-X|T|-||BB||-|-XXX----XXX-----------------------------------------------XX------------
--------------------------------------------------------------|----T-----X--|XXX---XXX-------|-----|--|XXXX|XXT|-|TT|||X||--||-|XXXX---XTXXX---------------------------------------------XXXX---------Xv
--------------------------------T--------------To-------------|----|-T--XX-X|XXXX--XXXX------|----B|BB|XXXX|-B||-||||||X||XT||-|XXXXXXTX|XXXX---------------------------------------------XXXX--------Xf
--------------------------------|--------------|--------------|--M-|-|-XXX-X|XXXXX?XXXXX--X-?|-o---|TX|XXXT|-T||X||||||X||X|||X|XXXXXX|X|XXXXX--------------------------------------------XXXXX----B-BXf
------T-------------------------|---X----------|-------X---XXX|X---|-|XXXX-X|XXTXXXXXXXXX----|-----||T|XXX||M|||X||||||X||X|||X|XXXXXX|X|XXXXXX-------------------------------------------XXXXXX-----XXf
------|T------------------------|---XX---------|-------XX-----|----|-|XXXX-X|XX|XXXXXXXXXX-B-|-----||||TXX||X|||X||||||X||X|||X|XTXXXX|X|XXXXXXX------------------------------------------XXXXXXX-BBXXXf
------||------------------------|T--XXX----B---|-------XXX----|----|X|XXXXXX|XX|XXXXXXXXXTX--|----X|||||XX||X|||X||||||X||X|||X|X|XXXX|X|XXXXXXXX------------------------------------X----XXXXXXXX?XXXXf
------||--------BBB-------------||--XXXX-X-----|-------XXXX-X-|----|X|XXXXXX|XX|XXXXXXXXX|XX-|-MoXX|||||XX||X|||X||||||X||X|||X|X|XXXT|X|XXXXXXXXX-----------------------------------XX---XXXXXXXXXXXXXf
m-----||------------------------||??XXXXXX-----|-------XXXXXX?|---X|X|XXXXXX|XX|XXXXXXXXX|XXX|--XXX|||||XX||X|||X||||||X||X|||X|X|XXX||X|XXXXXXXXXX----------------------------------XXX-XXXXXXXXXXXXXXX
XXXXXX||XXXXXXXXXXXXXXXXXXXXXXXX||XXXXXXXXX----|XXXXXX-XXXXXX-|--XX|X|XXXXXX|XX|XXXXXXXXX|XXX|XXXXX|||||XX||X|||X||||||X||X|||X|X|XXX||X|XXXXXXXXXXXXXXXXXXXXXXXXXXXXXXXXXXXXXXXXXXXXXXXXXXXXXXXXXXXXXXX
