--------------------------------------------------------------------------------------------------------------------------------------------------------------------------------------------------------
-------------------------------------------------------------------------------------------------------------------o-----------------------------------------------------------o------------------------
--------------------------------------------------------------------------------------------------------------------------------------------------------------------------------------------------------
--------------------------------------------------------------------------------------------------------------------------------------------------------------------------------------------------------
-------------------------------------------------------------------------o-------------------------------B--------------------------------------------------------------------------------------BBBBBBB-
-------------------------------------------------------------------------------XXXXXX-------------------------------------------------------------------------------------------------------------------
----------------------------------------BBBBBB------------------XXXXXXXX-----------------------------------------------------------------------------------------------------------------------------?--
------------------------------------------------------------------------------------------------------------------------------X---X------X-------------------------------------------------------------v
---------------------------------------------------------------------------------------------------------------------------------XX-----XX-------------------------------------------------------------f
---------------------XXX-------------------------------------------------------------------------------------????---------------XXX----XXX------------------------------------------------------------Xf
-----------------------------------------------------------------------------------X-------------------------------------------XXXX---XXXX-------------------------------------------------------------f
----------------------------------------------------------------------------------XX------------------------------------------XXXXX--XXXXX-------------------------------------------------------------f
---------------------------------------------------------------------------------XXX-----------------------------------------XXXXXX-XXXXXX---------o---------------------------------------------------f
--------------------------------------------------------------------------------XXXX----------------------------------------XXXXXXXXXXXXXX---------------------------------------------T---------------f
m----E-------------------------------------------------------------------------XXXXX----------E----------------------------XXXXXXXXXXXXXXX---E----------------------M------------------|---------------X
XXXXXXXXXXXXXXXXXXXXXXXXXXXXXXXXXXXXXXXXXXXXXXXXXXXXX--------XXXXXXXXXXXXXXXXXXXXXXXXXXXXXXXXXXXXXXXXXXXXXXXXXXXXXXXXXXXXXXXXXXXXXXXXXXXXXXX--XXXXXX-------XXXXXXXXXXXXXXXX--------XXXX|X---XXXXXXXXXXXX
