----------------------------------------------------------------------------------------------------------------------------X--M--X---B----B-----------------------------------------M--BBB-X--X--------
--------------------------------------------------------------------------X----------------------------B--------B------------X--XBXXX---------X-B---------------------------------X-B----o---X---BBBX---
-------------------------------------------------------------------------------------------------------B--------------------------BB-----X--o-----------------------------------------BBB---?X--B-------
----------------------------------------------------------------------------------------------------------------X-----------------X-----???X--------------------------------------X----X---X?B??------X-
-X---------------------------------------------------------------------------------------------------------XB---------------B---B-??-BBBoBBBBTT-----------------------------------M---TXTX--?-X---X-T-X-
-----------------------------------------------------------------------------------------------------------------BB----------X-B---MXT---X---||-M----------------------------------X?X|?|XXTTXMXX-XB|-X-
--------------------------------------------------------------------------------------------------------------X---B-----------B----X-|-------||-B----------------------------------BoB|X|B-||XXB-TXX|-X-
---------------------------------------------------------------------------------------------------B---------------------------X--BB-|BX--M--||---B-----------------------------B--B?-|T|--||XXXX|XX|-Xv
------------------------------XXXX-----------------------------------------------------------------------------------------T---X-----|-XX-X--||----------------------------------B----|||XM||XXXX|XX|XXf
------------------------------------------------------------------------------B------------------T----------------XXXX-----|---B-----|-XXXXX-||------------------------------------BB-|||XX||XXXX|XX|XXf
---X---------------------------------------------------------------?-----------------------------|-------------------------|---?B----|-XXXXXX||-----------------------------------B--B|||XX||XXXX|XX|XXf
------------------------------------------------------------------------------------------------B|-----X---------B-X-------|-------X-|XXXXXXX||BBBB-----------------------------B---BB|||XX||XXXX|XX|XXf
-------------------------------------------------------------------------------------------------|-------------------------|-XBB-B---|-XXXXXX||--------------------------------------B|||XX||XXXX|XX|XXf
-------------------------------------------------------B-----------------------------------------|-------------------------|---------|BXXXXXX||X--------------------------------B-----|||TX||XXXX|XX|XXf
m------------------------------------------------------------------------------E----------E------|-----M----------E-------E|-X--B-EXE|XXXXXXX||XX---------------------------------BEX-||||X||XXXX|XX|XXX
XXXXXXXXXXXXXXXXXXXXXXXXXXXXXXXXXXXXXXXXXXXXXXXXXXXXXXXXXXXXXXXXXXXXXXXXXXXXXXXXXXXXXXXXXXXXXXXXX|XXXXXXXXXXXXXXXXXXX-XXXXX|XXXXXX--B|-XXXXXX||XXXXXXXXXXXXXXXXXXXXXXXXXXXXXXXXXXB----||||X||XXXX|XX|XXX
