-----BBBB------XX-----------------------------------------------------------------------------------------B--B---------------------------------------------------------------X------------X-------------
------X-X--------------------------------------B-----------------------------------------------------------------------------------------------------------------B------------B---o---------------------
--------------------------------------------------------------------------------------------------------------B------------------------------------------------------------------------------------X----
---------------------T----------------------------------------------------------------------------------------------------------------------------------------------------------------------------------
---T-----------------|----------------------------------------------------------------------------------------------------------------------------------------------------------------------------------
---|-----------------|------------------------------------------------------------------------------------------------------------------------------------------------------------------??????--------B-
---|--B--------------|------------------------------------------------------------------------------------------------------------------------------------------------B------------------------------X--
---|-----------------|---------------------------------------------------------------------B------------------------------------------------------------------------B---------?------------------------v
---|-----------B--B--|--------------------------------------------------------------------------------------------------------------------------------------------T----------------------B-------------f
---|-----------------|------------------------------------------------X-------------------------------------------------------------------------------------------|------------------------------------f
---|--X--------------|------------------------------------------------XX------------------------------------------------------------------------------------------|------T---B-----B-------------------f
---|-----------------|-----------------------o------------------------XXX-------------------------------------B---------------------------------------------------|--B---|T--X-------------------------f
---|-----------------|-----XX-----------------------------------------XXXX----------------------------------------------------------------------------------------|------||----------------------------f
---|-----------------|-----XX-----------------------------------------XXXXX---------------------------------------------------------------------------------------|------||----------------------------f
m--|-----------------|----XXX-----------------------------------------XXXXXXo---------------------------------------o---------------------------------------------|------||B---------------------------X
XXX|XXXXXXXXXXXXXXXXX|XXXXXXXXXXXXXXXXXXXXXXXXXXXXXXXXXXXXXXXXXXXXXXXXXXXXXXXXXXXXXXXXXXXXXXXXXXXXXXXXXXXXXXXXXXXXXXXXXXXXXXXXXXXXXXXXXXXXXXXXXXXXXXXXXXXXXXXXXXXX|XXXXX-||-----XXXXXXXXXXXXXXXXXXXXXXXX
