-----------------------------------------------------M-----------------------------M-----------------------------------------------------------------------------------------M--------------------------
------------------------------------------------------------------------------------------------------------------------------------------------------------------------B------X------------------------
------------------------------------------------------------------------------X------------------o---------------------------------------------------------------------------------o--------------------
-----------------------------------------------T-----------X----------M-BBoTBBB--------------------------------------------------------------------------------------T----------------------------------
-----------------------------------------------|--------------X-T----Xo----|-----------------------------------------------------------------------------------------|------------------????---?--------
---X-------------------------------------------|----------------|---o--XX--|-------------X------M--------------------------------------------------------------------|------o---TT----------------------
---XX------------------------------------------|----------------|---TT-TXXM|--XTX---XTXXXXT----------X---------------------------------------------------------------|-----X--X-||----------------------
---XXX-----------------------------------------|----------------|---||-|XXX|XXX|XX---|----|------M--XX---------------------------------------------------------------|-----XX---||---------------------v
---XXXX----------------------------------------|---o------------|---||-|XXX|XTX|XXX--|----|--------XXXX--------------------------------------------------------------|-----XXX--||---X-----------------f
---XXXXX---------------------------------------|----------------|T--||-|XXX|X|X|XXXXX|--X-|-------XXXXXX-------------------------------------------------------------|-X-o-XXXX-||---XX----------------f
---XXXXXX--------------------------------------|----------------||BB||B|XXX|X|X|XXXXX|--XX|--M---XXXXXXXX------------------------------------------------------------|-XX--XXXXT||---XXX---------------f
---XXXXXXX-------------------------------------|--B------XXXXX--||--||-|XXX|X|X|XXXXX|XoXX|-----XXXXXXXXXX----------------------------------------------------------X|XXXX-XTXX|||---XXXX--------------f
---XXXXXXXX------------------------------------|o---------------||--||-|XXX|X|X|XXXXX|XXXX|X---XXXXXXXXXXXX--------------------------------------------------------XX|XXXXXX|XX|||---XXXXX-------------f
---XXXXXXXXX-----------------------------------|---------XXXX-o-||--||X|XXX|X|X|TXXXX|XXXX|XX-XXXXXXXXXXXXXX------------------------------------------------------XXX|XXXXXX|XX|||X--XTXXXXT-----------f
m--XXXXXXXXXX----------------------------------|------------E---||--||X|XXX|X|X||XXXX|XXXX|XXXXXXXXXXXXXXXXXX----------------------------------------------------XXXX|XXXXXX|XX|||XXEX|XXXX|-----------X
XXXXXXXXXXXXXXXXXXXXXXXXXXXXXXXXXXXXXXXXXXXXXXX|XXXXXXXXXXXXXXXX||-X||X|XXX|X|X||XXXX|XXXX|XXXXXXXXXXXXXXXXXXXXXXXXXXXXXXXXXXXXXXXXXXXXXXXXXXXXXXXXXXXXXXXXXXXXXXXXXX|XXXXXX|XX|||XXXX|XXXX|X----------X
