------------------------------------------------------------------------------------------------------------------------------B-------------------------------------------------------------------------
------------------------------------------------------------------------B---------------------------------------------------------------------------------------B---------------------------------------
---------------------B----------------------------------------------------------------------------------------------------------------------------------------------------------------------------------
------------X--------------------------------------------------------------B----------------------------------------------------------------------------------------------------------------------------
---------------------------------------------------------------------------------------------------------------------XXX--------------------------------------------------------------------------------
---------------------------------------------------------------------------------------------------------------------------------o-------------------------------------------------------------X--------
---------------------------------------------------------------------------------------------------------------------------B----------------------------------------------------------------------------
-------------------------------------------------------------------------------------------------------------------------------------------------------------------------------------------------------v
-------------------------------------------------------------------------------------------------------------------------------------------------------------------------------------------------------f
---------------------------------------------------------------------------------------------------------------------------------------------------------------------------------------------?---------f
-------------------------------------------------------------------------------------------------------------------------------------------------------------------------------------------------------f
-----------------------------------------------------------------T-----------------------------------------------------------------------X----------------------------B--------------------------------f
-----------------------------------------------------------------|----------------------------------------------------------------------XX-------------------------------------------------------------f
-----------------------------------------------------------------|--------------------------------------------------------------------XXXX-------------------------------------------------------------f
m-EXXXXXXXX------------------------------------------------------|--------------------------------------------------------------------XXXX------------------------------------------E------------------X
XXXXXXXXXXXXXXXXXXXXXXXXXXXXXXXXXXXXXXXXXXXXXXXXXXXXXXXXXXXXXXXXX|XXXXXBXXXXXXXXXXXXXXXXXXXXXXXXXXXXXXXXXXXXXXXXXXXXXXXXXXXXXXXXXXXXXXXXXXXX-----XXXXXXXXXXXXXXXXXXXXXXXXXXXXXXXXXXXXXXXXXXXXXXXXXXXXXXX
