--------------------------------------X--------------------------------------------------------------------?--------------?--------------X-----------------------------------------------------M--------
-------------------------------------------------------------------------------------------------------------------------B-o----------------------------------------------------------------------------
--------------------------------------------------------------------------------------XXXXXXX------o---o--------o--------o-------------------------------------------------------------------X---B------
-----------------------------------------------------------------------------------------------------------------------------------------------------------------------------------------------------??-
-----------------------------------------------------------------------------------------??--T----------o--o-----------------------X--M------------------------------------------------------------MX-X-
--------------------------------------------X--------------------------------X---------------|--------X----XT-----------T---------XX-X-----------------------------------------------------------?----?-
-------------------------------------X----------------------------------o----XX------X----BBB|BB-----oTX-MXT|-M--T------|--------XXXXX-------------X----------------------------------------------------
-------------------------------------------------------------------T---------XXX----------X--|--------|XXXX||X-T-|T--T-X|---X---XXXXXX-----X------XX--------------------------------------------------Xv
------------------------------------------------o----------------T-|-X--XX---XXXX------------|-----M--|XXXX||B-|-||XX|XX|------XXXXXXX-----------XXX----------------------------------------?????T????Xf
-----------------------B-----------------------------------------|-|XX--XX---XXXXX-----------|-o??????|XTXX||-T|?||--|XX|XX---XXXXXXXX----------XXXX------------------------------------------M--|-B--Xf
------T--------------------XXXX?XXX------------------------------|-|XX--XXX--XXXXXX----M-o--X|--------|X|XX||X||-||-X|XX|----XXXXXXXXX---------XXXXX---------------------------------------------|----Xf
------|T------------------------T------------------------------X-|X|XX--XXXX-XXXXXXX--------X|-------X|T|XX||X||-||XX|XX|---XXXTXXXXXX------?-XXXXXX---------------------------------------------|Xo-XXf
------||------------------------|------------------------------XX|X|XXX-XXXXXXXXXXXXX----T--X|X-----XX|||XX||X||-||XX|XT|XXTXXX|XXXXXX------BXXXXXXX-------------------------------------------T-|TBXXXf
------||--------BBB-------------|--X-----X---------------------XX|X|XXX-XXXXXXXXXXXXXXXXX|--X|XX---XXX|||XX||X||X||XX|X||-X|XXX|XXXXXX------XXXXXXXX------------------------------------------X|-||XXXXf
m-----||------------------------|--?--E-XX---------------------XX|X|XXX-XXXXXXXXXXXXXXX--|--X|XXXEXXXX|||XX||X||X||XX|X||XX|XXX|XXXXXX-----XXXXXXXXX-----------------------------------E-------|-||XXXXX
XXXXXX||XXXXXXXXXXXXXXXXXXXX---X|XXXXXXXXXXXXXXXXXXXXXXXXXXXXXXXX|X|XXXXXXXXXXXXXXXXXXXXX|XXX|XXXXXXXX|||XX||X||X||XX|X||XX|XXX|XXXXXX----XXXXXXXXXX-XXXXXXXXXXXXXXXXXXXXXXXXXXXXXXXXXXXX----XX|X||XXXXX
