--------------------------------------------------------------------------------------------------------------------------------------------------------------------------------------------------------
--------------------------------------------------------------------------------------------------------------------------------------------------------------------------------------------------------
--------------------------------------------------------------------------------------------------------------------------------------------------------------------------------------------------------
--------------------------o------------------------------------------------------------------------------------------------------------------?----------------------------------------------------------
-------------------------------------------------XXX----------------------------------------------------------------------------------------------------------------------------------------------------
----------------------------------------------------------------------------------------------------------------------------------------------------------------------------------------B---------------
--------------------------------------------------------------------------------------------------------------------------------------------------------------------------------------------------------
-------------------o--------------------------------------------------------------------------------------------------------XXXXXX---------------------------------------------------------------------v
-------------------------------------------------------------------------------------------------------------------------------------------------------------------------------------------------------f
--------------------------------------------------------------------------------------------------------------------------------------------------------------------------------X----------------------f
-------------------------------------------------------------------------------------------------------------------------------------------------------------------------------------------------------f
-----------------------------X------------------------------------------------------------------------------------------------------------------------------------------------o------------------------f
-----------------------------XX------------------------------------------------------------------------T-----------------------------------------------------------------------------------------------f
-----------------------------XXX-------------------------------------------------X---------------------|------------B----------------------------------------------------------------------------------f
m----E-----------------------XXXX------------------------------------------------XX--------------------|--------------------------------E--------------------------------------------------------------X
XXXXXXXXXX???????XXXXXXXXXXXXXXXXXXXXXXXXXXXXX-X-------XXXXXXXXXXXXXXXXXXXXXXXXXXXXXXXXXXXXXXXXXXXX----|X--------XXXXXXXXXXXXXXXXXXXXXXXXXXXXXXXXXXXXoXXXXXXXXXXXXXXXXXXXXXXXXXXXXXXXXXXXXXXXXXXXXXXXXXX
