-------------------------------------------------------------------------------------------------------------------------------------------------------------------------------B-------------B----------
--------------------------------------XXXX--------------------------------------------------------------------------------------------------------------------------------------------------------------
---------------------------------------------------------------------------------------------------------------------o----------------------------------------------------------------------------------
--------------------------------------------------------------------------------------------------------------------------------------------------------------------------------------------------------
----------------------------------------------------------------------------------------------------------------------------------------------------------------------------------T---------------------
--X-------------------------------------------------------------------------------------------------------------------------------------------------------------------------------|---------------------
---------------------------------BB-----------------------------------------------------------------------------------------------------------------------------------------------|---------?-----------
----T-----------------------------------------------------------------------------------------------------------------------------------------------------------------------------|--------------------v
----|-----------------------------------------------------------------------------------------------------------------------------------------------------------------------------|--------------------f
----|-------X---------------------------------------------------------------------------------------------------------------------------------------------------------------------|--------------------f
----|------XX---------------------------------------------------------------------------------------------------------------------------------------------------------------------|--------------------f
----|-----XXX--------------------------------------------------------------------------------------------------X------------------------------------------------------------------|---B----------------f
----|----XXXX---------------------------------------------------------------------------------------------------------------------------------------------------------------------|--------------------f
----|---XXXXX---------------------------------------------------------------------------------------------------------------------------------------------------------------------|--------------------f
m---|--XXXXXX---------------------E-----------------------------------------------------------------------------------------------------------------------------------------------|---X----------------X
XXXX|XXXXXXXXXXXXXXXXXXXXXXXXXXXXXXXXXXXXXXXXXXXXXXXXXXXXXXXXXXXXXXXX--XXXXXXXXXXXXXXXXXXXXXXXXXXXXXXXXXXXXXXXXXXXXXXXXXXXXXXXXXXXXXXXXXXXXXXXXXXXXXXXXXXXXXXXXXXXXXXXXXXXXXXXXXXX|XXXXXXXX---XXBB-----X
