------------------------------------------------------------------------------------------------------------------------------------------------------X------X-----------------------------B--B---------
-----------------------------------------------------------------------------------------------------------------------------------------B-B------------------B------o-----X----------X----B------------
---------------------------------------------------------------------------------------------------------------------------------------B----------------------------------------------------?-----------
--------------------------------------------------------------------------------------------------------------------------B--BBBBB--------------------B------------X------B----X?????--B-------BB-------
------------------------------------------------------------------------------------------------------------------------B---------------------------------------------T------B---M-----X-oX--?--B---X-X-
----------------------------------------------------------------------------------------------------------------------------------------X--M--------------------------|------?----------XB---------XXXX-
-------------------------------------------------------------------------------------------------------------------------------------------T-------?--B----o---o------|-----B--B----T-----------B-XXXXX-
-------------------------------------------------------------------------------------------------------------------------?-----------------|----------------o------B--|o-----X-----X|--o--oXXXXXXXXXXXXv
-------------------------------------------------------------------------------------------------------------------------------------------|-------------X-----X------|---??XX------|-B-X-------XXTXXXXf
------------------------------------------------------------------------------------------------------------------------------------B------|---------T---XX---X------X|----TTX---B--|B-?--X---BXXX|XXXXf
-----------------------------------------------------------------------------------------------------------------------X-----------T-------|---------|XX-XXX----------|---X||X------|--X------XXXX|XXXXf
------------------------------------------------------------------------------------------------------------------------X----------|-------|---------|X--XXXX-----B---|-MXX||X-X----|---B----XXXXX|XXXXf
-----------------------------------------------------------------------------------------------------------------------------------|-------|--------X|X--XXXXX-o------|-XXX||XM-----|---B--XXXXXXX|XXXXf
--------------------------------------------------------------------------------------------------------------------------T--------|-------|-------XX|X--XXXXXX-------|XXXX||X---X--|----BBXXXXXXX|XXXXf
m-------------------------------------------------------------------------------------------------------------------------|--------|-------|------XXX|X--XXXXXXX------|XXXX||X-B----|---B-XXXXXXXX|XXXXX
XXXXXXXXXXXXXXXXXXXXXXXXXXXXXXXXXXXXXXXXXXXXXXXXXXXXXXXXXXXXXXXXXXXXXXXXXXXXXXXXXXXXXXXXXXXXXXXXXXXXXXXXXXXXXXXXXXXXXXXXXX|XBXX----|-XXXXXX|XXX--XXXX|X--XXXXXXXXXXXXX|XXXX||XX-X?XX|X---XXXXXXXXX|XXXXX
