--------------------------------------BB---------B------------------------------------------------------------------------------------------------------------------------------------------------------
-----------------------------------??????-------??-------XXXX-------------------------------------------------------------------------------------------------------------------------------------------
------------------------------------------------?????-------BBB-----------------------------------------------------------------------------BBBB------BB-----------------------o------------------------
---------------------------o------------------------XXXX------------------------------------------------------------------------------------------------------------------------------------------------
------------------------------------------B-------------------------------------------------------------------------------------------------------------------------------------------------------------
--------------------------------------BBBBBBBBBM--------------------------------------------------------------------------------------------------------------------------------X--XXXXXXX--------------
--o-----------------------------------------------------------------------------------------------------------------------------------------------------------------------------------------------------
--o----------------------------------------------------------------------------------------------------------------------------------------------------------------------------------------------------v
-----------------------------?--------------------------------------------------------------------------------------------------------------------------------------------XXXXXXX--------------------??f
---------------------------o-----------------------X------o------------------------------------------------------------------------------------------------------------------B----------------X--------f
--------------------------------------------------XX----o-------------------------------------------------------------------------------------------------------------------------------------XX-------f
--------------------------------------------o----XXX------------------------------------------------------------------------------------------------------------------------------------------XXX-X----f
-------------------------------------TBB--------XXXX----------------------------------------------------------------------------------------------------------------BBBBBBB-------------------XXXX-----f
-------------------------------------|---------XXXXX-BBBBBBBB----------------------------------------------------------------------------------------------------------XX---------------------XXXXX----f
m-----------------------------------X|--------XXXXXX--------------------------------------------------------------------------------------------------------------------------E-----X---------XXXXXX---X
XXXXXXXXXXXXXXXXXXXXXXXXXXXXXXXXXXXXX|XXXXXXXXXXXXXXXXXXXXXXXXXXXXXXXXXXXXXXXXXXXXXXXXXXXXXXXXXXXXXXXXXXXXXXXXXXXXXXXXXXXXXXXXXXXXXXXXXXXXXXXXXXXXXXXXXXXXXXXXXXXXXXXXXXXXXXXXXXXXXXXXXXXXXXXXXXXXXXXXXX
