------------------------X-------------B-X--------------------------------------------------------------------------XX-------------------------------------------------------------X-------------X---X---
----------B------BX------------------------------------B------------B------------------X------------X-----------X----B-------------------B-B---X----X-B-------------------------------------------------
--------------------------------------------------------X-------------------------------------------------------X-----------------------------------B---------------------------------------------------
------------------X-------B------------------------------------X-------------X------------X---------------------------------------X------B-----XB-----------------------------------------X------X------
--------------------B-----B----B---------------------B--X---------------------------------------------------B-X----------------B--------------------X-----B------------X--------------------------------
-----------------------------------------X-----------------------------B----------------------------------------------------------------------------------------B---------------------------------------
--------X---------------------------------X----------------------------------------------B----------------------X----------B---------X-----------------X-----X------------B-------------------X------X--
-------X--X----B---X----------------------------------------------B--------------------------------------B-----------------------------------------X------------X--------------------------------------v
-------------------------X--------------------B-------X---------------------B-----X--------------------------------------------B-------X---------------------------------B--X--------------------------f
-----------------------------------------------------------------------------------------------B---------------------X-----------------------------------------------X---------------------------------f
---B-------------BB-------------------X------------------------X-------------------------------------------------------------B-------------------------------------------------------------------------f
--------------------------XB-----------B----------------X----------------------------------------B-------------------------------X-----------------------------------------------X---------------------f
----------B--------------X---------------B-------------------B-B-------B---------------------------------------------------B---------------------------------------------------------------------------f
----------B------------------------------------------------------------------X--------------------X-----B------------B---B----------B------BX-------------------------B---------X------------B---------f
m----------------X-----------------------------------------------------------X----------------------------------------------------------------------------------------------B--------------------------X
XXXXXXXXXXXXXXXXXXXXXXXXXXXXXXXXXXXXXXXXXXXXXXXXXXBXXXXXXXXXXXXXXXXXXXXXXXXXXXXXXXXXXXXXXXXXXXXXXXXXXXXXXXXXXXXXXXXXXXXXXXXXXXXXXXXXXXXXXXXBXXXBXXXXXBXXXXXXXXXXXXXXXXXXXXXXXXXXXXXXXXXXXXBXXXXXXXXXXXXX
