--------------------------------------------------------------------------------------------------------------------------------------------------------------------------------------------------------
--------------------------------------------------------------------------------------------------------------------------------------------------------------------------------------------------------
--------------------------------------------------------------------------------------------------------------------------------------------------------------------------------------------------------
-------------------------------------------------------------------------------------------------------------------------------------------------------------------------------XXXXX------------BBB-----
--------------------------------------------------------------------------------------------------------------------------------------------------------------------------------------------------------
-------------------------------------------------------------------------------------------------------------------------------------------X------------------------------------------------------------
--------------------------------------------------------------------------------------------------------------------------------------------------------------------------------X-----------------------
-------------------------------------------------------------------------------------------------------------------------------------------------------------------------------------------------------v
-------------------------------------------------------------------------------------------------------------------------------------------------------------------------------------------------------f
-------------------------------------------------------------------------------------------------------------------------------------------------------------------------X-----------------------------f
-----------------------------------------------------------------------------------------------------------------------------------------------------------------------MXX-----------------------------f
---------------------------------------------------------------------------------------------------------------------------------------------------------X-------------XXX-----------------------------f
----------------------------------------------------------------------------------------------------------------------------------------------------------------------XXXX-------------------T---------f
---------------------------------------------------------------------------------------------------------------------------------------------------------------------XXXXX-------------------|---------f
m-------------------------------------------------------------------------------------------------------------------------------------------------------------------XXXXXX-------------------|---------X
XXXXXXXXXXXXXXXXXXXXXXXXXXXXXXXXXXXXXXXXXXXXXXXXXXXXXXXXXXXXXXXXXXXXXXXXXXXXXXXXXXXXXXXXXXXXXXXXXXXXXXXXXXXXXXXXXXXXXXXXXXXXXXXXXXXXXXXXXXXXXXXXXXXXXXXXXXXBXXXXXXXXXXXXXXXXXXXXXXXXXXXXXXX--|---XXXXXXX
