--------------------------------XX--------X-------------------------------------------------------------------------------------------------------------------------------------------------------------
-----------------------------------------??????--------------------------------------------------------------------------------------o------------------------------------------------------------------
-----------------------------------------------------------------------------?--------------------------------------------------------------------------------------------------------------------------
------------------------------------------------------------------------------------------------------X------------------------------------------------------------------------------X------------------
-----------------------------------------------------------------------------------------------------------------------------------------------------------------------------?????----------------------
--------------------------------------------------------------------------------------------------------------------------------------------------------------------------------------------------------
---------------------------------------------------------------------------------------------------------------------------------------------o----------------------------------------------------------
-------------------------------X-----XXXXX--------------------------------------------------------------------X---------------------------------------------------------X-------X----------------------v
------------------------------------?---X--------------------------------------------------------------------------------------------------------------------------------------------------------------f
---B-B----------------------------------XX-------------------------------------------------------------------------------------------------------------------------------------------------------------f
----T-----------------------------------XXX--------B-----------------------------------------------------------------------------X---------------------------------------------------------------------f
----|-----------------------------------XXXX-----------------------------------------------------------------------------------------------------------------------------------------------------------f
----|-----------------------------------XXXXX--------------------------------------------------------------------------------------B---------------------------------?---------------------------------f
----|-----------------------------------XXXXXX-????----------------------------------------------------------------------------------------------------------------------------------------------------f
m---|--------------------------------EE-XXXXXXX------E---------------------------------------------------------------------------B------E------o-------------------------------------X--------o--E-----X
XXXX|XXXXXXXXXXXXXXXXXXXXXXXXXXXXXXXXXXXXXXXXXXX-XXXXXXXXXXXXXXXXXXXX-------XXXXXXXXXXXXXXXXXXXXXXXXXXXXXXXXXXXXXXXXXXXXXXXXXXXXXXXXXXXXXXXXXXXXXXXXXXXXXXXXXXXXXXXXXXXXXXXXXXXXXXXXXXXXXXXXXXXX----XXXX
