----------------------------------------------------------------------------------------------------------------X--------------------X-----?--XXXXXXXXB------------------------------------B------------
------------------------------------------------------------------------------------------------------X------------------------------------BX-------X-X----?------BB-------X----------------------------
---------------------------------------------------------------------------------------------------------------------------------------------o---?-B-----o------------------XXXXXXX---------------------
------------------------------------------------------------------------------------------------------------------------------B--B---T-----X---B---B--B--BBBBB-BBXXXX----X--???-------------------------
----------------------------------------------------------------------------------------------------------------------------------B-B|--BX---BT---X--BBX---o-X-------------B-B---M----BX-----?--------X-
---------------------------------------------------------------------------------------o-------------------------------X--------BXB--|---TBM-X|B-XX--B------XX--------------o?-T---B-----B-----------XX-
------------------------------------------------------------------------------------------------------------------------------X-?????|--X|XXBX|XXXX?BMoB-X-XXX-oo--------------|----B---------------XXX-
-------------------------------------------------------------------------------------------------------------------X------o-------X--|M-?|----|XXXX--X---XXXXX?--------B-B-----|----------o----o---XXXXv
-----------------------------------------------------------------------------------------------------------------------------------T-|--X|-T--|XXXX------XXXXX-X---B--?--------|-T----B----------oXXXXXf
-------------------------------------------------------------------------------------------------------------------------------B---|B|---|-|-X|XXXX?----XXXXXXX----B???--------|-|-------------B-XXXXXXf
-------------------------------------------------------------------------------------------------------------------------X------o-B|-|X--|-|XX|XXXX-X-XXXXXXXXX-------------B--|-|-----X--------XXXXXXXf
-------------------------------------------------------------------------------------------------------------------------------X---|-|---|-|XX|XXXX--XXTXXXXXXX---B-------T----|T|-------------XXXXXXXXf
-------------------------------------------------------------------------------------------------------------------------------BB-?|X|-?-|X|XX|XTXX-XXX|XXXXXXXX--X-----B-|X---|||--------M---XXXXXXXXXf
-------------------------------------------------------------------------------------------------------------------?-------------M-|-|X--|X|XX|X|XXXXXX|XXXXXTXTXX???----X|XM--|||-----------XXXXXXXXXXf
m---------------------------------------------------------------------------------------------------------------------------E-X---?|-|E-X|X|XX|X|XXXXXX|XXXXX|X|XX----E--X|XX--|||E------E--XXXXXXXXXXXX
XXXXXXXXXXXXXXXXXXXXXXXXXXXXXXXXXXXXXXXXXXXXXXXXXXXXXXXXXXXXXXXXXXXXXXXXXXXXXXXXXXXXXXXXXXXXXXXXXXXXXXXXXXXX------XXXXXXXXXXXXX---B|-|-XX|X|XX|X|XXXXXX|XXXXX|X|XXXXX-----|XXXX|||XXXX-XXXXXXXXXXXXXXXXX
