--------------------XXX---------------------------???????------------------------------------------------------------XX---------------------------------------------------------------------------------
-------BB-------------------------------o------------------------------------X------X--------------------------------------------------------------------------B----------------------------------------
-----------BB------------------------------------------------------------B-----------------------------------------------------------------------------------------------------------------------BBBB---
-----------------------------------------------------------------------------------------------------------BB--------------XX-----------o---------------------------------------------------------------
--------------------------------------------------------------------------------------------------------------------------------------------------------------------------------------------------------
-----?-----------------------------------------------------------------------------------------------------------o--------XXXXXXX-????------------------------------------------------------------------
-----------------------------------------------------------------------------------------------------------------------------------------------------------------BB-------------------------------------
----------------XXBBBBBB--------------------------------------------------------------------------------------------------------------------------------------------------------------o----------------v
-------------XXBBBBBBB--------------------XXXX----------------------------------B-------------------------------------------------------------------------???????----------X---------------------------f
----------------------------------------------------X--------------------------------------------------------------------------------------------------------------------------------------------------f
----------------------------------------------------XX-------------X------------???????-------------------------------X-------------------------?-------o----------------------------------------------f
-XXXXXXXX----------------------------------------X--XXX------------XX------------------------------------------------XX--B--??????--------------------------------------------T------------------------f
------------------------------------------------XX--XXXX-----------XXX-----------T----------------------------------XXX-B-------------------------------------B---------------|----------------??????--f
-----------XXXX---------------XX---------------XXX--XXXXX----------XXXX----------|---X-----------------------------XXXX-------------------------------------------------------|------------------------f
m---------------------------------------------XXXX--XXXXXX--------XXXXXX--???E?--|--XX------------------------E---XXXXX----E--------------------------------------------------|------------------------X
XXXXXXXXXXXXXXXXXXXXXXXXXXXXXXXXXXXXXXXXXXXXXXXXXXXXXXXXXXXXXXXXXXXXXXXXXXXXoXXXX|XXXXXXXXXXXXXXXXXXXXXXXXXXXXXXXXXXXXX----XXXXXXXXXXXXXXXXXXXXXXXXXXXXXXXXXXXXXXXXXXXXXXXXXXX|XXXXXXXXXXXXXXXXXXXXXXXXX
