-------------------------------------------------------------------X------------B----M-----------B--B---------------------------B---o------------------B-----B---?--------XXBX--------------------------
-------------------------------------------------------------Bo--B-----------M----X--X---------------------------------X-----------X----------------------X----------------X---X-------------X--?-------
----------?--------------------------------------X-----------------BBBBB----B---------------?---------X---------B----------------B--B???X?-------------?-----------BX--------------------B----XB--------
----------------------------------------------------T------BB------------------------------X-------X-----------------o--------------------B------X-----T-o---X-------------B--------o-------------X--B--
---------------------------------X---------X--------|---B-----BB-----------------BBB-------------------------XX------------B-BT---X------T-------------|------------B----------------T---------TX-------
--------------------------------XX--------XX--?-----|-------B--------T--B-----XX---------o---------------T--------T--oX-------|----------|-----------T-|------XB-------------X-T---X-|-X-----BB|XBB-----
----------------------------M--XXX---X---XXX-----X--|-----X-T------o-|--------------B---B-X---------X---X|--------|---T-X-----|-X-------B|--------B--|-|------XX---------B--XX-|--XX-|--X--???X|XB?-----
------------------------------XXXX--XX--XXXXXXoXXX--|-----XX|--------|----------------------------BBB---X|-------B|---|-----X-|T--M-----X|XXX--------|X|B----TXXX----------XXX-|-XXX-|--TXXo-XX|XXX----v
-----------------------------XXXXX-XXX-XXXXX--------|-B---XX|------oB|------------------------?--B---T-XX|X?B-----|X??|-----XX||-------??|????XB--X--|-|XoB--|XXXXXX-X----XXXX-|XXXX-|--|XX-XXX|XXX-M--f
----------------------------XXXXXXXXXXXXXXXX--------|B??B-XX|X------B|----------------X------XX------|--X|XX------|XX-|-----XX||????-----|X------XX--|-|-----|XXXXX--XX--XXXXXX|XXXXX|o-|XXXXXX|XXXX---f
---------------------------XXXXXXXXXXXXXXXXX--------|-----XX|XX------|----B-B----B----XX-------------|--X|XXX-----|XXX|-----XX||----X-TX-|XX----XXX--|-|-T---|XXXXXX-XXXXXXXXXX|XXXXo|--|XXXXXX|XXXXX--f
--------------------------XXXXXXXXXXXXXXXXXX-------X|-----XX|XXX--B--|X---------------XXX----o-------|--X|XXXX----|XXX|-----XX||X--B--|-X|XXX--XXXX--|-|-|---|XXXXXXXXXXXXXXXXX|XXXX?|??|XXXXXX|XXXXXX-f
-------------------------XXXXXXXXXXXXXXXXXXX---X--BX|-X---XX|XXXX----|XX--------X----BXXXX------B----|-XX|XXXXX---|XXX|X----XX||XX----|-?|XXXXXXXXX--|-|X|---|XXXXXXXXXXXXXXXXX|XXXXT|--|XXXXXX|XXXXXXXf
------------------------XXXXXXXXXXXXXXXXXXXX-----X-X|X-B--XX|XXXXX---|XXX-------------XXXXXX---------|-XX|XXXXXXM-|XXX|XX---XX||XXX-oT|--|XXXXXXXXX--|X|X|X--|XXXXXXXXXXXXXXXXX|XXXX||-X|XXXXXX|XXXXXXXf
m---------E------------XXXXXXXXXXXXXXXXXXXXX-------X|XX-E-XX|XXXXXX--|XXXX------X-----XXXXXXX--------|-XX|XXXXXXX-|XXX|XXX--XX||XXXX-||--|XXXXXXXXX--|E|E|-EX|XXXXXXXXXXXXXXXXX|XXXX||XX|XXXXXX|XXXXXXXX
XXXXXXXXXXXXXXXXXXXXXXXXXXXXXXXXXXXXXXXXXXXXXXoXXX-X|XXX--XX|XXXXXXXX|XXXXX----B------XXXXXXXXX------|-XX|XXXXXXXX|XXX|XXXXXXX||XXXXX||--|XXXXXXXXX--|-|-|--X|XXXXXXXXXXXXXXXXX|XXXX||XX|XXXXXX|XXXXXXXX
