------------------------------------------------------------X---------------------------------X------------------------X--------------------------------------------------------------------------------
---------------------------------------------------------X------------------X------------------------X-----B------------------------------------------o-------------------------------------------------
---------------------------------X-----------------B---------------B-----X---------------------------------------X---------------B----------------------------------------------------------------------
-B----X---------------------------o------------------------------------------------------------------------------------------------B-B------------------------------------------------------------------
-------------------------------------------------X-------------------------------------------------------X--------------BBBBBBB----------------------------------X--------------------------------X-----
--X--------------------------------------------------------------------------------------------------B------------X-----------------------o--------B------------------------------------B---------------
----------------B----------------------------------------------------------------------------------------B------------B-B----------------------X--------------------------------------------------------
-X------------B-----------------------------------B-----------------------------------X-------------X--------B--------------------------------------------------------------------B--------B-----------v
--------------------------------------------------------------------------------B----------------------B--B--B------------------------B--------o-------------------------------------------------------f
--------B-----------------BBBBBB--------------------------------------------------------------------------------------X----B---------o-----------------------------------------------------------------f
-------B-------------------------------------------------------------------------------------------X---------------------------------------------------------------------------------------------------f
--------------------------------------------------------------X-------------------------------------------------------------o--X-o-------------B------T------------------------------------------------f
---------------X---------------------------------------------------------------------------------------B---------o----------------------------------T-|--------------------X---------------------------f
-------------M--------------------------------X-----------------------------------------------------------------B-------B---------------------------|-|-------------------XX---------------------------f
m----X----------------------------------------XX-E---------------E------------------------------X-----E------------------X---------B---XE-----------|-|------------------XXX---------------X-----------X
XXXXXXXBXXXXXXXXXXXXXXXXXXXXXXXXXXXXXXXXXXXXXXXXXXXXXXXXXXXXXXXXXXXXXXXXXXXXXXXXXXXXXXXXXXXXXXXXXXXXXXXXXXBBXXXXXXXXXXXXBXXXXXXXXXXXXXXXXXXXXXXXXXXX|X|XXXXXXXXXXXXXXXXXXXXXXXXXXXXXXXXXXXXXXXXXXXXXXXXX
