----o------------------------X--------o----------X-X-----------------o---------------o----oo--B-------------o------B----------------------------o-----------------------------------------------------X-
--------------B-------o----B----o---BB------------------------------o------------o----------------------o--------------o------------------B---------BB---B---B--------------------B--------o-----X-X----
-------X----o--o---X-------------o---oB-----------B-o----o-----------B-----o-----------o---o---o-------oo-oX--------B---o----------Bo----o--B---o------B--X----------------o----------o---------X-----E-
---B---o--B--Bo--XBo---------X-o----------Bo---Eo-B---B-o---BB-B-------o-------o----X----------o--------B-----o------E---B------o------X-------o--------BB---------------------------B----------o-------
--o-------B---o----B--o-------ooB-o-------B----X------------E-X-------Bo---------B-------o---------B-o----X------B----B---B---------o-----------o----B---------E-------o-----------------o---o----o-BB--
-----------------B-o--B---------------B------------o-------o--------------oX---X-BX---------o---------o-o-----o------o-------B-------X-X---o-------o-B--------------------------B-------B-------Xo------
-----o--BX-----------X---------B-----oo-----E---B--------B-----o-----o---o-B---X----------X-----X----oo----------------o----B----E-----------------oX-----o--------------B-------o---E-----oB-o-o-------
---Xo----------Bo---------------o--B----B---o----o-----B------------------o--------------B-------------o------o----Bo-o----X---o--o--oX---o-----------X------B--X------o---o-o----------------B--------v
-------------------o---------oo---o-------------------o--o-X---o---B---E--o----o--o---o-B----------o--o--o--o----B--X---ooE---------------------------------BB---o-------------------o-o-B----------oo-f
-B------------------B--------o---------------------------o---B-------o-------------------B--o--o------------------o---X--------------o-B----B------------------BBoo----oo---o---------o---X----o-------f
-------------------o------E-B-o-------X-------------o--ooBBX---B-----------------B--------------X-----o-o-------X--B---o---------o-o------o-------------B-----------------B---o-------B-E------------X-f
--------X----B----X--B-------B---------------o--------o-------X---B----------------o------B-------X----------o-----B-----------------o------X----B--X-------o----XoXo-----Xo-------------B-----Bo----oof
---------o-X---o-o---B---X-----------X---B--B---------o--------------o---o--B---o--------------B--o--X--B-----------o------------B---o-----B-o--o-------o-----o------------B---o-o-----B-------X-------f
---o---B------B-B---BB-Booo-----o-----B----B-------o------X---------o--o-o-Bo---------X-----------------------E-----o---------X----o----o-------Eo----------B--------------------o--------------o------f
m-BB----o------Eo-o--EB-----------oo-Bo----o---oEo---BEE-----BB-----X---o-------E-o----BBoE-B--E------------o-------X------X--oo--------E-B-------X--o---o-o--------EBX------E----XE-------------E-Eo--X
XXXXXXXXXXXXXXXXXXXXXXXXXXXXXXXXXXXXXXXXXXXXXXXXXXXXXXXXXXXXXXXXXXXXXXXXXXXXXXXXXXXXXXXXXXXXXXXXXXXXXXXXXXXXXXXXXXXXXXXXXXXXXXXXXXXXXXXXXXXXXXXXXXXXXXXXXXXXXXXXXXXXXXXXXXXXXXXXXXXXXXXXXXXXXXXXXXXXXXXX
