---------------BB------o---B-----B-B-X-B-o--o------o---X------------o-------BB--XB-X-------o---o-----o--o-----B-X-------------------X----B-----o--Boo-B---------B-----X-------------o--o-oB---o---------
-X---B-o--o----oo--oo------------X--B--BB--oX-o--------o------------X-o---o-----------o---------B-B-X-----------B--o---o--o-------------------------o-------------o--o----B--o--E--------------oXB----o-
----o--------------Eo--oo----o---------o---T-Xo----BX----oE-------------Bo----------o-B---X---------o-----B-----B-------------------E-X-X--B-E----B----B-----------o-B-----BoB---B-------Xo----Eo-o-----
--------B--------oB----B----------X---oB-oo|--o-----o----E----B--o-B---o--X----X------------o--X-----------------BB--------------------oooo-----X------oX-----------o---o-o---Bo---oB---Bo---B---B------
--o----B-----B-o--o--E-----B----B------o---|---B------X----B------Bo-B----B----B------o---BoX-------------o-o---o-o-------------------oX------o---B------o------------o--------X--o--o-------o---o------
?-o-X---Xoo-Bo---Bo--B------o--B---B-B----o|--Bo--------------------o----X----o--------------?--------------oX--o-B------B---------B---B-B--o---oX-B-----o----T----B-X--------------X-oB----------o--B--
--------BX-o--XX--X-B--------------X------B|-B----------------------X------oo-----B-----------------------o-----B---------X--oo-------o--E---------B----ooo---|-o--BBB---o---B-B--B---------?-B---------
o----------oo--o----o-B--------------B---o-|-----------X-X---------X----B-o-BB-----------B--X--o---?--------------B-o-----oXo-X-oE------------o-------X--B----|----X-----B---B---XX------B-o------o---ov
------X----o---o-------o----------XB----B-B|-oB?-------Xo-----X--oB--X---Bo---B-------------B-------------oX-------B--------o----------------?-----------o----|----------o-----------------o------o-B--f
---o-o-----------o-oBB---o---oo-----o---BB-|-------------oo----B----B---------o-o-oXoo----o---B?-X------o----------------------o---X------E-B---------o-o-----|---B-------B-------oo---------o------X-Xf
o----o--BB----o------oB-o--TBB----------X--|-B-o-o---------------------------B-B----o-X----BoB-------oo---o----------------B-Boo------X-o---BB-------o-oo---o-|-X---B-o-X------------------------------f
-----------X-------X-oo----|---T----X-----X|-XB-oo---o--BB-B--o---B-o---------o---oX------oo------------B---B----------B---------o---XooB---o-X------o------o-|-----------B----o-------------X--------Bf
-------B------X------------|---|---o-o-----|-X------o------o------B---------B--o----B---------------o--oo-B------X-------o----oo-----B---o-----------B-----o--|-o--o--------BX------B-----------X---B-Xf
-X----------o--------o----o|---|-----?X-B--|---------B--B-------Xo-oo------B-----B----o-X-----B--B----B--B--oX-B---o----------B-oo--X-o-----X---o-------------|--X---o--------oE---------------B------of
m--------BBB-EB-----X---BX-|--B|--XB---E-o-|-B---B--B-oB---B---o---B?E----------X--o-BX----o------E--E----o-o-B--o---Eo------o-----BB-----------o----o-X----X-|--o-o-B-B---B---B----E--------------X----
XXXXXXXXXXXXXXXXXXXXXXXXXXXXXXXXXXXXXXXXXXXXXXXXXXXXXXXXXXXXXXXXXXXXXXXXXXXXXXXXXXXXXXXXXXXXXXXXXXXXXXXXXXXXXXXXXXXXXXXXXXXXXXXXXXXXXXXXXXXXXXXXXXXXXXXXXXXXXXXXXXXXXXXXXXXXXXXXXXXXXXXXXXXXXXXXXXXXXXXX
