----------------------------------------------------------------------------------------------------------B----------B----------B------------XB--BBBBBXXXXX----------B-------oX-----o-------------------
--------------------------------------------------------------------------------------X-----o---------B-M----BBBBBB---Bo-B---X---------B-X-B-BB-X--o-----X-----B------B------------XX--------------X----
-----------------------------------------------------------------------------------------B----X-BB-----X---?B--?--------Xo---X--B---X-----B---?B--B----X----B----B-BB-X-X--B----B----X?XXXXX-??M???---B-
-------------------------------------------------------------------------------------------T--B------------------X----T----M-----oB------X----------T-----BBBBBBBB-?-------X------?---X-BBBBBBBBXBX--B--
----------------------------------------------X------------------M--------------o----------|------------XXXXXXXXX-----|----XX--X--XB---------XB-X-X-|---T----oo----X--XT----B---B-TB---X----X-T----XX---
----------------------------B-------------------------------------------B-M----------------|---B--XX-M----XX------B-TB|X--X----B-----T-BBBBXBXM-XX--|---|---------B--XX|---X-BB--X|X--?MX--XXT|-B-XXTT--
-------------------------------------------------------------X------------X----BT---B------|---X----M-oB-XXX------BX|M|--B---T-XB-X-X|----XX--XXXXXX|---|-----------XXX|---XX----X|XX-XX--XXX||-oXXX||--
--------------------------------------------------------------------------T-----|--------T-|-----B--B-T-XXXX-B-BB-X-|B|-BB---|---XX-X|oT-TXXXoXXX--T|BBX|--X-------XXXX|---XXXBBBX|XXXXX-XXXX||-XXXX||?v
----------------------------------------------------------B------------B--|-B---|--------|B|-X--?----X|XXXXX-----XXX|X|XBB-X-|--XXXBX|X|X|XX-XXXX--||-T-|-XXX----?XXXXX|XXXXXXX--X|XXXXXXXXXX||XXXXX||Xf
--------------------------------------------------------------------------|-----|--------|-|-----X----|XXXXXBXB---XX|-|oT-X-T|-XXXX-X|X|X|XXXXXXX-X||-|B|XXXXX---XXXXXX|XXXXXXXX-X|XXXXXXXXXX||XXXXX||Xf
--------------------------------------------------------------------------|--o--|--------|-|-----XTX-X|XXXTXXXX-BXXX|X|-|B--||XXXXX-X|X|X|TXXXXXXX-||-|-|XTXXXX-XXXXXXX|XTXXXXXXXX|XXXXXXXXXX||XXXXX||Xf
---------------------------------------------------------------------?----|--B--|-X------|-|-----X|XXX|XXT|XXXXXXXXX|X|-|-M-||XXXXXXX|X|X||XXXXXXXX||-|X|X|XXXXXTXXXXTX|X|XXXXXXXX|XXXXXXXXXX||XXXXX||Xf
--------------------------------------------------------------------------|---??|XXX-----|-|--Bo?X|XXX|XX||XXXXTXXXX|X|X|--?||XXXXXTX|X|X||XTXXXXXX||-|X|X|XXXXX|XXXX|X|X|XXXXXTXX|XTXXXXXXXX||XXXXX||Xf
---------------------------------------------------------------------X----|-----|-XXX----|X|--BT-X|XXX|XX||XXXX|TXXX|X|X|--X||XXTXT|X|X|X||X|XXXXXX||X|X|X|XXXXX|XXXX|X|X|XXXTX|XX|X|XXXXXXXX||XXXXX||Xf
m---------------------------------------------------------E---------XX----|--EE-|-XXXXEE-|X|EE-|-X|XXX|XX||XXXX||XXX|X|X|XXX||XX|X||X|X|X||X|XXXXXX||X|X|X|XXXXX|XXXX|X|X|XXX|X|XX|X|XXXXXXXX||XXXXX||XX
XXXXXXXXXXXXXXXXXXXXXXXXXXXXXXXXXXXXXXXXXXXXXXXX----XXXXXXXXXX-----XXX--M-|--XXX|XXXXXXXX|X|X--|XX|XXX|XX||XXXX||XXX|X|X|XXX||XX|X||X|X|X||X|XXXXXX||X|X|X|XXXXX|XXXX|X|X|XXX|X|XX|X|XXXXXXXX||XXXXX||XX
