--------------------------------------------------------------------------------------------------------------------------------------------------------------------------------------------------------
--------------------------------------------------------------------------------------------------------------------------------------------------------------------------------------------------------
--------------------------------------------------------------------------------------------------------------------------------------------------------------------------------------------------------
--------------------------------------------------------------------------------------------------------------------------------------------------------------------------------------------------------
------------------------------------------------------------------------------------o-------------------------------------------------------------------------------------------------------------------
---------------------------------------------------------------------------------------------------------------------------------------------------------------------------------------------------?----
--------------------------------------------------------------------------------------------------------------------------------------------------------------------------------------------------------
-------------------------------------------------------------------------------------------------------------------------------------------------------------------------------------------------------v
-------------------------------------------------------------------------------------------------------------------------------------------------------------------------------------------------------f
---------------------------------------------------------------------------------------------------X---------------------------------------------------------------------------------------------------f
------------------------------------------------------------------------------------X-------------XX---------------------------------------------------------------------------------------------------f
-----------------------------------------------------------------------------------XX------------XXX---------------------------------------------------------------------------------X-----------------f
----------------------------------------------------------------------------------XXX-----------XXXX---------------------X----------------------------------------------------------XX-----------------f
---------------------------------------------------------------------------------XXXX----------XXXXX-------------------------------------------------------------------------------XXX-----------------f
m-------------------------------------------------------------------------------XXXXX---------XXXXXX------------------------------------------------------------------------------XXXX-----------------X
XXXXXXXXXXXXXXXXXXXXXXXXXXXXXXXXXXXXXXXXXXXXXXXXXXXXXXXXXXXXXXXXXXXXXXXXXXXXXX-XXXXXXXXXXXXXXXXXXXXXXXXXXXXXXXXXXXXXXXXXXXXXXXXXXXXXXXXXXXXXXXXXXXXXXXXXXXXXXXXXXXXXXXXXXXXXXXXXXXXXXXXXXXXXXXXXXXXXXXXX
