------------------------------------------------------------------------------------------------------------------------------------------------------------------?BB----B-------?----------------------
---------------------------------------------------------------------------------------------------------------------------------------------------------------------------XXXXXXXX-B????????-----------
----------------------------------------------------------------------------------------------------------------------------------------------------------------------------M-----------------o---------
--------------------------------------------------------------------------------------------------------------------------------------------------------------------X--------------X---BX--------B------
--------------------------------------------------------------------------------------------------------------------------------------------------------------------------------------------------------
------------------------------------------------------------------------------------------------------------------------------------------------------------------------------X---B---------------------
-----------------------------------------------------------------------------------------------------------------------------------------------------------------------------------MX-TB----X------X----
----------------------------------------------------------------------------------------------------------------------------------------------------------------------M------BBBBB----|--B--------XX---v
------------------------------------------------------------------------------------------------------------------------------------------------------------------------X----B------B-|-X---o----XXX---f
-------------------------------------------------------------------------------------------------------------------------------------------------------------------------------X------|---------XXXX---f
--------------------------------------------------------------------------------------------------------------------------------------------------------------------------------------|----X---XXXXX---f
-------------------------------------------------------------------------------------------------------------------------------------------------------------------X--------X-BM------|---XX--XXXXXX---f
----------------------------------------------------------------------------------------------------------------------------------------------------------------------------XX-----X--|-oXXX-XXXXXXX---f
------------------------------------------------------------------------------------------------------------------------------------------------------------------X---------XXX-------|XXXXXXXXXXXXX---f
m---------------------------------------------------------------------------------------------------------------------------------------------------------------EX-----E----XXXX------|XXXXXXXXXXXXX--XX
XXXXXXXXXXXXXXXXXXXXXXXXXXXXXXXXXXXXXXXXXXXXXXXXXXXXXXXXXXXXXXXXXXXXXXXXXXXXXXXXXXXXXXXXXXXXXXXXXXXXXXXXXXXXXXXXXXXXXXXXXXXXXXXXXXXXXXXXXXXXXXXXXXXXXXXXXXXXXXXXXBXXXXXXX---XXXXX-M---|XXXXXXXXXXXXXBBXX
