---------------------------B---B--B-------------------X-------------------------------------X--------------------------------------------------------------------------B-------------------B---B--------
---B-------------------B--------------------B-----------------------------B------------B-----------------------------------------------------------B-------------B---------------------------------B----
------------------------------B-X------------------------------X------X--B-----X------B-------------------------B---------------------------------------------------------------------------------------
-------------------------X-------B-------B------------X---------------X-------------------B-----------------X---------B-------------------------------------------B-------------------------------------
-----------B----------------------------------------------------------------------------------------X----------------B-----------X-------B-------------X-------B--------------B-------------------------
------------------------------------X------------------------------------------X--------------B----------X-------------X--------B----------------------------B------------------------------------------
---X-------------B----B-----------B-----------------------------------X--------------------------X--------------------------------------------------------------------------------------------X---------
----------X---X-------------------B-----------X--B------------------------B----------X-----X----------------B-----------------------------------B------------------------------------------------------v
-----------------------------B---------X---------------------------------------------------------X---------------------X-----B----------------------B----------------------X---------X-----------------f
-B-B----------------------------------B---X-------------------------------------------B----------------------------B----------------------------X--------X-B----------------------X--------------------f
------B--------------------------------------------------X-B-------X--------B--------------------------B--------------------------------------------B-----------X-X-------B------------B---------------f
---------------X------------X------------X--------------------B-------------B------------------------B------------------------------------B------------B-------------------B------X-------------B------f
-------B---------X------------------------------------------------------------------------------------------X---------B-------X------------------------------X--X-------------------B------------------f
----------------------------------B-----------------------------X----------------------------------------------------------------------------------------B---------------------------------------------f
m----B-------------------------------------------------------------------------------------------------------------------------------------------------------------------------------------------------X
XXXXXXXXXXXXXXXXXXXXXXXXXXXXXXXXXXXXXXXXXXXXXXXXXXXXXXXXXXXXXXXXXXXXXXXXXXXXXXXXXXXXXXXXXXXXXXXXXXXXXXXXXXXXXXXXXXXXXXXXXXXXXXXXXXXXXXXXXXXXXXXXXXXXXXXXXXXXXXXXXXXXXXXXXXXXXXXXXXXXXXXXXXXXXXXXXXXXXXXX
