---------------------------------------------------------------------------------------------------------------------------------------------------------------B------X--------------------------B------
-------------B-------------------------------------------------------------------------------------------------------------------------------------------------------------B---------X------??????X?-BB-
--------------------------------------------------------------------------------------------------------------------------------------------------------------------------?----?------------------------
-----T---------------------------------------------------------------------------------------------------------------------------------------------------------------------------------X----------------
-----|--------------------------------------------------------------------------------------------------------------------------------------------------------------------XBB-------BBBBBBBM--------B---
-----|----------------------------------------------------------------------------------------------------------------------------------------------------------------------------XBBBBX-X--------------
-----|----X--------------------------------------------------------------------------------------------------------------------------------------------------------------B-------------XX-X-X-----------
-----|----XX--------M---------------------------------------------------------------------------------------------------------------------------------------------------------------X--XXX-------------v
-----|----XXX-----------------------------------------------------------------------------------------------------------------------------------------------------------------------XX-XXXX------------f
-----|----XXXX-----------------------------------------------------------------------------------------------------------------------------------------------------?----B------XT---XXXXXXXXXX-----B--Xf
-----|----XXXXX----------------------------------------------------------------------------------------------------------------------------------------------------------------X|--XXXXXXXXXXXX?----X--f
-----|----XXXXXXo--------------------------------------------------------------------------------------------------------------------------------------------------------------X|XXXXXXXXXXXXXXX-------f
-----|----XXXXXXX--------------------------------------------------------------------------------------------------------------------------------------------------------------X|XXXXXXXXXXXXXXXX------f
-----|----XXXXXXXX-----------------------------------------------------------------------------------------------------------------------------------------------------------??X|XXXXXXXXXXXXXXXXX-----f
m----|----XXXXXXXXX-------E--------------------------------------------------------------------------------------------------------------------------------------------E-------X|XXXXXXXXXXXXXXXXXX-E--X
XXXXX|X--XXXXXXXXXXXXXXXXXXXXXXXXXXXXXXXXXXXXXXXXXXXXXXXXXXXXXXXXXXXXXXXXXXXXXXXXXXXXXXXXXXXXXXXXXXXXXXXXXXXXXXXXXXXXXXXXXXXXXXXXXXXXXXXXXXXXXXXXXXXXXXXXXXXXXXXXXXXXXXXXXXXXXXX|XXXXXXXXXXXXXXXXXXX--XX
