---o-o-----o-------------B-----B-o-----oo-----o-----oX----B-----------o------------B--o------o-----------o------B--------------B----B--------B-X---o-----------o------------------------X-B-----------X-
o-----X----Bo----------B-o-----------oX-------------B---B---------------------o-o-----o-X-------X-----B--------XX-----------------o---Boo---oB--o---B-o--o-Bo---o-----o--------o-------o-----X--B----oo-
-----------BE------------o--------oB--B-----------B-o-o-------B-Bo----X-o-------B-E-X--B---------B------------------------------X--o-----------X----o--B-o-XBo--X------B-----o---------------------o---o
--o-------o-B-----BB-------X------o---------B---------o--o---------------------ooo----------oBXB---------------BB-----------o-B-----B---------B-----X----o----B-X-o----B---o---o----------------B-o-----
-----X-XX----------------------Bo-------oB---o-----B-------------o---Bo----BX--------X--oXo-------B---------Bo--o-----X----o-o--o--oo------------o----o-----o------B--o-----BBoo--B-----B-o---o---------
---XX-------B--X-o-o--o-B--o------o-------oo----BB-------X-----------X---E-o----B---o------o-X-B-B---------------ooB---------------o-----o-X------?------------B------------X-o-o-o-oBX-----------B-o---
----------------o-------------o-------------X-E---------------X--o------------------------B-B-o-----B------oo-------------T----B--oo-Bo---oB-------B----B-o-----------B----B--o-----oX-oB------o-------B
-----o------B-o-----------o--o------Bo------oo-----------B--o-----o---o---B-o-ooB--Xo---B--BB-Bo-------E-B---o----------B-|------------oo------o---o---B--BX-oo-------X-------X-------E--o--o--B-------v
o----o-o----o-Xo-o---------------------o----o------oo-------B-Bo-XB-o---E--B-------o-------o-o---oX----------------B---B--|-----o-----o---X---B--B-B-------o--------X----X-----o-B-o-------BE--------BXf
-----B---oX-o--o--------B---o-o---B-X---o------o-o-Bo------------X------oB--o-B-----------------------Xo---o--X-o-X--o---o|---------------------o--B----B----X------B----------o------o------B--o---oX-f
---T--------B-B--o-B----------B--o----Xo-----BT-B--X-----o--------------B----o?--o--Mo------B----o------------------------|-----------B----B--------B----------B---o------------------o-BB---------E---f
---|-------B-----B-----XB---------oo----------|---XX-o-----o-o----o----------B-B--o--B--X-------B---o--------B----------B-|--o----Bo---------B---X--------------o---------B---o----------B-X----o------f
-B-|-----------Xo-------------------o---o----B|----------o----------------X-----o----o-B------------Xo----------------BB--|----o-o-B--oB------B-------o------E--B------X---?---o-o-----------------X---f
-E-|-B--------o------Xo----B--o--X-----------o|------oo----------B--o----------o----oo-----Xo------TX-BX--o-Bo------o-B--B|--?-B-B----------------B-----B------------X---------o----E-B-X---------o---of
mB-|----B----EB--E--------E-----B------E----B-|--o-------Boo-E---o--X------o---------o------B-B----|----------------E-----|-----B--o--------oB---o-------o---E-B---X-----X-------X-E-B---B-E----X---B--B
XXXXXXXXXXXXXXXXXXXXXXXXXXXXXXXXXXXXXXXXXXXXXXXXXXXXXXXXXXXXXXXXXXXXXXXXXXXXXXXXXXXXXXXXXXXXXXXXXXXXXXXXXXXXXXXXXXXXXXXXXXXXXXXXXXXXXXXXXXXXXXXXXXXXXXXXXXXXXXXXXXXXXXXXXXXXXXXXXXXXXXXXXXXXXXXXXXXXXXXX
