----oB--o--------------------------------------o-----B-o-o------B-----XB-------------B----------------Xo--------------------------BB--------X---------------o--------------B----------------------------
B-----------o-----------E--o---o-----B----Boo---B-----------o---o-------Bo-o--ooB----------------X-B-B----------------------o--------------B---------------------------Xo--------o---------X------------
-X-------o--o-----X------o------oX----B-------------------------o---------Bo----oB--X---X---------------------X---------oBo----B-----------o---E-o--------------oB----------X-----B-o---------------E--B
-----------BB-B-o--------------------------------------------------------o---------------o-----------------X----------B----B-----------X----------------B----o-X------X-o------------X----o----X--------
----o--B----o----B----------B----------------B----BX------B--------o---B-----B------------B-B--o------------oB-------BB---X--oX---o----------------X-----------o--o--------------------------B---X------
-----X-----E-------------------B------------o-----o------o-B------B-------------B-o--------------o?-------------BB-----oo--------o--------------X-----------X-------------------ooX---o-------o---------
----------o---oB-----o--------------o--B--------B---o---o---------------o----o-----------o----------------------------E-o-------B----o-------------?------B----o----o---B-----o---o-----o-o----?o-----o-
---o-------E-----------X---------o-o------B-----o-------------------Bo---o-------------o-o-o--X-----------------oo---------------------oo------E--o---------------o-------------------------X-o------B-v
-----------B--o----o-------------------------------------oX-----o-------------X-----o-B---X-----E------------------o--------o--o-o-o--------oB-B----B---------o-B-------B---o--B----X--------B--o------f
----B---B---X--o---------o-o--o--B---o--B--B----------X--X----X--------o------o----------o------o--BX----------o-B--BoB-------BX-------------------------o--B---XB----o-----------X------Eo-------o-X--f
----------------------------X---o------o----o-------B---------o------o--------------------o----X-Bo-o----------E--o----B---------------------------B-B-----------o-o-----------o-o---------B-----------f
-----------B------------Bo---o----------oo-o---o-B--------o-o--B--------oo-------o------B---XXo-X-------------X------o---o--o----------B-----o-o---------o--o---------o------------o-X-----------X----Bf
-B------X--o---o---------oo-----B-o-------------XX---------oB--------B-----B-------o-o------o--------------------B---o-----o---------o-----oE------------------o------------X--X-----o------o-------BB-f
--------------o-------Bo---X-----o-----Bo--B-----o---B-------------------o--------o-----o--EB--------X-o----Xo-B--B----o-o-o------B-------E--oB----o---------BB---------o--------------o-X-----o-------f
m---------X-E------X---E-----------------X-B------B-----X---oBo-B---------B--o---------B-------o-------------oo----X-B------o----B----o-B----------B---------o-----o-B---o------------B-o------------EoX
XXXXXXXXXXXXXXXXXXXXXXXXXXXXXXXXXXXXXXXXXXXXXXXXXXXXXXXXXXXXXXXXXXXXXXXXXXXXXXXXXXXXXXXXXXXXXXXXXXXXXXXXXXXXXXXXXXXXXXXXXXXXXXXXXXXXXXXXXXXXXXXXXXXXXXXXXXXXXXXXXXXXXXXXXXXXXXXXXXXXXXXXXXXXXXXXXXXXXXXX
