-----------o-------o-----o-----o--------------o----o------------oo--------------o-------------------B-----o---o-o---X----------------B---------------X-----B--oo---------------X--------o---B------o----
------------o--------o--oX-----oX-----B-----X--B--------BB-------X-XB-------o------------------B----------o------o----------?--------B-----o----------X---o-------------------B----B-----------o------Bo
-------o------oo--B---o-----o-o------E---o-o-X----B-------------B----------------B-o--Xo----------------B------o----o-----B----B---------------o---o---o-----o------X-----X----------------------------o
-o-X-----------o-o-------------o--B----o----Bo--o-----------B---o----o---o--o---------oXB--B-B--oB----o--------------E--E--o----------o----o---------------------B--------------B---B------Bo-----------
-o-E---o----------oB---o---------------o---------o---------o------------B---------------B--o-o-ooX-------------------B-----X--------------------------------------B--?---------o-o-----o--B------------o
--o----B--X-B--ooo-o--------X-------------B----o--B-o--------oXo-oX--Boo------o------X-------B---E--------B-o-B-------oE---B-------B-----B---oBo-B--B----o-o------------B---o-----B------------BB-------
-B-------B------XB----o----oo---B-----o----o-o-B--o---o----------B--------B------B-----o---oBo--B---E--o--------------o----------B-BX--o----------oB-B-E---o----B----o---o----------XB-X-----------X----
-----------------?-----X-o--------------------X---o---X----------------X-B------Xo-o---o----------------o--------o---------------o---B-----o---BB-B-------o-B--ooo-o--oB-----o----------------------E-Xv
----o----------------o------B----B--------BX-BX---------------oX--------------B---o---------------XB----o------Bo---o---------X-----------o--o-o--oX----------B----oB---o-oo-B--B---o-o--o--o-------o--f
--X---X------o---?----o--------o-o-X----B-------------------o----ooo--------B----------o-B----o-o---o-o--------o---------B-----------B-------X--------oo----------Boo-o-----o--X----B----B--------o----f
-X-------------------o-o----o--o---------o---------o----------------B--o-B---o--------B----o-----oo-------------E--B-------o---o----------------o--o--oB----B--------o-------oo----B------B--o-B-oX----f
--oBB-------o------X-------o-----E---o---X--------B--oB-B-o--o-B-------o--B-------o-------B-B----o-------------o-------o--oo-----o-o-----------------------o-X---------o--------oo---E-o------o------oof
---X---o---------o------------o---o---o----B----------------------o-o-B-----oo---o-oB-o-o--B-----o----------------B---o---------M----o-----o---------o-----o----------------o-B---------B----Xo---o--X-f
--o-------------X--E--------------------o------------o------------------------------------X-----------o---------------o---------------oo---------o----B--------------------------------------B---oB--o-f
m------o----o-B--o------B---------o------B-B----o--BX---o-B-----o--o-------B-----BoB-?--ooM---B----o-BB--------------B--B--o--------B-X--o-o--o--o----B--B---X---o------X---o---o------o--oB-------BE--X
XXXXXXXXXXXXXXXXXXXXXXXXXXXXXXXXXXXXXXXXXXXXXXXXXXXXXXXXXXXXXXXXXXXXXXXXXXXXXXXXXXXXXXXXXXXXXXXXXXXXXXXXXXXXXXXXXXXXXXXXXXXXXXXXXXXXXXXXXXXXXXXXXXXXXXXXXXXXXXXXXXXXXXXXXXXXXXXXXXXXXXXXXXXXXXXXXXXXXXXX
