--------------------------------------------------------------------------------------------------???????-----------------------------------------------------------------------------------------------
-----------------------------------------------------------------------------------------------------XXXXXX------------------------???????--------------------------------------------------------------
--------o------------------------------------------------------------------------o----------------------------------------------------------------------------------------------------------------------
--------------------------------------------------------------------------------------------------o-----------------------------------------------------------------------------------------------------
--?-------------------------------------------------------------------------X---------------------------------------------------------------------------------------------------------------------------
-------------------XX-----------------------------------------------------------------------------------------------------------------------------------------------------------------------------------
----------------------------------------------------------------------------------------------------------------------------------------------------X---------------------------------------------------
------------------------------------------------------------------------------------------BBBBB--------------------------------------------------------------------------------------------------------v
--------------X-----------------------------------------------------------------------------------X----------------------------------------------------------------------------------------------------f
-------------------------------------------------------------------------------------------------------------------------------------------XXXXX-------------------------------------------------------f
-----------------------------------------------------------------------------------BBBBBBB----------------------????-----------------------------------------------------------------------------------f
-------------------------------------------------------------------------------------?---------T----------------------------------------------------------------------------------------------------XXXf
-????-XXXXXXXX------------------------------------------------------------XXXXX---------X------|---------------------------------------------------------o---------------------------------------------f
---------------XXX----------------------------------------------------------------------XXX----|-------------------------------------------------------------------------------------------------------f
m---E-----------------------------------------------------------------------------------XXXXBBB|BBBB-----XXXXXXXX----------------------------X--------EBBBB-----------E----????????--------------------X
XXXXX---XX---XXXXXXXXXXXXXXXXXXXXXXXXXXXXXXXXXXXXXXXXXXXXXXXXXXXXXXXXXXXXXXXXXXXXXXXXXXXXXXXXXX|XXXXXXXXXXX-XXXXXXXXXXXXXXXXXXXXXXoXXXXXXXXXXXXXXXXXXXXXXXXXXXXXXXXXXXXXXXXXXXXXXXXXXXXXXXXXXXXXXXXXXXXX
