---------------------------X----------------------------------------------------------------------------------------------------------------------------------------------------B-B-------X-------------
--------------------------------????????----------------------------------------------------------------------------------------------------------------------------------B-----o------------------B----
---------------------------------------------------------------------------------------------------------------------------------------------------------------------X---X------------------------------
---------------------------------------------------------------------------------------------------------------------------------------------X------------------------XX--B----B--------------B---------
-------------B------------------------------------------------------------------------------------------------------------------------------------------------------------X-----M-----------------------
------------------------------------------------------------------------------------------------------------------------------------------------------------------B------XXXB------------?--?????-------
-------X------------------B------------------------------------------------------------------------------------------------------------------------------------X--------XXX-X-o-----X-------------------
-------------------------------BT---B----------------B-----------------------------------------------------------------------------------------------------------------XXXXXXXXX-----X----------X------v
--------------------------------|----------------------------------------------------------------------------------------------------------------------------------XBBXXXXXXX-----T------------XX--o---f
--------------------------X-----|----------------------------------------------------------------------------------------------------------------B-------------------XXXXXXXX-----|X-----?????XXX------f
----------------------X------X--|-----------------------------------------------------------------------------------------------------------------------------------XXXXXXXXXT----|----------XXXX------f
-----------------XX------------B|--------------------------------XXXXXXXX------------------------------------------------------------------------------------------XXXXXXXXXX|BBBB|B------BBXXXXX------f
--------------------------------|---X-----------------------------------------------------------------------------------------------------------------------------XXXXXXXXXXX|-X??|?X------XXXXXX------f
--------------------------------|------------------------------------------------------------------------------------------------------------------------X------BXXXXXXXXXXXX|XX--|-----T-XXXXXXX------f
m---------------------------E---|-------E-----------------------------------------------------------------------------------------------------------------------XXXXXXXXXXXXX|XX--|-B-E-|XXXXXXXX----E-X
XXXXXXXXXXXXXXXXXXXXXXXXX----XXX|XXXXXXXXXXXXXXXXXXXXXXXXXXXXXXXXXXXXXXXXXXXXXXXXXXXXXXXXXXXXXXXXXXXXXXXXXXXXXXXXXXXXXXXXXXXXXXXXXXXXXXXXXXXXXXXXXXXXXXXXXXXXXXXXXXXXXXXXXXXX|XX--|X-XXX|XXXXXXXXXX----X
