X---o---o--B--------oo-o--------BBB-----o--------X-----------o-----X---oB---X---B---o--------B-------------------------B---o------------------o--------o---o---------oB-----B------o--o--B--T----o------
-----oo--o--XX--B-------B--B-----------o------X-o-E--B--X-o--XooBo--B-----B--o--o--X--Xo-----X-X----------------------oB----B-B-XoX-----------B----B---X------B--B-?----o---B--o-o---oBo----|-------o--X
---------oB---o---X-B---X------X--B-----------------o--------E----B--o-----o-----------------BX------o----Xo---X----XBX--o----o-----o----------o-----B-------X-----------Xo---o---------B-Xo|--------o--
X-----X---X----------oB-----o-B---Bo-o-----------B--------B-----X-o-B-------------o-----------------------------------X-o--B--o-------X-B--B----B--B-----E--------o--------------o------o---|--B--------
--o-o--------------------B---o------------Bo---B-B------------o----------o-Bo-------E-----B--B----oXBM---B----B----o-------B------------B-------XBo-----oBoo-----?---B-----------oo----Bo---|-----B-----
-T---o-oo-------oo-o-B--------X--BoX---o-----B----M---o----B---o---B------X---o-B-----o---o-----B--------------------------X------Bo----oB----BXo------------o--B-B--oB---oX------X--------o|--oT----E--
B|--o-----o-------X---o-----B---oo-----B---o-Bo--o---------------o--X-B----------------o-------------E----X-B-X----------B---------o-o---o-----------BB---------oB----o----------------o----|---|---E---
-|-B---------o-o-----X-------B--X---B-B-------Xoo---o-------o-B-----Bo--------o------o-B-B-o-----o-------o---Xo----------o--------Boo-B---o--o---ooB-ooBo------------B------------B-----o--o|-o-|------v
B|----XE-----T---o-B----------------oEo-XB--X-----o-------BX--B--------oB----------------oX------------o--B--------o------------------oo----BB-E-B----B-o--o-B----o--o-o---------o---o------|---|------f
-|--BX---o---|--X--------o-------------------X------B-----BB-B--------o---B----------------oB--o--o------------B-----X--o----o--------X--------E-B----oo-----o-------X----B--------B-oX---oX|---|--o-B-f
o|---oX--o---|-o--o---X-BBo----B-o----B-------------o--oB---o--E--X---oB-X-----oBB---o--o-o--X--------o----Bo----B--X--o--------------o------o-o---------oX-Bo---M------B------------o----o-|---|--B---f
-|-----o-----|-----------------B----------o-----------------o-B---o-X--------------------Xo-o--------B----X------E-------B-----o---B--ooB------------------------------Xoo-------oo----X-B--|---|--B-B-f
-|--EoX----oo|-o-----B-X---------o-B---------------o---------------o------------B---------B------------o--B---T--oo----X--o----B-----o-------------B---BX------o----o---B----------------XB-|---|------f
-|-oXo---X--o|---B-B----o------oB---X-----------------E------B-B-B-----B----o--BX---X----------B--B---o--B--B-|--------E-o---------T------o--------BB-----------o--B-o--o----------o-o-----B|--X|------f
m|--------E--|-----BB-----B-------o-------------B------X-------o---B--o-------o-----ooBX-------o------B--E----|-o------BX--o-------|---E---X----B-Eo--o---o----B-----E------EX-----o------o-|---|-------
XXXXXXXXXXXXXXXXXXXXXXXXXXXXXXXXXXXXXXXXXXXXXXXXXXXXXXXXXXXXXXXXXXXXXXXXXXXXXXXXXXXXXXXXXXXXXXXXXXXXXXXXXXXXXXXXXXXXXXXXXXXXXXXXXXXXXXXXXXXXXXXXXXXXXXXXXXXXXXXXXXXXXXXXXXXXXXXXXXXXXXXXXXXXXXXXXXXXXXXX
