--------X------------------------------------B---------------------------X-X------------------B-------------------B------------------------B---------------B--------------------------------------------
-----------------B-----------------------------------------------B-------------------------------------------B-------------------B-------------------------B------------B-------------------------------
-------------------X---------------------------X--------B------X------------------------------B-------------------X-------------------------------------------------------------------------------------
-----------------------------------------------------B---------------------------------X-------------------------------------------------------------------------------------------X----------------B---
---B---------------------B--------------------X-X--------------------------------------------X-------------------------------------------X---------X----------------------------------------------------
----------------------------------B------------------------------------------------------B------------------------B-----------------------B------X--X-------------------X---------------------------X---
----------------------------------X--------------------------------------X-----X-------------------------------------------------X-----------------------------------B----B-----------------------------
----X----------X--------------------------------------------------------------------------------------X------------X------------------------------------------------------B----------------------------v
--------X----------------------------------B------X-----------------X-------------------B-------------B----------------------------X------------------------------X--------------------------------X---f
--X----------------------------B------BX------------X------X--X--------------X------------------X------------B-----------------------B---X-------X----X------X------------------------B----------------f
------------------------------------------------------B--------------------------X---------------------------------------B-----------------------------------------------------------------------------f
--------------------B--------------B-----------------B------------X----------------------X-----------------------------------------------------B-------------------------------------------------------f
---------------------------------X-----------------B--------X---XB------------------------------X------B-----------------------------------------------------------------------------------B--------X--f
----------------------------X----------------------B--------------------------------------B-X-------------B-------------------X-----------------X--------BX-------------------------B------------------f
m---B---------------B---------------------------------------------------------------------B----X----B--------------------------------------------------------------------------------------------------X
XXXBXXXXXXXXXXXXXXXXXXXXXXXXXXXXXXXXXXXXXXXXXXXXXXXXXXXXXXXXXXXXXXXXXXXXXXXXXXXXXXXXXXXXBXXXXXXXXXXXXXXXXXXXXXXXXXXXXXXXXXXXXXXXXXXXXXXXXXXXXXXXXXXBXXXXXXXXXXXXXXXXXXXXXXXXXXXXXXXXXXXXXXXXXXXXXXXXXXXX
