--------------------X-----------------------------------------------------------------------------------------------------------------------------------------------------------------------------------
---------------------------X------------------------------------------------------------------------------------------------------------------------------------B---------------------------------------
--------------------------------------------------------------------------------------------------------------------------------------------------------------------------------------------------------
------------------B--------------------------------------------------------B----------------------------------------------------------------------------------------------------------------------------
-?--------------------------------------------------------------------------------X----------------------------------XXX---------X----------------------------------------------------------------------
--------------------------------------------------------------------------------------X-o----------------------X-----------------o----------------------------------------------------------------------
-------------------B-------------------------------------------------------------------------------------------------------B-------------------------B--------------------------------------------------
--------------------------------XXXXXXX----------------------------------------------------------------------------------------------------------------------------------------------------------------v
-------------------------------------------------------------------------------------------------------------------------------------------------------------------------------------------------------f
-------X-------------------------------------------------------------------------------------------------------------------------------------------------------------------------------X-----?---------f
----------------------------------------------------------------------------------------------------------------------------------------------------------------------------X--------------------------f
------------------X----------------------------------------------T--B------------------------------------B------------------------------------------------------------B------o-------------------------f
--------------------------------------------------------------T--|------------------------------------------------------------------------------------X------------------------------------------------f
-------------X------------------------------------------------|--|--------------------------------------------------------------------X-----------------------------o----------------------------------f
m-E-------E--XX-----------------------------------------------|o-|--XXXX-----------E-X------------------E-----------------------------X----------------------------------------------------------------X
XXXXXXXXXXXXXXXXXXXXXXXXXXXXXXXXXXXXXXXXXXXXXXXXXXXXXXXXX?XXXX|XX|XXXXXBXXXXXXXXXXXXXXXXXXXXXXXXXXXXXXXXXXXXXXXXXXXXXXXXXXXXXXXXXXXXXXXXXXXX-----XXXXXXXXXXXXXXXX-----XXXXXXXXXXXXXXXXXXXXXXXXXXXXXXXXXX
