----------------oB---------X-----o---------------------------o-X--B--X----X-------------XB----------X-B----X--------------------X-----BXo-o---BB------------oo------o--------o------------------------BB
-----------B-BEo------B-B------o-o--oB-----MX-------o-oB----B------o-----o-----------------------oB---o--------o-----o-oXo---------o--B---o----B-o--------o-----XB-------B-BXB-----------o--o--B----o---
---------?-B--o---o----BB--------o-----Bo-----oo-----B------B------BBo------E-BB-------o-----B---------o----------o---------X-X--B---o------oo----------------o---o------o-------------o-----o----?-----
------X----o--B---Bo--o-o---B----------o------o--oX--X---X-B--o-B-------o---X---o---o----X-----oo-B---X----o--o-o-E-------B--B---------BB--------BB-oB----o---o----o-------T-o-oB----Bo---Eoo----oooE--o
o---------------o------o-------B--------o---B-B-------X-----o--X------B----------B-------o----------B--------------------------o---BB-B--------------o----------------B----|----X-------------oo---XX-o-
--X-o--B---------BT----o-------X---B--------------oB-----X--o------o----B--B--------------XoXB----o----B--B------o-X--B-B-----------------oM-------B---------o--B----------|--BoX--------T----X---------
-----B-----T------|-------------oB--B----B-----o--Xo------B--o-E-o-------X--o----oo-----X-------B---oo------o---o--------B-------E---------XB---B-B--------o-------B----B--|-----B-X-B--B|-oBo--------oo
oo--Boo----|-o----|-oo-----E-B---B----X--------o----o-----o-X-----o------o-oBE------o-o-B-------B----oo----o-------------------Xo-------o---------X--------X------oo-------|--------B----|-------------v
-----B--X-o|-X----|--TB--o-------o---B-------X--B------oX--B-----X--T--------X-----Bo-----X---------o-----o-?---X-?----------------X-Bo-----------oB----B--------o---------|-o-----------|----o------oXf
-----Bo----|-o--o-|--|---o-----Xo----oB-------BB-o---o------BBX-----|-Bo-------X-----o--oB---o---B-T--B--o--B--B----o---X---oBo-o----o--------B-B-----------B---oo------Xo-|--X-o--------|----o-B-oo---f
--o--oB-X--|---o--|-o|--------X--------B-B-------E--------B----B----|---oo----B-B-o--B--M-----X--o-|-oo-----o---------X---Xo----Xo--B-------oBB--B---X----------X---o---oo-|--o--B---XX-o|-o-X------o--f
--X-----BBo|---o--|--|---------T--X---------------o----XB--------B--|---------------oB-------o-----|-o------X-----------------------B----B--B----B---------o--------E---X--|----------T-o|-------o-----f
o--------o-|--o--B|--|---------|-------ooo---o--B-----oo-------o---o|----B---------------B--o-B-X--|-B--X------B---oB--o----oBo-----oB---------oB-------B-----oo------o----|-o-B--o---|--|------------of
X---------B|------|--|----X---B|-o--------oE-o-------o-o---------X--|-o--------E-E------B-------o--|--------o-------o-----Bo----B--X---o---X--B---E--o-BB----o-------------|--o--oX-X-|--|----o--------f
m---------o|------|--|----oEE-B|------E---B---E-o------B------E---o-|--oE-E--E-E-Eo-------oB-------|---E----Xo-X--------B-------E------o-oE---B------------B----oo?-oEB--o-|---o------|--|-----o--o-----
XXXXXXXXXXXXXXXXXXXXXXXXXXXXXXXXXXXXXXXXXXXXXXXXXXXXXXXXXXXXXXXXXXXXXXXXXXXXXXXXXXXXXXXXXXXXXXXXXXXXXXXXXXXXXXXXXXXXXXXXXXXXXXXXXXXXXXXXXXXXXXXXXXXXXXXXXXXXXXXXXXXXXXXXXXXXXXXXXXXXXXXXXXXXXXXXXXXXXXXX
