--------------XX----------------------------------------------------------------------------------------------------------------------------------------------------------------------------------------
--------------BBBB----------------------------------------------------------------------------------------------------------------------------------------------------------------------BBBBBBBB--------
--------------------------------------------------------------------------------------------------------------------------------------------------------------------------------------------------------
--------------------------------------------------------------------------------------------------------------------------------------------------------------------------------------------------------
--------------------------------------------------------------------------------------------------------------------------------------------------------------------------------------------------------
-----------------------------------------------------M-----XXXXXXX--------------------------------------------------------------------------------------------------------------------------------------
----------------------------------------------------------------------------------------------------------------------------------------------------------------------------------------------------X---
--------------------------------BBBBBB-----------------------------------------------------------------------------------------------------------------------------------------------------------------v
-----------------------------???????-------------------------------------------------------------------------------------------------------------------------------------------------------------------f
---------BBBBB-------X-------------------------------------------------------------------BB------------------------------------------------------------------------------------------------------------f
---------------------XX--------------------------------------------------BBBBBBB-----------------------------------------------------------------------------------------------------------------------f
------XXXXXXX--------XXX--------------------------------------------------------------------------BBBBB------------------------------------------------------------------------------------------------f
---------------------XXXX---------------------------------------------------------------X-------------------------------------------------------------------------------------------------------------Xf
---------------------XXXXX----???----T-------------------------------------------------XX-------------------------------------------------------------------------------------------------------------Xf
m--------------------XXXXXX----------|E-----------------------------------------------XXX------------------------------------------------------------------------------------------------------------XXX
XXXXXXXXXXXXXXXXXXXXXXXXXXXXXXXXXXXXX|XXXXXXXXXXXXXXXXXXXXXXXXXXXXXXXXXXXXXXXXXXXXXXXXXXXXXXXXXXXXXXXXXXXXXXXXXXXXXXXXXXXXXXXXXXXXXXXXXXXXXXXXXXXXXXXXXXXXXXXXXXXXXXXXXXXXXXXXXXXXXXXXXXXXXXXXXXXXXXXXXX
