--o--B----------B--------------o--o----B---o--X--------------------------------------------------o-------------o---o-o--X------------------------B-o----B----------------------------------B------------
-o---------o--------o-------B----------------B----------------B--o--------X------------B--------?--------B-o--o-------o----------------B-?B----------XEB------Bo-----B------------X------B-B----B-------
---o-------X---o---------X----------o---------X-o---ooB--------------B-------o--------B------o----------------X-B-------------Xooo-o------o-------o-----o---------B-----X-o-o--o--o---------oB----------
------X-----B------o------------X----------X----BX-o---oB---B--------------------E-o--B-B---------------o----------------B--Bo-------------------B---o-------B------------------------B-------o--B-----B
------------o-----------------o----------------o----------BX--o--B-------B-B---B-B------E--o----------o---?--o------E-------B--B----------------------------o-----o-----oB----X--X-------B--------------
-----Xo---------B--o------B-----o-------B--------oo---X---Xo------X---o-o-o---o--------oX-o-?---------BX------oo---X-oo----oo---o---B-oB----------X---------X--------BX----o---------o------oo--------B-
------------o--X------B-oX------o----EBo---o-----oXo-------------------B-----------------------------X----------------Xoo---o-X------o---------o-o-oX------o--------------BX----------o----------o------
-----B-o---B-------o-o-----------B---X-Bo---------------------o----o-B---X---o-------------X----------Bo-o-----oo-------------------oBo-o------Bo--o-B-X---------o------------B----------------X------ov
-o-X----------o-----B--X------------------------o----BX-X---??o--------XX----B------------o-----X-----B---------------X-B-o-------------------o--------------------o---o------X---------B--B----X-o----f
-o---------XE---BX----o----o--B--B------X---Xo--B--X---o------------------o-----o-B---B-o------X-?B-----B------o--BXo--B------------o-----B-----------------o----B---o-------o------B-----oX------o----f
---o-----o-------o----o--o---B----------Bo-----------------o--B----------------------o-------B-----E---------o-------B------------------B---o-o-----X--------X---B--B-----BBB--------------------------f
-oX----B-----------o--------------X--BBo-------o---B------oo---oB----------o--------oB----o-Xo-------o------E-------------o------o---o----B--o-------------B------o-----X----o-o-B---------------------f
----------B----o-oo-------o-------------------------X------------------oo----------o---o---------------o---o-------------X----------o--o-----B----X----------o-o-o------B-------B-------------BXB---Xo-f
---------B------------o--------------B---------B---o--o---------X-B--o----B----------X--o--X----o--E-B----o------B-B----------B-B-------B--o------BBB-B---o------oB--o----o---oo-------o---o---ooBB----f
m--o-B-------o---o---------E--X-o--------B------X----B----B----X-----X---Xo------o----------X--oo-X--------------X------o----o---oo-------B-o---o-------o-B-X----B--X------------B------oB-----oB---B--X
XXXXXXXXXXXXXXXXXXXXXXXXXXXXXXXXXXXXXXXXXXXXXXXXXXXXXXXXXXXXXXXXXXXXXXXXXXXXXXXXXXXXXXXXXXXXXXXXXXXXXXXXXXXXXXXXXXXXXXXXXXXXXXXXXXXXXXXXXXXXXXXXXXXXXXXXXXXXXXXXXXXXXXXXXXXXXXXXXXXXXXXXXXXXXXXXXXXXXXXX
