---------------------------X------------------------------------------------------------------------------------B------------X---B------X-XXoXo-----X----X------------------------B----M----------?????-
--------------------------------????????-----------------------------------------------------------------B-------------------------B--------BX--B-----------------BB------B---X----??-------------------
--------------------------------------------------------------------------------------M----------XXXXX-------X----X--B---X--B-------B---M-------B--------X-----------------------------------------B-X--
---------------------------------------------------------------------------------------------------B------------o------B---------B---B------TX-XXXXoXX---o--oT-------X--BBB-T---------------------------
-------------B----------------------------------------------------------o----------------------------------X-----oB----------X-Xo--T-BXB-X--|---------o----X-|------------B-|---------------------------
----------------------------------------------------------------------------------------------XXXXXo-------------------M----------X|-XX--B--|T--XB--------XX-|----------X---|---------------X----X------
-------X------------------B----------------------------------------------------------------------------------X---------B----B????X-|XXX-----||------B-XM-XXX-|-X--BXBB--XX--|-X------------XX----XX-----
-------------------------------BT---B----------------B----------------------------------------------X-----B-------X---XXB-------BXX|XXX-oXB-||--------XXXXXX-|T---------XXXX|XXXXX--------XXX-X--XXX---v
--------------------------------|---------------------------------------------------------B-o----------------------B--XT-oo-----TXX|XXX?----||-TX-----XXXXXX-||-----BX--XXXX|XX-B--------XXXX---BXXXX--f
--------------------------X-----|--------------------------------------------------------------------------B---------XX|--T-----|XX|XXXBBBBB||-|-B----XXXXXXo||-B-------XXXX|XX-----BX--XXXXX--BBXXXXX-f
----------------------X------X--|------------------------------------------------------M----------------XXX---------XXX|-B|--???|XX|XXX-B---||-|X----XXXXXXX-||---------XXXX|XX------XXXXXXXX----XXXXXXf
-----------------XX------------B|--------------------------------XXXXXXXX--------------------------------T-T---X-B-XXXX|--|---XX|XX|XXXX----||-|---BXXXXXXXXX||----BBBBXXXXX|XXBBBBB-XXXXXXXX----XXXXXXf
--------------------------------|---X-----------------------------------------------------X-X-------X----|-|------XXXXX|--|T--XX|XX|XXXX---X||-|-X-XTXXXXXXXX||BBBX---XXXXXX|XXX?????XXXXXXXX---XXXXXXXf
--------------------------------|-----------------------------------------------------B-------------XX---|-|----BXXXXXX|--||-XXX|XX|XXXXX-XX||-|B-XX|XXXXXXXX||---XX-XXXXXXX|XXXX--oXXXXXXXXX----XXXXXXf
m---------------------------E---|-------E--------------------E-------------------------E------------XXX--|-|E---XXXXXXX|EE||XXXX|XX|XXXXXXXX||-|XXXX|XXXXXXXX||---XXXXXXXXXX|XXXXX-XXXXXXXXXX----XXXXXXX
XXXXXXXXXXXXXXXXXXXXXXXXX----XXX|XXXXXXXXXXXXXXXXXXXXXXXXXXXXXXXXXXXXXXXXXXXXXXXXXXXXXXXXXXXXXXXBXXXXXXX-|X|XX-XXXXXXXX|BX||XXXX|XX|XXXXXXXX||-|XXXX|XXXXXXXX||XXXXXXXXXXXXX|XXXXXXXXXXXXXXXX----XXXXXXX
