--------------------------------------------------------------------------------------------------------------------------------------------------------------------------------------------------------
-----------------------------------------------------------------------------------------------------------------------------o------------------------------------------o-----------BBBB----------------
----------------B----------------------------------------------------------------------------?---------------o------------------------------------------------------------------------------------------
-----o----------------------------------------------------------------------------------?-------------XBBBBBB-------------------------------------------------------------------------------------------
--------------------------------------------------------X--------------------------------X--------------------------------------------------------------------------------------------------------------
----------------------------------------------------------------------------------------XX--??-----------------------------------------------------------?----------------------------------------------
-----------------------------------------------------------------------------X---------XXX--------------------------------------------------------------------------------------------------------------
---------------------------------------B----------------------------------------------XXXX-------------------------------------------------------BB----------------------------------------------------v
------o-------------------------------------------------------M----------------------XXXXX-------------------------------------------------------------------------------------------------------------f
--o---------------------------------------------------------------------------------XXXXXX--------------------------------------------------------------------------------------------X----------------f
-------------------------------------------------------B---------------------------XXXXXXX-----------------------o------------------o------------------------------------------------------------------f
----------------------------------------------------------------------------------XXXXXXXX-------------------------------BB----------------------------------------------------------------T--X--------f
----------------M------------------------------------------T---------------------XXXXXXXXXo----------------T-------------------------------------------------------------------------------|--XX-------f
------------------------X----------------------------------|--------------------XXXXXXXXXX-----o-----------|---------------?---------------------------------------------------------------|--XXX------f
m----------------------XX----------------------------------|-----E-------------XXXXXXXXXXX-----------------|-------------------------------------------------------------------------------|--XXXX-----X
XXXXXXXXXXXXXXXXXXXXXXXXXXXXXXXXXXXXXXXXXXXXXXXXXXXXXXXXXXX|XXXXXXXXXXXXXXXXXXXXXXXXXXXXXX-----XXXXXXXXXXXX|XXXXMXXXXXXXXXXXXXXXXXXXXXXXXX-XXXXXXXXXXXXXXXXXXX-------XXXXXXXXXX-------XX--X|XXXXXXXXXXXX
