---------B----o------o--------------o---oB------------oo--o--------------B-------X-----------------B------o----o---------------Bo------------------?----B-B---------XB----------B----B-----B------------
--B-------X-------X---------o---o-------------------oX---------------B-o-------o-------o--B----B----------B---o-B-Xo-------------o--------B-------X--E--o---------------------------------------oBo-----
-------XX-B----------------------o-BB-o--------B------B--o--o------------B---------------o-----XBB--B-----BB--------Boo---------o--X----------o----o-------X-o--------------------o---X-----B-o--------E
---------E-----------o-------------X---------o----B-----oX-----------o---------E---------o----B--o-------------B----B--EoB-o------------o-------B--------------E----B--o------o------------B----B-o-E--B
-------------o---o-----------------B----B-o-o-X-o---------------------B--------X---oB-----X--B-X-B--------------o-o----B-?--------o-o----B---B-----------o--BXo--B------oo--X-----------o-----o---------
----o-----o-----o---B-B--------o--X----------E-------o--B-------X--B-o-o------o---------o--o---B-----------------X-B-o--o---------------o--X---o------?-------------B----oo----------o--X-----o-o-------
--X----------------------oXX--------B-------------X----B-------X------B---------------B--o---o----------o-------B--o----o---?oB----B--------o------------------o--------------o--------B----------------
---------------o-------o--------------B----o-----------o--X-----------X-B-------------X------o----------o-oo----X----B--o----M-------oB---o---------o------------X-o-----------------o-----------------v
-----Xoo----o---o-------o---------B-----X-----------------X----B--------------B---B--------o---X-B---------------B------B-----o---------------------B-B--Xo------o---------o-------------oo-B-o--B-----f
--oX---B----Xo--------o--o--------o---o------o----oo--o-o---B---oB---------------o-----o-----------------o--------------o---B--B-o-oX------oo---o-------------------o---------X-BoB-----o------o-------f
----o----o----------B---B-----o----------EX----------B--o---B--X--XB-----B---------------B------------------B---B--o------B-----------------o----o----B-----B----------o-o-o-B------B-----B--B---o-----f
----------o---B--------o--o--B---o--X----o----o-X----B--B------X--B-----X--------B------o-B-oB--------o--------------o-----X-----------BB--B---------------------o-o----o-o--o--BX-------------------?-f
-B-------X----------o------B----------o--------o----------X--------B----------B-------o--X--X-------o---------------B---X-oX-B--o-X--------Bo------oB--o-B----------B--X----B---X---oo-X-o------o------f
----------------B--------X--Bo----E----X-B---X-oo----------o--BX-o-o-XX-----o-B------------------o---B------X--oX------o-------BE--o------------X-B--------------------o----B-------o---Boo----o-B-Bo-Xf
m-o------B-X--o----oo---------B-oX------------o-----oB-----X----X-B---B-------------E--------oo--------o---B---------------------B----o------o--B--Xo--------------------------------------o-B--oooB---X
XXXXXXXXXXXXXXXXXXXXXXXXXXXXXXXXXXXXXXXXXXXXXXXXXXXXXXXXXXXXXXXXXXXXXXXXXXXXXXXXXXXXXXXXXXXXXXXXXXXXXXXXXXXXXXXXXXXXXXXXXXXXXXXXXXXXXXXXXXXXXXXXXXXXXXXXXXXXXXXXXXXXXXXXXXXXXXXXXXXXXXXXXXXXXXXXXXXXXXXX
