--X---------------------o----------------------------------------------------------o-B----B------------------------------------o-------------------------------o-------o--------------------------------
----B----B----------o--------------------X-------------Bo----------------o-------------------------------B----------X-----------o-------------------o-----o--------------B-B-X----o---X-------o--o------
--oo-X-B--------------------------------------------X----------------------B-------o--oo----------------o-o--------------------o-o---o--------B--------B---o-----------B--------o------X-----o------B---
--------o--------------o--------oo-o-----oE--------------------B-----o--o----X-B----B-o---------o---------o--------X--------o-------B------o---------------B--?B---------------------B--------B---------
-----------------XXB-----B---------B-----------------X-------------B--------B----------E---------------o-----------------------X------------o----Bo----------------o--------o---o-----------o-o------o--
---o--o-----------------o-------o-X-----B--------o-o-----B----o--X-o-------------------X--X----XoB--------------o----------B-------o---------B---o---X-B----X-----------------B----?---B---o------------
-----B------X----o----------------X---------X--------o--------o------o---------B------o-----X----------X-o--------------B------------------------B--------------o----------------------o------B-------B-
-o--------B-------Eo-------------------------------X------B----o-----------o-o--X---------------------------X------o--o-------B-------B---XX---------------X--o-------------o-----o----------------o-o-v
---o----------------------o----X-----------X-o--B-------o------------------o---------------------o-Boo-------X-----oB----B--B------o----------o------------------Xo---o-----o---o----------o-o--o-----of
------------------X-B-----------o--o-------X---o--------B---------B----------------------X----B--o----------o---E------------B-----------------------o---------------------?--oB--B--------------------f
--X--o----------o------------------B----------X--------o----o--------------B---------------o---------------------------------------o---------oB------B-----X-o--o-----------E--o-----------o---X----o--f
-------B--------------o------X------------X-B----o----Bo-------------------o---------------XoB--o-----------------------o-----------------o-------------------B------------------------------o---------f
-B--ooB----------o---------oB---o-----------------------------------o---oo--------------oB--X--o-o------------E--X--?-B------------------o----Boo--------------------------------o-------X----B------X-f
----o-------E-------------o---o---------o-----o--------------X--X--------o--o-X------o-B-----o--------------o--------o-------------ooo----o------BX--oo---------------o----Bo-------o---B-------X------f
m---o-----o-----oo------------oE---oo-------o----ooo---o------------X-o------o--------------B-----o-B--------------o------XB---------------------------B---------o-------o----------B-----M-B-------o-XX
XXXXXXXXXXXXXXXXXXXXXXXXXXXXXXXXXXXXXXXXXXXXXXXXXXXXXXXXXXXXXXXXXXXXXXXXXXXXXXXXXXXXXXXXXXXXXXXXXXXXXXXXXXXXXXXXXXXXXXXXXXXXXXXXXXXXXXXXXXXXXXXXXXXXXXXXXXXXXXXXXXXXXXXXXXXXXXXXXXXXXXXXXXXXXXXXXXXXXXXX
