----------------------------------------------------------------------------------------------------------B----------B--------BBBB-----------XB--BBBBBXXoXX----------B--------X-----o-------------------
--------------------------------------------------------------------------------------------o---------B-M-----BBBBB---Bo-B---X-B-----X-B-X-B-BB-X--o---B-X------------B------------XX--------------X----
-------------------------------------------------------------------------------------------------------X---?---?--------Xo---X--B---X-----BM--?B--B---------B------BB-X-X-XB----B-----?------??M???-----
-------------------------------------------------------------------------------------------T--B------------------X----T----M-----oB------X----------T-----????-----X------B-------?-------BBBBXBXBX--B--
----------------------------------------------X------------------M-------------------------|------------XXXXXXXXX-----|----XX--X--XB---------XB---XX|---T----o--------------B-----TB--------X------XX---
----------------------------B-------------------------------------------B-M----------------|------XX--------------B-TB|X--X---BB-----T-BBXXXBMT-XX--|---|T-----------------X--B--X|X--?----XXT----XXTT--
-------------------------------------------------------------X------------X---------B------|----------oB---X------BX|M|--B-----XB---X|---XXX--|XXXXX|---||------------B----XX----X|XX--X--XXX|---XXX||--
--------------------------------------------------------------------------T--------------T-|-----B--B-T--XX----BB-X-|B|-BB---?------X|oT-TXXXo|XX--T|-B-||-X-------------X-XXXBBBX|XXXXX-XXXX|--XXXX||?v
----------------------------------------------------------B------------B--|-B------------|B|-X--?----X|--XXB-----XXX|?|-BB---X-----BX|X|X|XXXX|XX--||-T-||XXX-----------XXXXXXX--X|XXXXXXXXXX|BXXXXX||-f
--------------------------------------------------------------------------|--------------|-|----------|--XXXBXB---XX|-|oT-X-T---BXo-X|X|X|XXXX|XX??||?|B||XXXX----------BXXXXXXX-X|XXXXXXXXXX|XXXXXX||Xf
--------------------------------------------------------------------------|--o-----------|-|----------|--XTXXXX-B-XX|X|-|B--|----XXXX|X|X|TXXX|XXX-||-|-||TXXXX------?B--TXXXXXXXX|XXXXXXXXXX|XXXXXX||Xf
---------------------------------------------------------------------?----|--B----X------|-|----------|-XT|XXXXXo-XX|X|-|-M-|----XXXX|X|X||XXX|XXXX||-|X|||XXXXX---------|XXXXXXXX|XXXXXXXXXX|XXXXXX||Xf
--------------------------------------------------------------------------|---???XXX-----|-|--B-???---|--||XXXXTX-XX|X|X|--?|----XXTX|X|X||XTX|XTXX||-|X|||XXXXXX---B----|XXXXXTXX|XTXXXXXXXX|XXXXXX||Xf
---------------------------------------------------------------------X----|-------XXX----|X|--B-------|--||XXXX|TXXX|X|X|---|X--TXT|X|X|X||X|X|X|XX||X|X|||XXXXXXX----B?-|XXXXX|XX|X|XXXXXXXX|XXXXXX||Xf
m---------------------------------------------------------E---------XX----|--EE---XXXX-E-|X|---E--E---|EX||XXXX||XXX|X|X|XBB|-E-|X||X|X|X||X|X|X|XX||X|X|||XXXXXXXX-?-X-X|XXXXX|XX|X|XXXXXXXX|XXXXXX||XX
XXXXXXXXXXXXXXXXXXXXXXXXXXXXXXXXXXXXXXXXXXXXXXXX----XXXXXXXXXX-----XXX----|--XXXXXXXXXXXX|X|XXX---XXXX|XX||XXXX||XXX|X|X|XX?|--B|X||X|X|X||X|X|X|XX||X|X|||XXXXXXXXXX--XX|XXXXX|XX|X|XXXXXXXX|XXXXXX||XX
