----------------------------------------------------------------------------------------------------------------------------------------------------------------------------------------X------------B--
-------------------------------------------------------------------X-------------------------------------------------------------------------------------------------------------------BB---------------
--o-----------------------------------------------------------------------------------------------------------------------------------------------------------------------------------------------------
----------T---------------------------------------------------------------------------------------------------------------------------------------------------------------------------------------------
----------|------------------------------------------------------------------------------------------------------------------------------------------------------------------------------------B-X------
---------o|-----------------------------------------------------------------------------------------------------------------------------------------------------------------------------T---------------
----------|-----------------------------------------------------------------------------------------------------------------------------------------------------------------------------|------------M--
-----T----|------XXX--------------------------------------------------------------------------------------------------------------------------------------------------------------------|--------------v
-----|----|---------X-------------------------------------------------------------------------------------------------------------------------------------------------------------------|----X---------f
-----|----|---------XX---X--------------------------------------------------------------------------------------------------------------------------------------------------------------|----XX-------Bf
-----|----|---BB----XXX-----------------------------------------------------------------------------------------------------------------------------------------------------------------|----XXX-------f
-----|----|---------XXXX----------------------------------------------------------------------------------------------------------------------------------------------------------------|----XXXX------f
-----|----|--------XXXXXX---------------------------------------------------------------------------------------------------------------------------------------------------------------|----XXXXX-----f
-----|----|-------XXXXXXXX-------------------------------------------------------------------------------------------------------------------------------------------------------------T|----XXXXXX----f
m----|---E|-----EXXXXXXXXXX------------------------------------------------------------------------------------------------------------------------------------------------------------||---BXXXXXXXB--X
XXXXX|XXXX|XXXXXXXXXXXXXXXXX---XXXXXXXXXXXXXXXXXXXXXXXXXXXXXXXXXXXXXXXXXXXXXXXXXXXXXXXXXXXXXXXXXXXXXXXXXXXXXXXXXXXXXXXXXXXXXXXXXXXXXXXXXXXXXXXXXXXXXXXXXXXXXXXXXXXXXXXXXXXXXXXXXXXXXXXX||XXXXXXXXXXXX--X
