-------o-----------X---o---------------B----o--o---o-ooX-------------B-------B-----X------o----o-----o--o-------X----------o-------------B--B-oo--Boo-B---------------X--o----------o--o-oB---o-----B---
-X---o-oB-o-------o-o------------X--B--B---oX-o-----------B---------X-----o-------BB-----B--------B-X---B-o---o-o--o---oB--o----------------------B-oB------------B----------o-------------B------o-----
--------------------E------o-------B-Bo----T-----------------o----------Bo---XBBo-----B---X------------oBBB------o---o----------------X-X---------BB-----------------B-----BoB----o-------E-------X-----
---X----o-----o-Bo-B-------------oX-?--B-o-|--o------B---B-B-----o--------X---------------o-o---------o-X----BB--BB---------B----B---o--oXo-------------E-------B-------o--o--B-----B---Bo---B---B--BB--
--o-----X---------X-o------X----o----------|---X------X----o-------oB--o-----------------oBo-----E-------o--o--------------------------X----X---E-B------o---o-----o--oo---o---X-----B--------o--oo-----
-oo-----Boo-B------o-B------oooB-B-B---X-Bo|---o------------------o---B----B--oo----------------------------o--Eo-------BB-oB-------X--BB------ooX-------o----T----B---------o------------?----o--o--B--
-------oBX-o--o---X---------B-B------X-B-X-|--------------------------B-B--o-----------------------------Bo--B----oo------B-----------o--X------o-------ooo---|-----B----o-------o--o-o-------B----B-X-X
---o-------oB-------o----------------B---oB|-----B-------X--X--o---X----oo---B----oo----oB-BB------------------XX---o-------o--oo---------B----X---------Bo---|----X---B-B-o-------------B-o-o---?---Xov
-B---------oBo-E--o----o--o---o--X-B----B-B|-oB-------o-----B-XB--B--X----o---B--------B--o-----------------------oB-----X-ooB-------o----------o--o----B-o---|--oB------o---------------X--------B---Ef
B--B-o--E--B--o--o-o--------?X--B----B--X--|--o--o---o-----o---B----Bo-----BB-X----XoB----o---E?-----o--o----o---------------------X-----E--B------B-o--o--o--|---BB---E----------B--------B-o----o-o--f
---------------o--o--B--o--T-----B-o------B|---o-----------o---oB-------oo---B-B------o----B------------B-o----------B-----B-o--------------------------------|------Bo-X-----B------------------------f
-----------XX---oo---B----E|---T--o------X-|----o-----o-B--o--X-o-----o----o--o---o---o------X-------o-oBo-XB-B-o--------------------XooB---o---------B--B----|-o--o------B----o-------------X--------Xf
-------B-----B-----------B-|-oB|--oo-------|---------------o----------------Bo---o--B------Xo--o----o--oo-Boo----X-E-----o----------------------B--E-X--------|----------B---X----------X------o---oB--f
-X--------------B----------|---|--B---XB---|--B-E-B--B--B--o--X-Xo-oo-----------------o---o------B-E-----o-B-X-o---o---X--------o---B-o------o--o--Xo-------o-|-ooB-o--X------oEB--B-------B---B------of
m---------B----E-------EBX-|-BB|--XB---E-o-|-----X-----E-------E-----E-XBo---B-----o-BX--------oB-E--B-B--o-o-X---X----o--BX-X-BBoo-BX---B-X--E-o--B---------o|--X--E--B---o--oX---------B-------X-X----
XXXXXXXXXXXXXXXXXXXXXXXXXXXXXXXXXXXXXXXXXXXXXXXXXXXXXXXXXXXXXXXXXXXXXXXXXXXXXXXXXXXXXXXXXXXXXXXXXXXXXXXXXXXXXXXXXXXXXXXXXXXXXXXXXXXXXXXXXXXXXXXXXXXXXXXXXXXXXXXXXXXXXXXXXXXXXXXXXXXXXXXXXXXXXXXXXXXXXXXX
