----o------------------------o----------o-------------B----------------B-----------------------o------o-------X-o---------------oX------------------B-----------------------------o---------------------
-------------o-------B------B--B------X--Xo-------------------X-B--o------B-----X-----------o------B----o------X-------------B--------------o-------Bo--------X--------B------X-------------------------
-------------------o-EXo--o---------------------o-----------o----BBo------------------o--------B-o-o-E-X-----------------B-----BX--------o------o---------X----B--B?-o----o--B-----o--oo-----------X----
---B---------o------o---------Bo--------B-o---o--o--------o--------------oo--oX---------o--B-oX------------o-----o-o-----X---o-o-----o--o--------oX--o---X----o-------------o--------EoB-B-----------B--
------o----?-----------BX-----BB----------------------------B---------------------X------X-oo-B---o----X----oo---o--B----------o-o-B----X--E--------o------------o-------o---------o------------Bo-o----
---o--E--o----------------o---------------B--oo----o-X------E-------------------BBo--B--BB---B-----B---oX-o---oB---o--?----------X------o------o---E---B-o-------o----o------------B--------------------
--------------------------------X-------X-------E----o----X-B--B-------B---B-----B-------------XB---B------------o--XX--Eo-o--oB--B--B-------------Xo-B----o------------B------------Bo--------o-----o--
-o-B---B-----------B-----B-B-----------------------oB--o--o--------?----------o--------B-B-----E-----o------------B-----o------o--------------------------X-o------o---------o--E--B-o---B---o---------v
-o--------------X-----o--B--oB-------E---o---B---Xo--o-----B-----o---B-----------o--B---------X-X-------------B---B-o---oo---o--X-o----o---------X-o---o---E-----------B--X-o--B-Xoo-------------o-----f
---o--o---------------------oo-X----o--------o-----------o----o----B-----------o---X-B---------B-----------------B---o----B-----o--o--X----------------E------o-----------o-o-BX---o----o--B-----------f
--B----------------------------o--o----------B--o-----o-o------------X---o---o-----------X-----o-X---------------B-o-----------o--o-B-----o---------o-------------X--o----------o---------B----o-------f
---------B--------B-X-------o------o----------oB----o--o--o---------B---------B----X----------E---o-o--------------o-o-B--B-o----o------------o--X-------Bo--B------------o------------o----o----------f
-----B-----o-----------------o----?---Bo-B--------------E-----o------o-----------------o-E----oB--------B--o------B-----------------o----B---o--------E----B------B------B-------o--?--------o--o---B-Xf
---------B--oo---o----o------B---------o--Xo---Xo------o-----E-o----------XB----o-B-------------------X--o--------B-------------o----B-----o--o-------o--------Bo----X-----------X---o----o-BB-o-XX----f
m--o------------o-----------------o---oB-E---X---oE--o--B-o-----B------o---------XX-------E--------o------oXo---o---------oE----E-oo-------o------------ooo--oo-------BXo-------Bo-------------o-oE----X
XXXXXXXXXXXXXXXXXXXXXXXXXXXXXXXXXXXXXXXXXXXXXXXXXXXXXXXXXXXXXXXXXXXXXXXXXXXXXXXXXXXXXXXXXXXXXXXXXXXXXXXXXXXXXXXXXXXXXXXXXXXXXXXXXXXXXXXXXXXXXXXXXXXXXXXXXXXXXXXXXXXXXXXXXXXXXXXXXXXXXXXXXXXXXXXXXXXXXXXX
