-----------------------B----B----------X-----------------------B---------------------------B------------X------B------------------------------------------------------------------------B---------------
-X------------------------------X--------X-----------------------B------------------------------------------X---X------------------------X-------------------B-----X-------X----------------------------
----------------------------------------X--------------------------------------------------------------------------------------------B-B----------------------------------------------------------------
----------X----B-----------------------------------------------B---------------X-----------------------------------------------------------------------------------------------------------BB-----------
----------------------------------------------------------------------------------------------B------X-----------------------------------------------------------------------------------X--------------
--------B-----------------------X-----------------------------------------BB-----------------------------------------------------X----------------------------------------------------------------------
-----B--------X---B------------------------------------B----B-----------------BX-----X----------------------B-----------X------------X------------------------------------------X-----------------------
-------XX-----------------------------------------------------B-----------B------------------------------B----------------------------B---------B-------------------------------X-X---------------B----v
------------B----------------------X------X--------------------------------------B---------------------------------X-----------------------B-----------------------------X------------------B----------f
-----------------------------------------B-----------------------------------------B-----B-------------------------------------------------------------------------------------------------------------f
------------------------------BX------------------------------------------------------------B---------------------B----------------X------------------------XB---B-----------------X--B----------------f
----B--------------B---------------------------------------X----------------B--------------------------------------------------------------------------------------B-----B-----------------------------f
-B----------------------------X--------B--------------------------------------------------B-------X----X----------------------------------------------------------------------------X------------------f
-------X-------------B-------------------B-------B-------------------------------X-X-------B------------------------X--------------------------X-------------------------------------------------------f
m-----------------------------X-----------X-----------------------------------------------------------------------X---------------------------X----------------------------B---------------------------X
XXXXXXXXXXXXXXXXXXXXXXXXXXXXXXXXXXXXXXXXBXXXXXXXXXXXXXXXXXXXXXXXXXXXXXXXXXXXXXXXXXXXXXXXXXXXXXXXXXXXXXXXXXXXXXXXXXXXXXXXXXXXXXXXXXXXXXXXXXXXXXXXXXXXXXXXXXXXXXXXXXXXXXXXXXXXXXXXXXXXXXXXXXXXXXXXXXXXXXXX
