-----------------------------------------------------------------------------------B---------Mo-------------------------------------??---M-----------------------------------M--------------------------
-----------------------------------------------------------------------o-o----------BBBB-------------------------------------------------M------------------------------B-------------------------------
-------------------------------------------------------------o--------X--------------B----------------------------------------------M---???????------------------------------------o--------------------
-------M------------------------------------?-------------------X------------------------------------------------------------T---------------------------------------T----------------------------------
-------------------------------------------------------------o------------------TT-------------------------------------------|---------------------------------------|-------------------------?--------
-------------------------------------------------------------T---------X--------||-------X----B---------------------X--------|------T---------X----------------------|----------------------------------
-------------------------------------------------------------|--T------XX-------||BB-------------------------------XX--------|---X--|-------XXX----------------------|-----X----------------------------
-------------------------------------------------------------|T-|------XXX-XXo--||--------T----T------------------XXX--------|--XX--|-------XXX----------------------|-----XX--------------------------v
---------------------------------------------------T---------||-|------XXXXXXT--||X-------|--X-|M---------B------XXXX--------|-XXX--|-----XXXXX----------------------|-----XXX-------------------------f
----T-------------------------------------M--------|---------||-|------XXXXXX|-o||XX?-----|-XX-|----------------XXXXX--------|XXXX--|----XXXXXXX---------------------|-----XXXX------------------------f
----|?---------------------------------------------|---------||-|------XXXXXX|X-||XTX-----|XXX-|---------------XXXXXX--------|XXXX--|---XXXXXXXXX--------------------|-----XXXXT-----------------------f
----|----------------------------------------------|--------T||-|------XXXXXX|XX||X|XXXo--|XXX-|--------T-----XXXXXXX-------X|XXTX--|--XXXXXXXXXXX-????-------------X|-----XXXX|X----------------------f
----|----------------------------------------------|-------X|||-|------XXXXXX|XX||X|XXXX-X|XXT-|--------|----XXXXXXXX------XX|XX|XX-|-XXXXXXXXXXXXX----------------XX|-----XXXX|XX---------------------f
----|----------------------------------------------|-----XXX|||-|-----XXXXXXX|XX||X|XXXXXX|XX|-|-------X|--oXXXXXXXXX-----XXX|XX|XXX|XXXXXXXXXXXXXXX----XXXXX-----XXX|-----XXXX|XXX--------T-----------f
m---|-----E----------------------------------------|-----XXX|||-|--E-XXXXXXXX|XX||X|XXXXXX|XX|-|------XX|--XXXXXXXXXX----XXXX|XX|XXX|XXXXXXXXXXXXXXXX------------XXXX|--E-EXXXX|XXXX-------|-----------X
XXXX|XXX---XXXXXXXXXXXXXXXXXXXXXXXXXXXXXXXXXXXXXXXX|XXXXXXXX|||X|XXXXXXXXXXXX|XX||X|XXXXXX|XX|-|--X--XXX|-XXXXXXXXXXXXXXXXXXX|XX|XXX|XXXXXXXXXXXXXXXXXXXXXXX----XXXXX|X-XXXXXXX|XXXXXXXXXXX|X----------X
