---------------o---------------------------o-----B---------------------------o-----o-------------------------------------------------------X-------------------------------o-o--------------------------
--------------X---X-------o------------------------------B--------------E--B-------------XB----o---------o--X--o----Xo------------------------------------XB---------------X--------------------o-------
--------B--------------o--------------o-B-----------oB-------------X-------X------o-----o-------B--B----------------o---------oo-----------B-------------------B-----o----o--X--------------------------
---o-----o-------------o------B----B-----X--E------------------B-X-----o--------o------B----------------o---------oo-------------------------------B---------o-B-------------B-B------B-------B---------
----B-------------Xo---------B----------o--o--Bo--o---------o--------X--------------------------------------------X--oo--X--o-------------Xo------X----X------------------o------------oX----B----------
----------o------------------------o-------------o---------o------------o---------------B----o-X-------------------o-B-------B-----------BB--------------B-------------X--o--o-----o--------------------
-o-----o------------X-----B---------------------o------B-------B--------o---------------X-XB-------X-----oB--------------------o-----------o------o------o----------------B---o-B-----------B-o------X--
--------B----X------B-----o-o------o--------B-------o-----------------Bo-X--o-oBo--------------------X-----o-----------o--------------B--o-----------------o--------X-------------o-----o-----------X--v
--------o--------------------------------B---------------------------------------------B-------o----Bo-------X--------o---------B--------------B-------oB-o----o--B-?X----------oo------o-B------------f
---o--------------o----M--------oo--------------------------------------------------o------B-------------------------o-------B----------------------------B--oB------------o------B------B----------o--f
----------------oo-B-o-o------------------------o---------------------------o---------Eo-----X-X--------------o----------oB-----o------------oB-----------------------o-o----------o-------------------f
--------o-----------B-----o--XB---o-----o------oB----B--B-------------B---------o-----o------------B---------------B------------o-X----------------X-----------o--B----------o-----o-------------------f
----ooo-------o--------------------------------------------oo-----------o----o-E--------o------------------------B--o----------------------------------o-----------------o---o---B?-----------------o--f
-------------o-------o--B------------------------o-------------oB---oX-------B-B-------B------E--o---------------------B----------o------------------Boo----o-------o-o----o--------------o--B-------B-f
m---o-------o---------B-B--o-----o---------X------B--B------------o--------o-o---------------B-------B--------B--o--o----------E-------------o-o-----------------B-------B----o----------X------oo-o---X
XXXXXXXXXXXXXXXXXXXXXXXXXXXXXXXXXXXXXXXXXXXXXXXXXXXXXXXXXXXXXXXXXXXXXXXXXXXXXXXXXXXXXXXXXXXXXXXXXXXXXXXXXXXXXXXXXXXXXXXXXXXXXXXXXXXXXXXXXXXXXXXXXXXXXXXXXXXXXXXXXXXXXXXXXXXXXXXXXXXXXXXXXXXXXXXXXXXXXXXX
