------B-X----------------------B----oB-----o-------------o-------------------B--Bo---X-o----B-----B---------------------------------------------------------------------o-B-----X--------------------B--
--------------Bo-B--B-------o---B-----------------o-B-B-----------B-o---X---------o------------o---oX---o-----------o-----------o-----B------o----------o---E--o--o-------o-----X---X-----oX----------B-
----X--------------E-------------X------------o---------B-E---o---------------o-----B-----o-o------o---oo--o---------o----o----X--o----B---B---------E---B-M----B-B---o----oB----------B----------------
-------------------oB----B--------o-B-X----oB------B-----o-BB-------XB---XBX---o-------B----------------o---o------B---B-----B---o------o----B----------------------------------------------------BX-B--
---------B---Bo-o---B-----------o-------------------o-------------oB----B---------------X------------B--oE-----------X----B--?-o-----E----o--------Bo-----------------oB-E-----o---------o--o--------X-B
--?--------------------B--------o-------oo-------------------o------------o-----------------------o-----o-----B-----------------o-----------o---B---oX--o--------o-B-----o--o----B-----oB------------Bo-
---------------X-----o--------o------o-Xo--------o----B-------------X---B---oB---B--oB------------o----------B-----B---B----B-B-------o--B---o----------o-X--Bo---o-o-------------o---------B-----------
---o--------------------------------o------------EB-----o-B---------------------X----o----------------B-----B-------------oo-X---X---o------------------X-------B----o---o-----X------B-o--------X-o---v
--B----o---------o-o-----------o------------B-----------------X-----------B------------------o---oB-----o----------o---------?-oo----o------oB-----oo-----oo---------------o----o---------o---------o--f
--X------------o---B---BE-oX-----X-------o-----o-------o--------------------o-------------E---o-----------Xo-B--o-----Bo----o-B----o-------o--------o--B------o-----B-------------o-o---o-----B-------Bf
---------o---o-X------------------------------B---------B--X---o--Boo-------B-------------oo--------o-------------------B--------------------o-B----o---o---------------o---X------------------o-----o-f
-----o---B----------------B----------------------------o-X-o------------------------------B---B-------o-----o--o-------X----------------o-----------o------Xo----------oX--BB---B-o---B---------o------f
-o-o---B--------o-o--------X-----oo--o----o---oB------------o------o--X---------------------------o--B-----------BX--------------oo-------o-----X----X-----------Bo-----o--o-----------------------o---f
------o-------oo-B--------------o-o----o--B------------------X----o----------------------Xo-B--o----------B-oE-o-----B----o------o-------o----X-o----------oo-----B----X--------o--B----X---------o---Xf
m--B-o-B---o---X-o-----B-----------B------B------------o--Bo-------o-----oXooo----------o-----------o------E--------B---------------X-o--BX-o------o--X-----o------o------X----o-----------B-XX----X---X
XXXXXXXXXXXXXXXXXXXXXXXXXXXXXXXXXXXXXXXXXXXXXXXXXXXXXXXXXXXXXXXXXXXXXXXXXXXXXXXXXXXXXXXXXXXXXXXXXXXXXXXXXXXXXXXXXXXXXXXXXXXXXXXXXXXXXXXXXXXXXXXXXXXXXXXXXXXXXXXXXXXXXXXXXXXXXXXXXXXXXXXXXXXXXXXXXXXXXXXX
