------------------------------------------------------------------------------------B----------------B------------X-X------B------------------------------------X---M-------------B----?-----------X----
----------------------------------------------------------------------------------------------X--------------B------------------------------------------------------B-M------------------XXXXXB--X------
-------------------------------------------------------------------------------------XXXX---------o------------------X----X-X----------X-----B---------X------------B---X-------------------------B-B---
--------------------------------------------------------------------------------------------X--X----T------XXXXXXX--------B-------------------------o----------------X----------------------------------
--------------------------------------------------------------------------------------X---X------X--|--T---------XXX-------???---X-BB---BXX------------------------------XX-----------B--------------oX-
-------------------------------------------------------------------B---------------------XX---------|--|-Mo--X---X-----------B-X---------XX------M------B---------------XX-----M--B-----------X-------X-
--------------------------------------------------------------------------------------o-XXX---------|--|-X--------X-TB---------BBBBBBB--XXX----X------------------BXB--XXX---T--X-----------T---------X-
---------------------------------------------------------------------------------------XXXX-------B-|--|X-X-B------X|----o--oX---B-----XXXX------BBB--X---X--B--------XXXX---|-X---------B--|---------Xv
--------------------------------------------------------------------------------------XXXXX---------|--|--------?BT?|?----------------XXXXXX---------TXX--------X---XXXXXX---|---X----------|-????????Xf
-----------------------------------------------------------------------------------T-XXXXXX---------|--|----------|-|--------------B-XXXXXXXX--------|XXX------X----XXXXXXX-B|-----------BX-|---------Xf
-----------------------------------------------------------------------------------|XXXXXXX---------|--|----------|-|---X-------M---XXXXXXXXXX-o-----|XXXX-----XX--XXXXXXX---|B--T-B-X---XX-|---------Xf
-----------------------------------------------------------------------------------|XXXXXXX---------|??|?????-X-BT|-|--XXXXXXXXXXX-XXTXXXXXXXXX-----X|XXXXT---XXXXXXXXXXXX-B-|B--|-X--XTXXX-|--------XXf
----------------------------------------------------------------------------------X|XXXXXXX---------|--|-?-----B-||B|BXXX---------XXX|XXXXXXXXXX---XX|XXXX|X-XXXXXXXXXXXXX-X-|---|-----|XXX-|-------XXXf
---------------------------------------------------------------------------------XX|XXXXXXX------B--|--|-BBBBBBBB||-|XXXX--X-----XXXX|XXXXXXXXXXX-XXX|XXXX|XXXXXXXXXXXXXXX---|---|-X--X|XXX-|------XXXXf
m-------------------------------------------------------------------------------XXX|XXXXXXX---------|--|---X---E-||-|XXXX-------XXXXX|XXXXXXXXXXXXXXX|XXXX|XXXXXXXXXXXXXXXX--|--?|XX?XX|XXX-|E----XXXXXX
XXXX-------XXXXXXXXXXXXXXXXXXXXXXXXXXXXXXXXXXXXXXXXXXXXXXXXXXXXXXXXXXXXXXXXXXXXXXXX|XXXXXXX---o-XXXX|XX|BXXXX----||X|XXXXXXoXXXXXXXXX|XXXXXXXXXXXXXXX|XXXX|XXXXXXXXXXXXXXXXX-|XXX|XXXXX|XXXX|XX--XXXXXXX
