--------B----------------------------------------------------------X------------------------B----------------------------------------------B----------------X-----------------------------------X-------
------B-----X-----------------------B----------B-B--------------------X-----------B------------------------X----X------------B-X----B-------B--------------------------------------X--------------------
-------------------------------------B--X----X---X------------------------------B-----------------------------------------------------------------------------------------------------------------------
----------------------------------------------------------------------------------X------B----X------B-------------------------------------------B------------------------------------------------X-----
---------------B-------------B--------------------------------------------------------------B---------------------------------B------------------------------------------X----X-------------------------
----------------------------------B------------------X-------X---------------------------------X----------X----X------------X---------------------------------XB-X-B------------X-----------------------
-------------------------------BB---B------------------------------B--------------B-------------------X-------B---------X----X----------------------X-B----------B--------------------------------------
---------------------------B---X-------X------------------------------------------------------------------------------------------------------B----------------------B-----------------X---------------v
----------------------------------------------------------------BX------------------------------B----XB----------------------------X----B--------------------X----------------------------------B------f
-----------------------B--------------------X-----------B----X-------------------------------------------------------------------------------------------------------------------------------------B---f
--------------------------------------------------------------------------------B-B--------------------X-----------------------------------------------B-------------------------X-----X---------B-----f
--------------------------------------------------------------------------B----X--------X----------------X-----------------------------------B---------X-------------------------------------------X---f
--X--------------------------------------X---X--X-----------------X--X------------------------------------------------------------------X------------------------------------------------X-------------f
-------------B---------------------------------------------------B-B--------------------B------------------------------------X------------------X-----------------------B---------------------X--------f
mB------------X-------------------------------------------------------------------------------------B-----B---------------------------------------------------------B----------------------------------X
XXXXXXXXXXXXXXXXXXXXXXXXXXXXXXXXXXXXXXXXXXXXXXXXXXXXXXXXXXXXXXXXXXXXXXXXXXXXXXXXXXXXXXXXXBXXXXXXXXBXXXXXXXXXXXXXXXXXXXXXXXXXXXXXXXXXXXXXXXXXXXXXXXXXXXXXXXXXXXXBXXXXXXXXXXXXXBXXXXXXXXXXXXXXXXXXXXXXXXXX
