-------------------------------------------------------------------X----B------------------?----------------------BX----XXXXXX--------------------------------------------XXXX--------------------------
--------------------------------------------------X--------------------------M-----X-X--B-----------------?---BBBB-----X--BBBBBBBBBXBBX----o--------------X---------B----------X----------------?X------
-------------------------------------------------------------------BBBBB--o---------------------------X-----------------------------B------o----M----------------------------------------B----X---------
---------------------------------------------------BB----------------------------------------X--X--X-------------T-------X---------------------------------------------------X------o-------------XX----
---B----------------------------------------------------B-----------????---X-----------------------XX------------|------------------------------B-------?-----------B------------------------X-oB-B--X--
-----------------------------------------------------------------T-----?------X----------------------X---T-------|T---------B------B------BBBB---X------------XBX--M-B----B--X-----T---X-------X----o---
------------------------------------------------X--------X-------|--------------------------------------X|----B--||--X-----------------?????----XXB-------X---TXXBBBBBBB-B--XX-----|-------?B??XXB?-----
-----------------------------------B----------o---------XX-X-----|----------------o-------------?---B---X|-------||----B-------o--M------------XXX------------|XX-------T--XXX-----|-------o---XXX-----v
-------------------------------------------------------XXX------X|---------------------------------M---XX|X?B--X-||-??BX--B-??----XB-X--------XXXX----M---B---|XXXXX-TX-|-XXXX----T|-B--T-----BXXXX----f
----------------------------------------------------??XXXX-------|------X---------o-------X--TX---------X|XX----M||X------T------XX----------XXXXXB-----------|XXXX--|XX|XXXXXTXXX||X-o-|------XXXXX---f
-----------------------------------------------------XXXXXB------|---------------B--------XX-|--X----X--X|XXX--X-||X------|--X--XXX----X----XXXXXX----------?-|XXXXX-|XX|XXXXT|-XX||----|------XXXXXX--f
---------------------------------------------------XXXXXXX-------|-------------X----X-----XXX|------X---X|XXXXXX-||XX-????|?---XXXX-------XXXXXXXX-T---------B|XXXXXX|XX|XXXX||XXX||----|------XXXXXXX-f
--------------------------------------------------BXXXXXXX-------|------------XXXB--------XXX|--B----XX-X|XXXXXX-||XXX---B|BBBXXXXX-------XXXXXXXX-|----X-----|XXXXXX|XX|XXXX||XXX||-B--|-B--oXXXXXXXXXf
--------------------------------------------------XXXXXXXX-------|-----------XXX----------XXX|X---B-X?X-X|XXXXXX-||XXXXBBB|B-XXXXXX--T---XTXXXXXXXX|XXXX------|XXXXXX|XX|XXXX||XXX||----|----XXXXXXXXXXf
m---o-------------------------------------E------XXXXXXXXXX------|----E-BBBBXXXX---o----EXXXX|XX-----XXoX|XXXXXXX||XXXXX-o|-XXXXXXX--|--XX|XXXXXXX-|-------E--|XXXXXX|XX|XXXX||XXX||E---|X--XXXXXXXXXXXX
XXXXXXXXXXXXXXXXXXXXXXXXXXXXXXXXXXXXXXXXXXXXXXXXXXXXXXXXXXXBXXXXX|XXXXXX---XXXXXXXXX----XXXXX|XXX-B-XXX-X|XXXXXXX||XXXXXXX|XXXXXXXX--|-XXX|XXXXXXXX|XX------XX|XXXXXX|XX|XXXX||XXX||----|XXXXXXXXXXXXXXX
