----------X---------X----------B-------------------------------------------X------------------X----X---B------X-------------X---B-----------------------------------------------------------------------
--------------------B-X-----------------------------B------------------------------------------B-------------------------------------X-------------------X------------X-------X-------------------------
--------------B-------------X--B--------------------------------------------------------------------------X---------X-----------------------B---------B-------------------------------B-----------------
-----------------B-------------------X------------------------X--------------------------X-----------------------X-----------------------X--------------------------------------------------------------
-----------------X-X-------------------------------------------------------------------------------------------------------------------------------------B----------------------------------B-----------
--X------------B-----X------------------X----------------B--------------------X----------B-----------X----------------------------------------B---------------------------------------------------------
----------------------------------------------------------------------------------------X--------------------B----B------------------X----------------------------------------------------------B-------
-------------------X----------------------------B--------B--------B----------------------------------------X----------------------------------------B--------B-----------------------------------------v
-----------B-B---B----------------------X--------------------------------------B-----------------------X----------------B--------X----------------------------------------------------------XX---------f
----------------------------B-X--------------------------------------------------------------------------------------------------------------------------------------------B-------B-----------X-B-----f
----------------X---B-------------X-B---------------------------------B-----------------------------------B------------------B----------------B----------X---------X---------------X----------------B--f
--B----------B--------B-------------------------------------------X------B-----------X--------------------------X--------------------------------------------------------------------------------------f
--------B-B-----------------------------------------B---------------------------------------------------X------------------------X--------------------------------------------------------B------------f
-----------B---------------------------------B-----------X--B-------B------------------------------------------X--------------B---------X-------------------------------------------------------X------f
m--X-----------------------X--------------------------------------------------------------------------------------------------B----------------------X-------------------------------------------------X
XXXXXXXXXXXXXXXXXXXXXXXXXXXXXBXXXXXXXXXXXXXXXXXXXXXXXXXXXXXXXXXXXXXXXXXXXXXXXXXXXXXXXXXXXXXXXXXXXXXXXXXXXXXXXXXXXXXXXXXXXXXXXXXXXXXXXXXXXXXXXXXXXXXXXXXXXXXXXXXXXXXXXXXXXXXXXXXXXXXXXXXXXXXXXXXXXXXXXXXX
