-------------------------------------------------BBBBB-----BB-------------------------------------------------------------------------------------------------------------------------------------------
------------------------------------------------------------------------BBBBBBB----------------------------------------------------------------------------------------------------------------------BB-
-------------------------------------------------------------------------------------------------------------------------------------------------------XXXXXXXX---------------------------------------?-
-------------------------------------------------BBBBBB--------------------------------------------------------------------------------------------------------------------------------------------??---
-----------------------------------------BBBB-----------------------------------------------------------------------------------------------------------------------------------------------------------
--------------------------------------------------------------------------------------------------------------------------------------------------------------------------------------------------------
-------------------------------------------------????---------------------------------------------------------------------------------------------------------XXXXX-------------------------------------
-------------------------------------------------------------------------------------------------------------------------------------------------------------------------------------------------------v
-------------------------------------------------------------------------------------------------------------------------------------------------------------------------------------------------B-----f
-------------------------------------------------BBBBBB-----------------------------------------------------------------------------------------X-----------?------------------------------------------f
-------------------------------------------------------------------------------------------------------X---------------------------------------XX------------------------------------------------------f
---------------------------------------------------------------------------------------T---?--???------------------------------------------o--XXX---------------------------------------------------T--f
----------------------------------------------------XXXXXXX----------------------------|-----------------------------------------------------XXXX---------------------------------------------------|--f
-------------------------------------------------------------------X-------------------|------T---------------------------------------------XXXXX---------------------------------------------------|--f
m?-----------------E------------------------E------------------------------------------|------|--------------------------------------------XXXXXX---------------------------------------------------|--X
XXXXXXXXXXXXXXXXXXXXXXXXXXXXXXXXXXXXXXXXXXXXXXXXXXXXXXXXXXXXXXXXXXXXXXXXXXXXXXXXXXXXXXX|XXXXXX|XXXXXXXXXXXXXXXXXXXXXXXXXXXXXXXXXXXXXXXXXXXXXXXXXXXXXXXXXXXXXXXXXXXXX------XXXXXXXXXXXXXXXXXXXXXXXXXX|XXX
