o-------o---B---------oB-B-----o-----------------o-X---o-o-oo--oo--X----------Bo---B----oo------------oB---------------o----E-------B----------------o------o-----------------------------------------o-
---B---------X------oo---------------B-o----B----------------------o--o------o----B--------X---------o------o-BB--------o---Bo-----------o--?Bo-------o---oo--oBB-----B-oB--ooo-o------------o-o--------
------Bo-oo--BX-----------o-oXo----o--o--------------o-----X----X---X------o---B-X-B-----o----o----------oB---B--o----o-------Bo--o------B------------Xo--------o-----------B-B--o-B---X----B?----------
---B-------------------------------oo-------------oB--o---o-?-----o--B-X-B--o-----o---B-----------------------o---oB------T----XX-------------o------Boo--B---------o-oB---------Xo-----B---B--X--o-o-o-
--B---------------------o----o--B--oB-o-Xo--X-X------o---o---B--oB-------X-------oT---B-----------------------X---Xo--B-o-|--------o-X----------------X-----o-B---o---------o-E----o-X-----B-o-B-o------
--B----o------X--------------oooB-o---B--o---X-------o---------X------------B----o|----------o-------------------o--------|-B--BBoB----o-------B----o-B--o--------------oB-X-oBB-o-B--------B----o------
oT-----X------B----------oo------o-o-------------------------B--------o---o-------|----B-B--oo----B-B-------XBT-XB-------B|---oB--------B----Bo-----------B-----------------------o------B---o-BB-XB?-B-
-|-B--------oX----E----------B--o?BB--Bo----Bo----------------ooB------o----X---oB|------BB--o--------?----B--|-----------|--------B--o----o-----X----------X-------o---------------------X-----B--o---v
-|---------B-----o?------o---o------o------E------X--oB---------o-----o-------Eo--|---B--B------X-------o-----|----X------|----------B---o--------o---o--B-o--X--X-------E---------------o-oo----o-----f
-|-----------o--B------E--o--B--o--Bo----B-B----B--o--o-------o------o-o------X---|----B------o----X--------o-|----------o|-oo-----B----------B--o---BB--Bo----oX--------XEX----------ooo-oX--o---X-o--f
-|--E----X----o--------?-----------o------?------o-----XX-----B-oBB-oo-oB--o----Bo|----o------oo-----------X--|-------B---|---o-----Bo---?B--o---------B--B----B-B--------B-----------o-B------------o-f
-|-EB--------oX---oBo------------------B---B--o------------EB-oo--X--B--o---------|-o---o-------o-B--o----B--X|----B----o-|-------------X-o-B---oB-o---------B------o-E--o------oX-----------X---------f
-|-?oo----BBo-B--oX-------X-----B-B-o-----------T----------B--------o-o------B----|-B---B-----o--------o-o----|-------o--B|----------B--o--------------X--E--oX-B-----X-----oB------B-------o--o--o----f
-|----X----o---------o-X---------B--B----X------|-----B-----o-------B-B--o--------|---o----o----Bo------------|-o-o----o--|-------------o-B------------o--B--o-o-B---X-Xo-----o--X---oo------B--------of
m|----Bo--X-----o-B----X-X---------o-------Eo---|-E--------------E--o-------T---B-|------EX--o-----oE------X--|-----------|------B----o--EX--E-E----o----o-B-----X--o---------------BB-------------XB-BX
XXXXXXXXXXXXXXXXXXXXXXXXXXXXXXXXXXXXXXXXXXXXXXXXXXXXXXXXXXXXXXXXXXXXXXXXXXXXXXXXXXXXXXXXXXXXXXXXXXXXXXXXXXXXXXXXXXXXXXXXXXXXXXXXXXXXXXXXXXXXXXXXXXXXXXXXXXXXXXXXXXXXXXXXXXXXXXXXXXXXXXXXXXXXXXXXXXXXXXXX
