--------------------------------------------------------------------------------------------------------------------------------------------------------------------------------------------------------
--------------------------------------------------------------------------------------------------------------------------------------------------------------------------------------------------------
--------------------------------------------------------------------------------------------------------------------------------------------------------------------------------------------------------
--------------------------------------------------------------------------------------------------------------------------------------------------------------------------------------------------------
------------------------------------------------------------------------------------------------------------X-------------------------------------------------------------------------------------------
--------------------------------------------------------------------------------------------------------------------------------------------------------------------------------------------------------
----------------------------?----------------------------------X----------?----------------------------------?------------------------------------------------------------------------------------------
-------------------------------------------------------------------------------------------------------------------------------------------------------------------------------------------------------v
------------------------------------------X------------------------------------------------------------------------------------------------------------------------------------------------------------f
-----------------------------------------XX-------------------X----------------------------------------------------------------------------------------------------------------------------------------f
------------------M---------------------XXX------------------XX----------------------------------------------------------------------------------------------------------------------------------------f
---------------------------------------XXXX-----------------XXX----------------------------------------------------B-----------------------------------------------------------------------------------f
--------------------------------------XXXXX----------------XXXX---------------------------X------------------------------------------------------------------------------------------------------------f
-------------------------------------XXXXXX---------------XXXXX------------------------X--XX-------------X---------------------------------------------------------------------------------------------f
m-----------E-------E---------------XXXXXXX-------E------XXXXXX-----------------------XX--XXX-------------E------------------------------------------E--------E-E-----E--------------------------------X
XXXXXXXXXXXXXXXXXXXXXXXXXX-------XXXXXXXXXXXXXXXXXXXXXXXXXXXXXXXXXXXXXXXXXXXXXXXXXXXXXXXXXXXXXXXXXXXXXXXXXXXXXXXXXXXXMXXXXXXXXXXXXXXXXXXXXXXXXXXXXXXXXXXXXXXXXXXXXXXXXXXXXXXXXXXXXXXXXXXXXXXXXXMXXXXXXXX
