------------------------------------------------------------------------------------------------------------------------------------------------------------------------------------------------o-------
------------------------------------------------------------------------------------------------------------------------------------------------------------------------?-----------------------X-------
-----------------------------------------------------------------------------------------------------------------------------------------------------------------?----X---B-----------------X-----------
------------------------------------------------------------------------------------------------------------------------------------------------------------------------BB-----------T----T------BB-----
----------X--------------------------------------------------------------------------------------------------------------------------------------------------------------B-----------|----|-BB-----X-T--
---------------------------------------------------------------------------------------------------------------------------------------------------------------------------XXXXMXBX--|----|-B---o----|--
------------------------------------------------------------------------------------------------------------------------------------------------------------B---------------------XX-|----|X----M----|--
----------------------------------------------------------------------------------------------------------------------------------------------------------------------------M-----XXX|-T--|XX--------|-v
-----------------------------------------------------------------------------------------------------------------------------------------------------------------------X--------BBXXX|-|B-|XXXB-T----|Xf
--------------????-----------------------------------------------------------------------------------------------------------------------------------------------------------o----XXX|X|-B|XXXX-|----|Xf
----------------------------------------------------------------------------------------------------------------------------------------------------------------X-----------X-----XXX|X|--|XXXXX|----|Xf
----------------------------------------------------------------------------------------------------------------------------------------------------------------------------------XXX|X|T-|XXXXX|--M-|Xf
----------B---------------------------------------------------------------------------------------------------------------------------------------------------------X------B------XXX|X||X|XXXXX|X--X|Xf
-------------X------------------------------------------------------------------------------------------------------------------------------------------------------XX--B---------XXX|X||X|XXXXX|XXXX|Xf
m-----------E-------------------------------------------------------------------------------------------------------------------------------------------------------XXXE----?E----XXX|X||X|XXXXX|XXXX|XX
XXXXXXXXXXXXXXXX--X---XXXXXXXXXXXXXXXXXXXXXXXXXXXXXXXXXXXXXXXXXXXXXXXXXXXXXXXXXXXXXXXXXXXXXXXXXXXXXXXXXXXXXXXXXXXXXXXXXXXXXXXXXXXXXXXXXXXXXXXXXXXXXXXXXXXXXXXXXXXXXXXXXXXXXXXXXXXXXXX|X||X|XXXXX|XXXX|XX
