-------------------------------------------------B-------------------------B------------------------------------------X?B----------------------------BB-------------------------------------------------
------------------------------------------------------------------------------------------------------X---o------------------------------B-B-----------------------B-----X-----------X-----B------------
------------------------------------------------------------------------------------------------X----------------?X------------XXXXXXX-------------B--------------------o---XXXXXXX---------------------
-------------------------------------------------o------------------------------B----------------------------B------BB---?-B-BBBBB--B---------X--------------------X------B-?????????----------B--------
-----------------------------------------------------------------------------------------X-------B-----------T--------------------B--B--BX------------B--------------------B----XM--------------X---X---
---------------------------------------------------------------------------------------oB--------------------|-B-T---B-X---B-----XX-----------------------------------------o---XBBBBBBX-B---------XX---
----------------------------------------------------------------------------------------------------------B--|---|?----------------------------X---?-X---------oo------BBB---X-XX---B-XX----------XXX-B-
---------------------------------------------------------------------------------------------X----B----X---B-|---|-XXXX--Xo-----X-X--------------------------??--------B------XXX--X-XXXXXoX-o---XXXX--v
----------------------------------------------------X----------------------------?-----------XXXo----------M-|---|B---oB?M------XX------B--X-------------B-----X-------------XXXX---XXXXX-------XXXXXXMf
---------------------------------------------------------------------------------------------XXX--TXXXX---XMX|---|----------X---XXX----------?-----B-------B-------BB-------XXXXXB-XXXXX------XXXXXXXXXf
-----------------------------------------------------------------------------------B--------BXXTX-|---B--X-XX|-T-|B----B-X-XX---XXXXXX---X-----B----X-XX-------------------XXXXXX-XXXXXX--B--XXXXXTXXXXf
---------------------------------------------------------------------------------------------XX|XX|T-----XXXX|B|-|--------XXX--XXXXXX--X-----X-------XX-------------------XXXXXXXXXXXXXX-B--XXXXXX|XXXXf
----------------------------------------------------------------B----------------------------XX|XX||-----XXXX|-|?|-------XXXX--BXXXXXX-XX---XX--T---XXXB----BB-oo---X----XXXXXXXXXXXXXXX---XXXXXXX|XXXXf
-------------------------------------------------------------------------------------B-------XX|XX||----XXXXX|-|-|???---XXXXX---XXXXXXXXXX?XXX--|--XXXX------T---X------XXXXXXXXXXXXXXXX--XXXXXXXX|XXXXf
m------------------------------------------------------------E-----------------------XE------XX|XX||X--XXXXXX|E|E|EE--XXXXXXX---XXXXXXXXXXXXXX--|-XXXXX-----X|---------XXXXXXXXXXXXXXXXX-XXXXXXXXX|XXXXX
XXXXXXXXXXXXXXXXXXXXXXXXXXXXXXXXXXXXXXXXXXXXXXXXXXXXXXXXXXXXXXXXXXXXXXXXXXXXXXX-----XXXXXXXXXXX|XX||XXXXXXXXX|X|-|XXX-XXXXXXXXX-XXXXXXXXXXXXXXXX|XXXXXXXXXXXX|--XXXXXXXXXXXXXXXXXXXXXXXXXXXXXXXXXX|XXXXX
