------B-----------------B--o----------------B-X-----------B------B---------o-------------B----o--------X----------X-X---o----------------------o-------o---------------B-----o------------------B-------
-----B-------------X-B----o-----X--o----------------------B-----X--------------E------X------o----o-----o-B-----o-B----------BB------o------X------o--X-o-------o-----------o----------------B-B--------
----B--------X---o------o------o----------------B---B-B------o-----------------o----X---E---o---B-----------o-X-----B---------oX-oB----------------o------o------o---X--oB----------------------X---B---
------o--o------------B----o--X---oBo-----------BBo-----------X-------X---X----------XoX--B---B-X---------oo---------------o---------o-X----------o------------X-X---o--o----------------X-B----------o-
-o-------oXX-------------o----B---o--------B---X-----------B----------B------Bo---B-------X------o---B---------------------oB-------B--------o----------o-----------o--------------oB------------------X
--BX-o-----o---------B---B-------------B--------------X----o----o----------------EX--------o--------------------X------o----------------o------------X-B---B---------o----------?------B------o-------XB
-------------------o--X-----------o-------------------------------B--Eo-o----------o-oBo-------X------XX-------X-------oE-------o-----o---B------------X-------B--------B-----------------------o-----B-
-----B---Bo--B-o-o------o-----BoBo----o----o--o-o-B------------o--------o-----------o---------o---------------o---MB-------B---X----------o-o-----------------------------XoX------B-------------------v
----o----X-B-----B----------B-B-B----------BX-------o--------B----o-o---o-------?----X--X-----o-X-----o---------oo-----------------X-----X--B---------X---B--o--B---oo------Bo-X-oX-X----o--o-o---B---Ef
----o------------------B-o-----o-----------B-----------------------------o--------------------------X----------o----------------B----X----o-------B-E----------E-----------------------Eo-o-----o-X-X--f
-oX---------------------------oo-o---------------------o------o-------o----o---o------------B--------X--o---------B---X---o-------B-o----o------------------X----X-o----BB-o-----------oo----------o---f
----B--------o--o---------o-------------------o----o-B-B-o-X-----o---Bo---o---o---oBo---B----------o----------E---------------------------------------B---o-X-o-------X-B--o----------B--o---X-----Bo--f
----------o-------Bo--------B-B--------B--o--o--oX--------B--o--o---------Eo-o-------B--------oo-o--------B---Xo----------------o---X-----o-------------------------B---o----o---------o-----o--------Xf
----------o-----oX----------B----------B--X---Bo-X------B-o----------BB-----o--------o----------X--------B-------------------oX--B--o-----o--oB---oo--o---B-----------oX-o---------B------oo---o-------f
m----X-----B--------o--o-----------------o-----X--B--oBoX----------o-----o---X-----------------------B----X---------o---o--B----oB--oo-o--X-B------o--BX-----------o-o---B-------XXo------B-------o----X
XXXXXXXXXXXXXXXXXXXXXXXXXXXXXXXXXXXXXXXXXXXXXXXXXXXXXXXXXXXXXXXXXXXXXXXXXXXXXXXXXXXXXXXXXXXXXXXXXXXXXXXXXXXXXXXXXXXXXXXXXXXXXXXXXXXXXXXXXXXXXXXXXXXXXXXXXXXXXXXXXXXXXXXXXXXXXXXXXXXXXXXXXXXXXXXXXXXXXXXX
