-------------------------------------------o-------------------------------------------------------------------B-----------oX--------------------B---------------------------B---------------------B----
------------B--------------------o----------B------o-o-----------BB-----oX-----o-------B----------------X-------------------------B----------------o------o------------------o---------B----------------
----o-----------------o---------o-----o--------------------B---o-----------------o-----o------------o--------------o--------X-o-oo--------B---------o----------o-----X----------X--B-----------o-------o
--------o-------B--o-------------BE----o--o------------------------------o--o--------------------B--o-----------X----XX--o------------------X------------o---------B-----E----X----X------B-o----B--o---
------------o-----------------o-o-BB-B----B----Xo-----------------o--Xooo-o--------o----B--------------o-o---------------------B--------------X----B--------------------------------o------o-o----------
-----------o------B------------o-----------------------------------o-o--B--o--o----Xo-o-----X------------o-----------------o-------o---------------------Bo-X--------o---o-------------------o---ooB----
----------B---X------------------X---------B-------------o---------------------------E-------------o----------------------Bo----o--o---B---o--o---B-B-B-------o----------------B---------------o--------
--B--o---o-o----B----------------------------------------------o--B-------B----X----------o-----------o--o-------B-------o--o----------o---o----------------------------B------------------oB----------v
-------------o----------------X---o---------------B-----------------X---------------------o-----o-----o---------B-----------B-------o--------o---------------------o--o-------o-----o--o-o-----------o-f
---Bo-o--------------------X-------B---------------------o-------------------o----B-B------oB-----------------o-----B-o-B-----------------------------------------------o---------B-------------o------f
---B--------o---------BB------------B-------o------------------------o-------Bo--B-o----------B----o----X---------o-----o---------o---------X--------------Xo------------oBo---------B--oX-------------f
--B---------------------------X-------o--------------------------o---o------o--B----o----B---------------------B------------o---XB-----o----------------------------------------o-------B-----------X-of
------oo---oo-----------o----B-----o-o-o------B-B-----o--------------o----o-------------------------------o-----------------X----o----------------o---o-----oo--------o-B--------B--------o------------f
------o-X------------B--o-M--B-----B-----------o---o---------B----X-------o-----------o-----B----------o-----------B------------------------BX-X-B--o----------B-o-X-B--------------oo--B-o----------X-f
mB--E-----------------X------B-------o---------o-----------o---o----o-o---E--B------XoB-------------B-B--------o---o-----------------------oo-----oo---o--------o------B------------------------------oX
XXXXXXXXXXXXXXXXXXXXXXXXXXXXXXXXXXXXXXXXXXXXXXXXXXXXXXXXXXXXXXXXXXXXXXXXXXXXXXXXXXXXXXXXXXXXXXXXXXXXXXXXXXXXXXXXXXXXXXXXXXXXXXXXXXXXXXXXXXXXXXXXXXXXXXXXXXXXXXXXXXXXXXXXXXXXXXXXXXXXXXXXXXXXXXXXXXXXXXXX
