-----BBBB-------------------------------------------------------XX-------------BB--------------B-------------B--------B----------------------------------------------M----------------------------------
---------------------------------------------------------------------------------------------X---B---------------------oX-----------------------------------------------B---------------------------X---
-----------------------------------------------------------------------------------------------------B--------XXX---?-B--B----------X----------------------------B-------B--------X----------------X----
-----------T----------------------------------------------------------------------B---------------B-----------B-------------B--------------------------------------M------------------------------------
---?-------|----------------------------------------------------------------------------X--------------T-B----TX----------------------------------------------B------------------TXXX-------------------
-----------|---------------------------------------o------------------------o----------XX-----------B-?|------|X---T---X---------------------------------------------X----B-B----|--------------------B-
-To--------|------------------------------------------------------------------B-------XXX---X---X-B-T--|-M----|---B|B-XX----MB-------------o------------------------------B------|--B----------------X--
-|---------|----------------------------------------------------------------X--------XXXX-----o---BB|BB|BBX---|----|-XXX---X--------------?-------------------------B------------|-------------B-------v
-|---------|---------------------------------------------------------------????-----XXXXX-------T---|--|????--|----|XXXX---XX-------------------------------------------X--------|---------------------f
-|---------|-----------------------------------------------------------------------XXXXXX---X--X|--o|--|------|----|XXXXM--TXX-B---X-----------------------------------X-B--T-B--|---------------------f
-|--T------|----------------------------------------------------X--------X--------XXXXXXX---XXBB|BBB|X-|--X--B|---X|XXXXBBB|XXX--T-XX---------------------------T---M----T--|----|---------------------f
-|--|o-----|-------------------------------------------------------------XX------XXXXXXXX-B-XXX-|-Xo|XX|-XXoX-|-TXX|XXXX---|XXXX-|XXXX--------------------------|-M-XB-X-|XX|XXX-|---------X-----------f
-|--|------|-------------------------------------------------------------XXX--M-XXXXXXXXXX--XXXX|---|XX|XXX---|-|XX|XXXX-X-|XXXXX|XXXXX-------------------------|-X------|--|----|---------XX----------f
-|--|------|-------------------------------------------------------------XXXX--XXXXXXXXXXXX-XXXX|--X|XX|XXX---|X|XX|XXXX-X-|XXXXX|XXXXXX------------------------|---B----|?-|----|---------XXX---------f
m|-E|------|-------------------------------------------------------------XXXXXXXXXXXXXXXXXXXXXXX|XXX|XX|XXX-E-|X|XX|XXXX-XX|XXXXX|XXXXXXX-----------------------|BBBBEBX-|EB|----|---------XXXX---E----X
X|XX|XXXXXX|XXXXXXXXXXXXXXXXXXXXXXXXXXXXXXXXXXXXXXXXXXXXXXXXXXXXXXXXXXXXXXXXXXXXXXXXXXXXXXXXXXXX|XXX|XX|XXX-XX|X|XX|XXXXXXX|XXXXX|XXXXXXXXXXXXXXXXXXXXXXXXXXXXXX|XXXXXXXX|XX|X---|XX----XXXXXXXXXXXXXXXX
