--X----------o---------------B--------------B--------oB----o------------------o-------o---oo-------------------B------B------------o-o-----------------B-------B----------------------X---o--oB---------
------------o-----------oB-------------X-------B---B------o---------o----B---B----X---------B------------o---------------E----o-----------------B----o--Bo------------o---------XB-o------------------o-
-------------B---X---------oo--X---------o---X---o------X--------------Xo----M---B--------B------------B--o----------o---B-o-o-----------------X-E-------------B--------B--------------o------o----X----
-----oB--B---B-----o----B---B-----B-------X-------------B-B--o--B-----------------B----------------o-----oo--o-----------------o--------------o-----------B---B----Xo---o-------o-----X--B-o------------
-----------o--o--oo---------B--------------o---------X----o--------------B---B---B--XoB------------B-------------oX-----oo----------oo-B-o--------B--B---o---------------o----o----------o--------------
-------B----o---------oXo-----o--o--------------------X-----o-------B--------o----B-X---o--B------------o--oo----------B---B----o-----X------------------------X-o---o-X--o----o------------B----------B
------------------------o--o---o---o-----------o----X--B-Xo-o-X---------------X-B-oXB---------------------------B-B------X---------------X----------o---B-------o-o----o-----------oB------B------B-----
--o-X--o-------o-o--B-----------BB---Bo---------o----X-Xo-B---o-------o----o---------------B--o-B---------oo----------o----------------X--oB---o----BX-----E--Bo-----------------o---------------o---B-v
-------------------------o--------oo----------B------------------------X----o----o---------------------B--o-o-------o---------B----E-X----------o----------------oX--o---o-E------o-----oX-BB--B------of
--X--o-B----------X----BoB--------X------------o--oB---------------------B-----X-oB----------B----------------------------B--X---ooB--B---o--------------------------------B----------------------o----f
----B--------------------B---o-o---B--o---------BB---o---o--------B----------------B-B------------B----o-o-Bo--o------o---BX---oB-o--BB--o--------E-----o---o------E---o----o-BB----------o-----------of
-----------X---------B-----------------BoE--o-o---X-------------o-----------B--------------------B---o-----------B----------B---o------o-------o--Xo---------------------------oB-B-o----X-B----o-o-o--f
-B--o----o----B----oooo-o--B-o---------?---------o---o--oX--------BB----B-o--o---o-------B---E--oo----B----X---o----B---------o--------------B-------E--------o-o-----B-------B-o--------X----------oB-f
-o------BB-----B--------X--B----------o----B--B---B------B--------------------B-------o----o---------XB-B-----B----o---o---oB--E----------BoX-----o?-XX--o----o--o--------B------B-----oX------------B-f
m--B----o----o-oo----o----------------o---oo-BoE-EB---o--o--------------B--B-o-------B---E-----o----o-o--B--X------EX--o----E-------------oBE----E-o---B--------o-Eoo----B----B-------ooB-o-Xo----EE--o-
XXXXXXXXXXXXXXXXXXXXXXXXXXXXXXXXXXXXXXXXXXXXXXXXXXXXXXXXXXXXXXXXXXXXXXXXXXXXXXXXXXXXXXXXXXXXXXXXXXXXXXXXXXXXXXXXXXXXXXXXXXXXXXXXXXXXXXXXXXXXXXXXXXXXXXXXXXXXXXXXXXXXXXXXXXXXXXXXXXXXXXXXXXXXXXXXXXXXXXXX
