-XT---o---o---o-o----o---B--oo-----o--o-o--o--------------------------o------Xo--------o-B-B-?o-Bo---oB--Xoo-XB----B---oB--B--o-o-------o-oo----------B---------o------o?-------------B-------------o-B-
-X|-----E-----B--------o-------o--E--------------o------------B-----B--X-----o----B--------------Bo-E--XB--?-o--X-------o---o----------oB----Bo---o-o---B-------B--X--------X--X------X-----oX-o----Xo-o
--|-o---BX----XBB-----B---o-------X----o------------------o------------B-oo----o--------oo----o-----B-------B-------------Xo---Bo----B-----------o----------B?----BB----o------X----X---B-X--------o----
--|-Xoo----o---X--oo-Bo-----B-X-------B--------B-----X--------------------BBo-----------o------o---o-----o--------------B-------o----oo-----------------oo----o------------o-B-----------------o---o---o
--|--o-------------------B-----BB---------o------X---B------------------oo-oo----oo-o------B-?--o------------BoB--------------o---X-------o--------oBX-----o--X-o-oo--E--o-o--B-o-----o---ooB---B---Boo-
--|--o-----------o--BB-----o----------o---X---------X------------------X--B-o------oo----o---------X-----------------o--X------X--o-----o----X-----o--------oB--------B------B----------B--oX-----------
-B|--------o-------X-----------B--B------------XX------------B----------o-----o--o-o----o---B------------o-------o---------o---------o-------X--------------B------B------------X---B-Bo--------X---X--o
--|----B-------------------oB---o----o-?-----o------oo---o---o-----T-B-o--B----oBX-----o------------oX--X----------oo--o-----X---o--------Bo----X------------o-o------B-B----o-B------------------B--o-v
-o|-Bo--B---X---B------o-------B--X-----------------------B--------|-o-----X---B-Boo-B-XBB--oo---X--o-o---X----X---o------BBXB--B------X---Eo--------X-oB----XB--B--o-----B--o-o--o--------------------f
--|-------X-B--X-o--E-------B--o---------------BX-----Xo--o-o---Xo-|--B---------o--------------oo-------------o-X---X--B---B------X--B-----B--o------o--B----------o--o-B--------o---------------o-----f
-B|----o-oB----B---BB-------------------B-B-Boo-----?-------------B|-oB-o-------o-B-----X----o---------X-oT------------oT---o--B--B--Bo--o---X---o-----------B----o--o---------XX--------------B----oBof
-X|---o----------o---------o---X------B--------o--o----o------BB--o|-X----o---X---------------------------|-oo-o--------|----X--B--------------?----B-X----o---Xo--o--o-T---o----o---E----o--o------B--f
--|-ooo-----------o---B---o-Bo--o-------------o------------o------B|-oB--------o--o------o-------X--o-----|-B-oo-B-o----|------oB----------o---------------X-o-----o----|---B------o-X-------o------B-of
B-|---------------o-----B--------o-----------BT-------------B-B----|---o----T------o----X-T---------------|-------XB----|--------o--X--B--o----?---------B-----B---B----|--oo-----?---------o----o-----f
m-|---oB-X--------X-E--Bo--oo---X--T---o---E--|----EE-oE-----o---E-|--B-----|----E---X-o-B|--EB------B----|-B----o-X-B--|---o---B---------Bo-----X------oo---BX----E----|---o--------oB----oo-E--B-----X
XXXXXXXXXXXXXXXXXXXXXXXXXXXXXXXXXXXXXXXXXXXXXXXXXXXXXXXXXXXXXXXXXXXXXXXXXXXXXXXXXXXXXXXXXXXXXXXXXXXXXXXXXXXXXXXXXXXXXXXXXXXXXXXXXXXXXXXXXXXXXXXXXXXXXXXXXXXXXXXXXXXXXXXXXXXXXXXXXXXXXXXXXXXXXXXXXXXXXXXX
