--------------------------------------------------------------------------------------------------------------------------------------------------------------------------------------------------------
-------????---------------------------------------------------------------------------------------------------------------------------------------------------------------------------------------------
----------------------------------------------------------------------------------------------------------------------------XXXX------------------------------------------------------------------------
---------------------------------------------------------------------------------------------X----------------------------------------------------------------------------------------------------------
--------------------------------------------------------------------------------------------------------------------------------------------------------XXXX--------------------------------------------
--------------------------------------------------------------------------------------------------------------------------------------------------------------------------------------------------------
----------------------------------------------------------------------????????-----------------------------------????-----------------------------------------------------------------------------------
----------------------------------------------------------------------------------------------XXX------------------------------------------------------------------------------------------------------v
----------------------------------------------------------------------------------------------------------------------X--------------------------------------------------------------------------------f
--------------------------------------------------------------------------------------------------B-------------------------o--------------------------------------------------------------------------f
--------?------------------------------------------------------------------------------------------------------o---------?????-------------------------------------------------------------------------f
-----M----------------------------------------------------------------------------To-----------------------T-------------------------------------------------------------------------------------------f
----------------------------------------------------------------------------------|------------------------|-----------------------B-------------------------------T-----------------------------------f
----------------------------------------------------------------------------------|------------------------|----------T--------------------------------------------|-----------------------------------f
m----------XE---------------------------------------------------------------------|--------------E---------|---------B|B--BBBBB------------------------------------|-----------------------------------X
XXXXXXXX--XXXXXXXXXXXXXXXXXXXXXXXXXXXXXXXXXXXXXXXXXXXXXXXXXXXXXXXXXXXX--XXXXXXXXXX|XXXXXXXXXXXXXX------XXXX|XXXXXXXXXX|XXXXXXXXXXXXXXXXXXXXXXXX-XXXXXXXXXXXXXXXXXXX|XXXXXXXXXXXXXXXXXXXXXXXXXXXXXXXXXXXX
