----------------B---Bo----oX------o---B-----X-----?-o--E-oo-B-----o---B---------X----------o--------------X--------B--o---X-B------T---------o-o--Xo-BBB---oB---B------------------------oE------------X
------?-o--o--o-B---X----BB-----------------E----o-----B----------------X--XX---------------o-----------X---------------T-B---B--B-|--o-----o---B---o-o--oo----XB--o-oX-X----o---XoB------B--o-------o--
---X------o---E---B--X----o--X--------------B------------BB---o-B----B-X?o---o--B-------------------X--o--------B-----oB|---B-B----|-oo---------------------B--X------BB------o----------o-T-----B-----o
o-B--o---oB---XT---------o---X---------o---o---B-----B------o------------B------B----X-o---o---o-----o----?X--o--E-o---o|----------|-B--XB---o-X----o--------oo----o----o---o-----B----oo--|------------
--X--BB-B---B--|------XB-o-----B-oo--B----X--o-------B-------o------o------o------B--BB---oo-----------?oo----o--B--Bo--|-Bo-X-B--o|----o---o---o----------o-----------------o-----B-------|------o-----
o-------Xo---o-|----------o-------o-B---------------------X----------X-o--------o---o----------------B-----------B----o-|------o---|---Eo-----------E--------B----B----X--------o--o-T-----|-o-B--------
o--------------|--------o--B-------------------BX--X---B-------------------------------B-------B-----XT----o-B---o------|---o------|-X-X-----------oBoBB----X---oo----o-----BoB---o-o|-----|------------
?-------Xo-----|-----X---B-B---EBoo-----B-----------------------o---o-B-B-------o---B------o-X--------|--o-----o--------|------oo--|-------o-------o-------o---------o--o----o-------|-----|-----------v
-o-------o-oXBo|---------------X-----------oT-----------o-X-----B----B--T------------o---o---Xo-------|----o------------|----B-----|-X--XE----X------------------B--o--oo-----oo-----|-----|-o---Bo----f
o----o-oB------|-Bo----------X--------o---B-|----------B------------B---|-X----oB---oX---X------------|--X---X----------|--------o-|--B--XX------o-B--B---X-----ooB-------o----E-----|--B-X|-Xo--------f
oT-B-------o---|------Bo--------o--o-oB-----|------B-oo--B-----------o--|----------------B---o--oB----|--B---B----B-----|-----o-o-o|--o---o--B------------o---------B--o--Xoo-X------|-----|------B----f
-|--E-o-B---B--|-----X---B---XE-------------|------------Bo-o-X---------|-o---o-------o-------o---oo-E|-o-----o---------|--o----Xo-|----------o-T-------------o-----B------oo-B--oo--|---B-|----------Ef
-|--B----Xo-oB-|-Bo-----------X-XB---o-o----|--o--------B-B------B------|----------B--------o--B-----B|-----o--B--o-----|-o---oX-o-|---------X--|--?-----B------o-X------------------|--Bo-|---o------Bf
-|-o----Bo-----|-----o--o-B-----------------|-----o-----------X---------|-X-------B--o-----o----X-----|-B--Bo-----------|-B---o----|---------oX-|---o--------------B-oo--o-o-B-------|--o--|-B------B--f
m|-------E-----|-X-E-E-Bo------B--oXB-----E-|----X-X----------------B-B-|-o----------o------B-----o---|-----o---o----Xo-|---oo-B--E|-----B------|-o--o---------------o----------E--o-|-----|-E-----o---X
XXXXXXXXXXXXXXXXXXXXXXXXXXXXXXXXXXXXXXXXXXXXXXXXXXXXXXXXXXXXXXXXXXXXXXXXXXXXXXXXXXXXXXXXXXXXXXXXXXXXXXXXXXXXXXXXXXXXXXXXXXXXXXXXXXXXXXXXXXXXXXXXXXXXXXXXXXXXXXXXXXXXXXXXXXXXXXXXXXXXXXXXXXXXXXXXXXXXXXXX
