-----------------------------------------X----------------------------------------------------------------------------------------------------------------------------------B---B------????BBBBBB-------
--------------------------------------------------------------------------------------------------B---------------------------------------------------------------------------X-------------------------
----------------------------------------------------------------------------------------------------------------------------------------------------------------------?-----------------X---------------
--------------------------------------------------------------------------------------------------------------------------------------------------------------------------------------------------------
------B---------------------------------------------------------------------------------------------------------------------------------------------------------------------------XX----BB--------------
-----M-----------------------------------------------------------B---------------X---------------------------------------------------------------------------------------?------------------X-----------
-----------------------------------------o----------------------------------------o----------?????-XXXXXXXX---------------------------------------------------------------------------------XX----------
------------------------------------------------------------------------------------------------X-------------------------------------------------------------------------------------------XXX--------v
------------------------------------------------------------------------------------------B------B----------------------------------------------------------------------------B-------------XXXXB------f
----------------------------------------------------------------------------------------------------------------------------------------------------------------------------------???????X--XXXXX------f
------------------------------------------------------------------------------------------------X-------------------------------------------------------------------------------------X-----XXXXXX-----f
--------------------------------------------------------------------------------T--------X---------------???????----------------------------------------------------------------------------XXXXXXX----f
------------------X-------------------------------------------------------------|--------------------T--B-------------------------------------------------------B---------------------X-----XXXXXXXX---f
--------------------------------------------------------------------------------|------------o-------|---------------------------------------------------------------------------X-------B--XXXXXXXXX--f
m----E------------------------------------E-------------------------------------|----E-----X---E-----|-------------------------------------------------------------------------E---------E--XXXXXXXXXXEX
XXXXXXXX----XXXX------XXXXXXXXXXXXXXXXXXXXXXXXXXXXXXXXXXXXXXXXXXXXXXXXXXXXXXXXXX|XXXXXXXXXXXXXXXXXXXX|XXXXXXXXXXXXXXXXXXXXXXXXXXXXXXXXXXXXXXXXXXXXXXXXXXXXXXXXXXXXXXXXXXXXXXXXXXXXXXXXXXXBBXXXXXXXXXXXXX
