-B-----E-Bo------o--o-o----oB-o---o---------o-o-o--o---------X-------?X-------B-B?---E---Eo--------o--B-----X--B--------o-oo--------o--BB---o---o-o----o----X---B-------------o--------------B----------
-----XoXB-----B-BB-------o---X------BXX-----B----------------X----Eoo------o-------o-B---XX-B------oB------o-B--------B-B-------o-----B--------Bo--------o-o----o----o---o-X---B----o---X------o-T--oo--
---o----B-X--o---o-----o---o-----B-B------o-----------o---o-------BB--------o--o-------Xo------------------X----o--oo-----------------B-B---------o------------X----o-B----------o----o--------o-|------
----Bo-B----o----------B---o---o--------B---E------o------Xo----------E---------o---o--BB--Xo------------X----o-B------o---------XX-o--B----------o-BX-------------o--o-oB-----------------------|------
---oo---ooo-------oo-o--o---oT----------B---BB------------------------Xo-----------?------------B--B---------o-?--oBBo--o-------------------oB-X----E---B-B--------o-----B--------o--------o----o|------
---------------oo------------|-------B-Bo--oB---------------X----------X-------?-----B------B------------BEo------B-o--------------o--o-------------B---BXo--------------oB---o------Bo----------|---o-X
-----o-----X-----o--B----o---|-o-------Bo---------o-----o---o-----oo-Bo---B------o--T---o----X--oo-----X--B---B-?-X-BB--------o----------oBo-------------oooB--o-B---------o------B-o------o--Bo-|----o-
-----B-------------o----X--o-|----------o-------------------BX--------B--o--X---B---|--B-------B-oo------B----o-----o------o-o------------E---------X-B-oB-----------o---X---------Bo--B--BBo----|-oE--v
---oo--oo--B------------o--B-|--B----B--o-E-o----BB-----------------------oo---B----|-----o--B---B-----------------B-X-------B-----------oX--B-----------------------B--o------------B---XB-B----|--Bo-f
-----------o-------B---o-----|--Xoo--B----B--XB-----X--o-B------------B---B-B-------|-B------T------X--X------o-XE-B---oo---------B-o------o----o-B-------Xo----XB--B--------------o---o----o-B--|---E-f
B---E----------------B-------|-B------X-B---------------------------o-----XB--T-B---|---o--Xo|-X-B-B--o--------o-B--------------B-----------X-o--o----o-Xo----o----B-B---o-o------X-B-----------B|---B-f
--o-B---------B--B-o--B---B--|-X-X-------------o-o----o-----B---------o------X|-----|---B-o--|--oT-o---------o---X---?-----XB----o-------o------------------o-X----o-o---------------------------|-----f
--o--------------oB-----o--?o|------Bo-----oXoo------------B----B--o--B----B-o|--BB-|--------|-B-|-----o------------o----o-------------X---o--o------B---o-Bo--X------------XB-------------------|--o-Bf
----o-----oB---oo----ooX-----|---------o-------Booo-------------------o------B|-----|----oo--|---|-B-------BB-oo------------?E----o--X-----o---------B-----------o---------o----------Bo------o--|-----f
m--Xo------Eo-------------Bo-|-E------o-o-----o------------oo-E-Xo---B-T--X---|-----|--------|---|------E-------o----------B-BB---X-o-B---XB--------o--o-B-------X---X--o---o-------------EE-o---|-X---X
XXXXXXXXXXXXXXXXXXXXXXXXXXXXXXXXXXXXXXXXXXXXXXXXXXXXXXXXXXXXXXXXXXXXXXXXXXXXXXXXXXXXXXXXXXXXXXXXXXXXXXXXXXXXXXXXXXXXXXXXXXXXXXXXXXXXXXXXXXXXXXXXXXXXXXXXXXXXXXXXXXXXXXXXXXXXXXXXXXXXXXXXXXXXXXXXXXXXXXXX
