---------------------------------------------------------------------------------------------------------------------------------------------------------------------------------------------BBBBBBBB---
-----------------------------------------------------------------------------??-------------------------------------------------------------------------------------------------------------------------
--------------------------------------------------------------------------------------------------------------------------------------------------------------------------------------------------------
------------------------------------------------------------------------------------------------------------------------------------------------------------------------????????------------------------
--------------------------------------------------------------------------------------------------------------------------------------------------------------------------------------------------------
---------------------------------------------------------XXXXXX-----------------------------------------------------------------------------------------------------------------------------------------
---------------------------------------------------------------------------------o----------------------------------------------------------------------------------------------------------------------
--------------------------------------------------------------??????-----------------------------------------------------------------------------------------------------------------------------------v
-------------------------------------------------------------------------------------------------------------------------------------------------------------------------------------------------------f
--------------------------------------XXXXXXX------------------X----------------------------------------------------------------------------------------------------------------------------------o----f
----------------------------------------------------------B?--XX---------------------------------------------------------------------------------------------------------------------------------------f
-------------------------------------------------------------XXX---------------------------------------------------------------------------------------------------------------------------------------f
---------------------------------------------------------XXXXXXX----------------------BBBBBB-----------------------------------------------------------------------------------------------------------f
-----------------------------------------------T-----------XXXXX------------------------------------------------------------------------------------------------T--------------------------------------f
m----------------------------------------------|----------XXXXXX------------------------------------------------------------------------------------------------|--------------------------------------X
XXXXXXXXXXXXXXXXXXXXXXXXXXXXXXXXXXXXXXXXXXXXXXX|XXXXXXXXXXXXXXXXXXXXXXXXXXXXXXXXXXXXoXXXXXXXXXXXXXXXXXXXXX----XXXXXXXXXXXXXXXXXXXXXXXXXXXXXXXXXXXXXXXXXXXXXXXXXX|XXXXXXXXXXXXXXXXXXXXXXXXXXXXXXXXXXXXXXX
