----------X-----BBX-o----o-B-XB-o---------B-BXXo---o---------X-XX--B-o---o--o-B--X-X---X---B--X-o------BB----B--------B-------o---------o----------BT----------------B----B-------o-----------------o---
-----X--o---------------X--------o--XBo----B----o-B-o--------B----o-B--o---------o----oo-X-o----------o--o----o----------o------oB-------B---B--B-oX|-B-B------------------o?---o---o-X---B-oB---B----B-
------Bo----T--XB------BB-BB-B-----X----------------X---o-o---------------------o----o-B-------o-Bo---------oXBoo---------B----o-----o--EB-------o--|------o------B-------B-------E--o--o--o---oo--Xo-o-
---o--------|--B----------o--------X----o-----------B----B---o-----B--X-----------------B-----o--------o------E------------------o---o--B--------B--|--o-o----------B-E-B-o-------B-------------o--X-BB-
------o---o-|---------o--------------------------o-------------o-----o----BBX-oBoo------B-B-----B--oT-B-------XXB-B---o-X--------o--o------o-o----EX|---B----B-X------X-------o---o----o--------Xo---oB-
----o--oT-o-|---B----oBB---------------------------B------o--o-o----------o--X-B-B-----------o-BBo-B|----B-----------------o-ooo-----------o------BX|----oo----------o----o?-----o------B-?---Bo----o--B
o--o-BB-|-T-|--o-E-------o--Eo----------Eoo--------------X-----o-----BB-B---o----BBB-oB---o----o---o|--B--B--o-o-----B-?------XX--------X-----------|-----o---ooo-o-B-------------X----B-B----B---Bo---B
-oB--X--|-|-|-o--BooB--B---XB-oo--o--X--B--------------------o----oo---o----B-----o----Bo------X---B|----------o---o----B-B----B------oB-------Eo---|-B-o-------------------X------------BB----------B-v
-----X--|-|-|-------B--B----o--X--------------X-X-o-----X-----B--B----o--------B----o------o--------|-B--B---o---B--------B--------B--o-X-B--BBB----|-----o-----o-B-------o---B-----o-B--B-o--oB---B-o-f
--------|-|-|-T----X----o--o--o-T------------------o--X--B---------o--o--Bo-B-o--X---------B--------|-B-----o----------X----------B---X----B----o---|-oB-------o---o-----Xo--X-o-oBXB--------o--o-B----f
-o-o---B|-|-|-|-----------?B----|--------oB--o-----o-------B-----B---------------BX---------------BB|-------B-------o------B----o-----------o-X--B--|---------B--B---------o-----oB--B----B------------f
-----X--|-|-|-|--------------B--|---o--------o-B--------------o--------------------Boo---------o----|--------X-B------B--B--B----B---o---------B-o--|------B-X------B------B-----------B----B-------o--f
----E-X-|-|-|-|-B--B------------|--E----------X-----?----XBB-------------B--------B-----X-----o-B---|-----------B-------------?o--------o---B-------|-?-----------B---------------o------X------X-----Bf
----X---|-|-|-|----o---------X--|--B---B----B-B--E------X--------o----o--XB----oo--oT-----X-o--X-B--|----o----------o------o---o-------------o------|----------o--B--o--?--------------------B---------f
m-------|-|-|-|----o------o---B-|--oo--T--oo-----BE--------o-----B---o-X--o-----o---|--E--o----BB---|-----o--B------E-----o---X--Bo-B----Bo----B----|------o-BB--X----B-----o---E-T---o--------------T-X
XXXXXXXXXXXXXXXXXXXXXXXXXXXXXXXXXXXXXXXXXXXXXXXXXXXXXXXXXXXXXXXXXXXXXXXXXXXXXXXXXXXXXXXXXXXXXXXXXXXXXXXXXXXXXXXXXXXXXXXXXXXXXXXXXXXXXXXXXXXXXXXXXXXXXXXXXXXXXXXXXXXXXXXXXXXXXXXXXXXXXXXXXXXXXXXXXXXXXXXX
