--?--------?-----------------M-----------BBBBB-------------------------------------------XXXXXX------------?-----------------M--?--------X------------------------------------------------------------B-
---------------------------------------------------------o------------------------------------------------------------------------B-o------X------------------------------------------------------------
--------------------------------------------------------------------------------------XXXXXXX----------o-------XXXXXXX---o----------BBBB----------------------------------------------------------------
-----o-----------------------------------------------------------------------------------------------------------T-T---------------T--------o---------------------------------------------------B-------
-----------------------------------------------------------------------------------------??--T----------o--o-----|-|T-To------B----|-oM--X-XXX----------------------------------------------------------
------------------------------------------------------------------------------T----X---------|--------X----XT----|-||-|--T-X----X-X|????XX---X-----------X----------------------------------------------
-------o----------------------------------------------------------------o-----|----XX--------|-----T-oXX--XX|-M--|-||T|-X|BXXB---XX|X--XXX-XXX----------XX----------------------------------------------
----------------------------------------------------------------M--T----------|----XXX---X---|-----|--XXXXXX|--T-|T||||XX|-XXX--XTX|XXTXXX-TXX---------XXX--------------------------------------------Xv
-----X---X--------------------------------------o------------------|-T--X-----|----XXXX------|-----|-XXXXXXX|B-|-||||||XX|-TXXXXX|X|XX|XXXX|XX--------XXXX--------------------------------------------Xf
-----XX--XX-------------------------X------------------------------|-|--XX--??|???-XXXXX----?|-----|-?XXTXTX|-T|X||||||XX|X|XXXXX|X|XX|XXTX|XX-------XXXXX--------------------------------------------Xf
-----XXX-XXX------------------------XX---------------------XXXXX---|-|--XXX---|----XXXXXX----|-----|--XX|X|X|-||X||||||XX|-|XXXXX|X|XX|XX|X|XX--T---XXXXXX--------------------------------------------Xf
-----XXXXXXXX-----------------------XXX----------------------------|-|--XXXX--|----XXXXXXX---|---X-|-XXX|X|X|-||X||||||XX|-|XXXTX|X|XX|XX|X|XX--|--XXXXXXX-------------------------------------------XXf
--o--XXXXXXXXX-------------------T--XXXX---B----------------------?|-|--XXXXX-|---XXXXXXXXX--|-----|XXXX|X|X|X||X||||||TX|X|XXX|X|X|XX|XX|X|XXX-|-XXXXXXXX-------------------X----------------------TXXf
-----XXXXXXTXXX------------------|--XXXXXX----------------o--------|-|--XXXXXX|---XXXXXXXXXX-|-----|XXXX|X|X|X||X|||||||X|X|XXX|X|X|XT|XX|X|XXXX|XXXXXXXXX--------------------------------------B--X|XXf
m----XXXXXX|XXXX-E--------------E|--XXXXXX-------------------------|-|--XXXXXX|-E?XXXXXXXXXXX|E-E-X|XXXX|X|X|X||X|||||||X|X|XXX|X|X|X||XX|X|XXXX|XXXXXXXXX----------------------------------------XX|XXX
XXXX-XXXXXX|XXXXXXXXXXXXXXXXXXXXX|XXXXXXXXXXXXXXXXXXXXXXXXXXXXXXXXX|X|XXXXXXXX|XXXXXXXXXXXXXX|X--XX|XXXX|X|X|X||X|||||||X|X|XXX|X|X|X||XX|X|XXXX|XXXXXXXXXXXXXXXXXXXXXXXXXXXXXXXXXXXXXXXXXXXXXXXXXXX|XXX
