B-o----B------oo--o-X----------------X-----o-B----o---oo--o--------o------o------o---B---o-o---------------------B-------------BXo--X-B------B-----B-B--------------------------------------o-o---o-Xo-B
B----------------o-o-----oE---E---o--------------------------o---BBB----o------o--o--------T------B---B-----B-o-X-B-o------------o---B----X-----X-Bo--BB-o-------------------------------o-----------o--
--B-oo-------B------------X---X----o---X-----B-----------B----o------B------o----oo----o--o|--B-o----o-o--o------X----------?-----BX-----------B-o------o---BoBo-------B-----o--------o---o------o--Boo-
oE----B----------o---BX--B---------B------------X-X----------------o-o---B---B-----------B-|-o-o---------------B-----o-------E--------------o-o-----B---?----oo--T--o----oo-o----B----------------------
-B----o----EB-----o--XBo-o----------B-o-------X--o---------o---o----oB--X--Xo--------------|-----o-X-------Bo----------------B----------------T-----------o------|--T--o-B-----X-o-----B---------o---o--
--B-B------B-X-------o--------B-oo----B-o--?---------o-------oo--------------------B-o-o---|---B-----o---B-------o----oB-B------XX---B--------|-----B----B-------|--|-o------o-X-----------X-X-------BoB
---o-----------------------oX----E-----o------o----o-Bo--------o----------oXo--B-------o---|-------------------B---B--------------------------|---B-----o-Bo-oB--|--|--------B--T--?--------o-o-o----o--
--------B--oBo--------o----------X---------o--o--o-----o--X-----o----Bo----------------oB-o|--?-------------T------X---------E-B-oB-----oE----|--B------------B--|--|-----------|-----------o--o-------v
-o----oB-----o--o----X--oo-X-----------B--o--o--------E-B--oB-o-oo-E---------B-o-B-Bo--oo-o|-o-oo-----------|--Bo-----Bo----oBo-BB------oB----|-------X--------X-|--|--o--------|-------o---X----------f
--o--------B-B-----oB-----B----o-------o---B-o--X-----BB---Bo-----oX------o-B-B--o---------|--o---ooX--Xo-B-|--?--o-o---o---B----Bo-----o---X-|-----B---Boo---X--|--|--T---B----|---------------X--oo--f
------EB-------Bo----o---oBB--o---o--------o--B----B---oo---XX---o----B-----o-------------B|-------------o--|-B--o-----------B---o--oo-----oB-|------------------|--|--|---X---o|---------X-----o------f
--Bo--B-B----------Bo-o-------B-----B----?-------------oo---------o------oB------X---------|------B-oB-o----|---B-Bo--------------------------|-B---o-----B--B---|--|-X|-B----X-|-o----Bo-----------B--f
------o---o-----------------o------o--o-------X--o----o--o-o--------------o--B--o---------o|---T---o-------X|-B----o---o-Xo---------Bo--------|--oo--o--------o--|-o|--|--------|--o--B------ooo-------f
---B---Xo----o-----B-o---------B--BEo---o-o---?B-BoB-o-o---X------oB--B----o-o--X----o-----|---|------X---o-|-----B-o--X-T-------o---o------T-|-o-o-----B----oo--|--|--|--o-----|-----------oo---o-B---f
m----X---E--X--o----X----T--BoE-X--B---------B-B-----o-------E-----E----oE-----------------|---|-----o---B--|----o-o--o--|---oo--X---BB-----|-|-Eo----o---B------|--|--|-o-o----|------o-------T-E--E--X
XXXXXXXXXXXXXXXXXXXXXXXXXXXXXXXXXXXXXXXXXXXXXXXXXXXXXXXXXXXXXXXXXXXXXXXXXXXXXXXXXXXXXXXXXXXXXXXXXXXXXXXXXXXXXXXXXXXXXXXXXXXXXXXXXXXXXXXXXXXXXXXXXXXXXXXXXXXXXXXXXXXXXXXXXXXXXXXXXXXXXXXXXXXXXXXXXXXXXXXX
