--------------------------------------------------------------------------------------------------------------------------------------------------------------------------------------------------------
------------------------------------------------------------------------------------------------------------------------------------------------------------------------------------------------M-------
--------------------------------------------------------------------------------------------------------------------------------------------------------------------------------------------------------
--------------------------------------------------------------------------------------------------------------------------------------------------------------------------------------------------------
--------------------------------------------------------------------------------------------------------------------------------------------------------------------------------------------------------
-----------???------------------------------------------------------------------------------------------------------------------------------------------------------------------------------------------
---------------------------------------------------------------------------------o----------------------------------------------------------------------------------------------------------------------
-------------------------------------------------------------------------------------------------------------------------------------------------------------------------------------------------------v
-------------------------------------------------------------------------------------------------------------------------------------------------------------------------------------------------------f
-----------B---------------------------------------------------------------------------------------------------------------------------------------------------------------------------------------???-f
-------------------------------------------------------------------------------------------------------------------------------------------------------------------------------------------------------f
----------------------------------------------------------X-----------------------------------------------------------------------------------------o--------------------------------------------------f
---o-------------------------------------------------------------------------------------------------------------------------------------------------o-----------------------------B-------------------f
--------------------------------------------------------------?------------------------------------------------------------------------X---------------------------------------------------------------f
m-----X-----------------------------------------X-------------------------E-----------------------------------------------------------XX---------------------------------------------------------------X
XXXXXXXXXoXXXXXXXXXXXXXXXXXXXXXXXXXXXXXXXXXXXXXXXXXXXXXXXXXXXXXXXXXXXXXXXXXXXXXXXXXXXXXXXXXXXXXXXXXXXXXXXXXXXXXXXXXXXXXXXXXXXXXXXXXXXXXXXXXXXXXXXXXXXXXXXXXXXX------XXXXXXXXXXXXXXXXXXXXXXXXXXXXX-----XX
