---------------------------------------------------------------------------------------------------------------------------------------------------------------------------------------------B----------
--------------------------------------------------------------------------------------------------------------------------------------------------------------------------------------------------------
--------------------------------------------------------------------------------------------------------------------------------------------------------------------------------------------------------
--------------------------------------------------------------------------------------------------------------------------------------------------------------------------------------------------------
--------------------------------------------------------------------------------------------------------------------------------------------------------------------------------------------------------
--------------------------------------------------------------------------------------------------------------------------------------------------------------------------------------------------------
--------------------------------------------------------------------------------------------------------------------------------------------------------------------------------------------------------
--------------------------------------------------------------------------------------------------------------------------------------------------------------------------------------------------T----v
--------------------------------------------------------------------------------------------------------------------------------------------------------------------------------------------------|----f
--------------------------------------------------------------------------------------------------------------------------------------------------------------------------------------------------|----f
--------------------------------------------------------------------------------------------------------------------------------------------------------------------------------------------------|----f
--------------------------------------------------------------------------------------------------------------------------------------------------------------------------------------B-----------|----f
-------------------------------------------------------------------------------------------------------------------------------------------------------------------------------------------T------|----f
-------------------------------------------------------------------------------------------------------------------------------------------------------------------------------------------|------|----f
m-------------------------------------------------------------------------------------------------------------------------------------------------------------------------------------X----|E-----|----X
XXXXXXXXXXXXXXXXXXXXXXXXXXXXXXXXXXXXXXXXXXXXXXXXXXXXXXXXXXXXXXXXXXXXXXXXXXXXXXXXXXXXXXXXXXXXXXXXXXXXXXXXXXXXXXXXXXXXXXXXXXXXXXXXXXXXXXXXXXXXXXXXXXXXXXXXXXXXXXXXXXXXXXXXXXXXXXXX-------XXXX|--XXXX|XXXXX
