---------------------------X-----------------------------------------------------------------------------------B-----o????---X-B-B--X---X---o-o-----X---------------?-------------M----M-B--------B????-
--------------------------------????????---------------------------B-?-----------------------------------B-????X??-----X-B---------B---B--M--X--B-------------------------B-----o--o?--------------?----
------------------------------------------------------------------------------------------------------------------XX-B--------------Bo----------B--------X----X-----------------------X--XXXXX-----BB-X-
------------------------------------------------------------------------------------------XMo-------------------o----X-o--------------------X-------???M?---B---------------T--B-T--------B-o-B-----M-B-
-------------B---------------------------------------------------------------------------------o---X-------------oB--XX---o--XXXT----BXo----------------------B-------------|BB-M|B----B--B---X----X-X--
-----------------------X---------------------------------------------------------------X------XXXXXX--?------B--------X-----T---|-X--XX---X--T--XB-T---B----------------X---|----|-X------T--XX--X-X----
-------X------------------B-----------------------------------------------------------X----------XXX---------X-BXXXXXXXX----|???|X--XXX-X----|---X-|X-o---X----------X--XXB-|----|XXX---X-|-XXX-XXX--B--
-------------------------------BT---B----------------B------------------X-----------------------XXXX--X---B-XXB-------XXX---|---|XXXXXX-XXB?-|---T-|X---------------XX-XXXXB|XBX-|XX------|XXXXX-XXXT-Bv
--------------------------------|-----------------------------------o--XX----------------------XXXXX-------XXX----oB--XTXX-B|---|XXXXXX-XXX--|---|-|-----X---------XXX--XXXX|---X|XXBX-o--|XXXX--XXX|--f
--------------------------X-T---|-------------------------------------XXX---------------------XXXXXXX-----XXXX------XXX|XXT-|-X-|XXXXXXBXXXX-|--X|-|-----o--o-----XXXX--XXXX|--XX|XXXX---X|XXXXBBXXX|X-f
----------------------X-----|X--|-------------------------------BBBBBXXXX---------M----------XXXXXXX-B--XXXXXX---X-BXXX|XX|X|XXX|XXXXXXBXXXXX|-XX|-|-X-----------XXXXX--XXXX|XXXX|XXXX--XX|TXXX--XXX|XXf
-----------------XX---------|--B|-------------------------B------XXXXXXXX------X-X----------XXXXXXXX----XTXXXX-X---XXXX|XX|X|-XX|XXXXXXXXXXXT|XXX|-|XX------XXT-XXXXXX--XXXX|XXXX|XXXX-XXX||XXX-XXXX|XXf
----------------------------|---|---X------------------------------XXXXXX------------------XXXXXXXXT---XX|XXXX----XXXXX|XX|T|XXX|XXXXTXXXXXX||XXX|-|XXXXXX----|XXXXXXXXXXXXX|XXXX|TXXXXXXX||XXX-oXXX|XXf
----------------------------|---|------------------------------B--XXXXXXX-----------------XXXXXXXXX|--XXX|XXXX--BXXTTXX|XX|||XXX|XXXX|XXXXXX||XXX|X|XXXXXX----|XXXXXXXXXXXXX|XXXX||XXXXXXX||XXX--XXX|XXf
m---------------------------|---|-------E--------------------E---XXXXXXXX-------------E--XXXXXXXXXX|-XXXX|XXXXX-XXX||XX|XX|||XXX|XXXX|XXXXXX||XXX|X|XX-------X|XXXXXXXXXXXXX|XXXX||XXXXXXX||XXX--XXX|XXX
XXXXXXXXXXXXXXXXXXXXXXXXX---|XXX|XXXXXXXXXXXXXXXXXXXXXXXXXXXBXXXXXXXXXXXX--XXXXBXXXXXXXXXXXXXXXXXXX|XXXXX|XXXXXXXXX||XX|XX|||XXX|XXXX|XXXXXX||XXX|X|XX---X--XX|XXXXXXXXXXXXX|XXXX||XXXXXXX||XXX-BXXX|XXX
