------------------------------------------------------------------------B------------------------------------------------------------X----B----o--------B----------M-X------B--X------------------------
--------------------------------------------X---------------------------------------------------------------------------------------?--------X????????--B--------------X--------------------------------
------------------------------------------------------------------------------------------------------------------BB--------------------------------------------------------------B---------------X-----
---------------------------------------------------------------------------------------------------------X----------------------------------X----X-------------T-------o---------------------------XXXX-
-----------------------------------B------------------------------------------------------------------------B----------------------------------X-X-------------|--?----------?????----------------B---X-
---------------------------------------------------------------------------------------------------------------------------------------------X-----------------|-------------M-B------B------T---XX-XBo-
---------------------------------------------------------------------------------------------------------------------------------X---------------T------X-??T--|----B----------------X---X---|--XX-XX---
--------------------------------------------------------------------------------------------------------------------XXXXX---B----B--------X------|-X----XX--|--|---X--X-------------X--XXX---|-XXXXXX--v
-----B--------------------------------------------------------------------------------------------------------------------------o-------------XM-|-XX---XXX-|--|---XX------X----B--X---XXX---|XXXXXXT-Xf
-----------------------------------------------------------------------------------------------------------------------------------X-------------|-XXX--XXXX|--|---XXX---------???-XX-XXXX---|XXXXXX|XXf
-------------------------------------M----------------------------------------------------------------------B---------------------------------M--|XXXXX-XXXX|-M|---XXTXM-T---------XXXXXXX--X|XXXXXX|XXf
--------------------------------------------------------------------------------------------------------------------------------X-o-X------------|XXXXXXXXXX|X-|--TXX|XX-|---------XXXXXXX-XX|XXXXXX|XXf
--------------------------------------------------------------------------------------------------------------B--------------------------X------X|XXXXXXXXXX|XX|-X|XX|XXX|--B------XXXXXXXXXX|XXXXXX|XXf
----------------------------------------------------------------------------------------------------------------------------M------X-----------XX|XXXXXXXXXX|XX|-o|XX|XXX|B----X--XXXXXXXXXXX|XXXXXX|XXf
m-------------------------------------------X------------------------B------E-------------------------------X-------------E-E-E---XX-----EBE--XXX|XXXXXXXXXX|XX|X-|XX|XXX|X----XXXXXXXXXXXXXX|XXXXXX|XXX
XXXXXXXXXXXXXXXXXXXXXXXXXXXXXXXXXXXXXXXXXXXXXXXXXXXXXXXXXXXXXXXXXXXXXXXXXXXXXXXXXXXXXXXXXXXXX-----XXXXXXXXXXXXXXXXXXXXXXXXXX----XXXXX-XXXXXXXXXXX|XXXXXXXXXX|XX|XX|XX|XXX|XX---XXXXXXXXXXXXXX|XXXXXX|XXX
