------------------------------------------------------------------------B--------------------------------------------------------------------------------------------------------------XXXXXXXX---------
------------------------------------------X-------------------------------------------------------------------------------------------------------------------------------------------------------------
-------------------------------X--------X---------------------------------------------------------------------------------------------------------------------------------------------------------------
--------------------------------------------B-----------------------------------------------------------------------------------------------------------------------------------------------------------
----------X--------------------------------------------------------------------------------------------------------------------------------------------------------------B------------------------------
-------------------------------------------------------------------------------------------------------------------------------------------------------------------------------M------------------------
----------------????????X-----------X-----------------------------------------------------------------------------------------------------------------------------------------------------------M-o-----
--------------------X-X-------------XX-----X---------------------------------------------B-------------------------------------------------------------------------------------------------------------v
----------------------XX----------?-XXX----------------------------------------------------------------------------------------------------------------------------------------------------------------f
--------------????----XXX-----------XXXX---------------------------------------------------------------------------------------------------------------------------------------------------------------f
----------------B-----XXXX------??--XXXXX-------------------------------------------------------------------------------------------------------------------------------------------------------X------f
----------------------XXXXX---------XXXXXX-------------------------------------------------------------------------------------------------------------------------------------------------------------f
----------B----------XXXXXXX--------XXXXXXX------------------------------------------------------------------------------------------------------------------------------------------------------------f
-------------X------XXXXXXXXX-------XXXXXXXX-----------------------------------------------------------------------------------------------------------------------------------------------------------f
m-----------E----E-XXXXXXXXXXX------XXXXXXXXX-------------------E-----------------------------------------------------------------------------------------------------E------E-------------------------X
XXXXXXXXXXXXXXXX--XXXXXXXXXXXXX-o--XXXXXXXXXXXXXXXXXXXXXXXXXXXXXXXXXXXXXXXXXXXXXXXXXXXXXXXXXXXXXXXXXXXXXXXXXXXXXXXXXXXXXXXXXXXXXXXXXXXXXXXXXXXXXXXXXXXXXXXXXXXXXXXXXXXXMXXXXXXXXXXXXXXXXX---XXXXXXXXXXXX
