----------------------------------------------------------------------------------------------------------------------------X--X---------------------------------------------------------------X--------
--------------------------------------------------------------------------X----------------------------B--------B-----------------------------------------------------------------------------------X---
---------------------------------------------------------------------------------------------------------------------------------------------------------------------------------------------------B----
----------------------------------------------------------------------------------------------------------------X-------------------------------------------------------------------------------------X-
-X---------------------------------------------------------------------------------------------------------XB------------------------------------------------------------------------------------XX-X-X-
----------------------------------------------------------------------------------------------------------------------------------------------------------------------------------------------------B-X-
-----------------------------------------------------------------------------------------------------------------------------------------------------------------------------------------------BX-o---X-
---------------------------------------------------------------------------------------------------B-----------------------------------------------------------------------------------------X--XXXXX-Xv
------------------------------XXXX-----------------------------------------------------------------------------------------------------------------------------------------------------------XX--B--XXXf
------------------------------------------------------------------------------B------------------T-----------------------------B-------------------------------------------------------------XXXBX--XXXf
---X---------------------------------------------------------------?-----------------------------|-----------------------------?-------------------------------------------------------------XXXX---XXXf
------------------------------------------------------------------------------------------------B|-----X---------B---------B-----------------------------------------------------------------XXXXX--XXXf
-------------------------------------------------------------------------------------------------|---------------------------X---------------------------------------------------------------XXXXTXXXXXf
-------------------------------------------------------B-----------------------------------------|-------------------------------------------------------------------------------------------XXXX|XXXXXf
m------------------------------------------------------------------------------E----------E------|------------------------E-----B----------------------------------------------------------E-XXXX|XXXXXX
XXXXXXXXXXXXXXXXXXXXXXXXXXXXXXXXXXXXXXXXXXXXXXXXXXXXXXXXXXXXXXXXXXXXXXXXXXXXXXXXXXXXXXXXXXXXXXXXX|XXXXXXXXXXXXXXXXXXX-XXXXXXXXXXXXXXXXXXXXXXXXXXXXXXXXXXXXXXXXXXXXXXXXXXXXXXXXXXXXXXXXXXXXXXXXXXX|XXXXXX
