----------------------------------------------------------------------------------------------------------?------------------------------------------------------------------X------X-----X-------------
-------------------------------------------------------------------------------------------------------------------------------------------?-------------------B----------------------------X-----------
---------------------------------------------------------------------------------------------------------------------------------------------------BBBB-------------------o-------X---------------------
----------------------------------------------------------------------------------------------------------------------------------------------T---------X-----------------------------------------------
----------------------------------------------------------------------------------------------------------------------------------------------|---------------B-----------------------------BX----------
----------------------------------------------------------------------------------------------------------------------------------------------|------B-------------------------------B----------o-------
-To---------------------------------------------------------------------------------------------------------------------------------------T---|--------------------------------------------------B--X---
-|----------------------------------------------------------------------------------------------------------------------------------------|---|--------------------X--------------------X------B---M---v
-|----------------------------------------------------------------------------------------------------------------------------------------|---|-----------------------------------------XX-------------f
-|----------------------------------------------------------------------------------------------------------------------------------------|---|-----------------------------------------XXX------------f
-|--T-------------------------------------------------------------------------------------------------------------------------------------|---|--------X------T-------------------B-----XXXX------B-M--f
-|--|o--------------------------------------------------------------------------------------------X---------------------------------------|---|---------------|-------------o-----------XXXXX-------M--f
-|--|-----------------------------------------------------------------------------------------------------------------------------------X-|---|-------?-------|----------------B--------XXXXXX---------f
-|--|-------------------------------------------------------------------------------------------------------------------------------------|---|----------X----|-------------------------XXXXXXX------??f
m|--|-------------------------------------------------------------------------------------------------------------------------------------|---|----E--E----E--|------------BE-----------XXXXXXXX--E---EX
X|XX|XXXXXXXXXXXXXXXXXXXXXXXXXXXXXXXXXXXXXXXXXXXXXXXXXXXXXXXXXXXXXXXXXXXXXXXXXXXXXXXXXXXXXXXXXXXXXXXXXXXXXXXXXXXXXXXXXXXXXXXXXXXXXXXXXXXXX|XXX|XBXXXXXXXXXXXXX|XXXXXXXXXXXXXXXXXXXXXXXXXXXXXXXXXX-o----X
