------------------------BX----B---------------------B----------------------X-------------------------------X--------------------------------B--------------------B--B-------------------------------B---
---------------------------------------------------------------------X--------------------------------------------------------------------------------X----------------------------B-B----X-------------
----------B---------X--------------------------------------X------------------X-----------------------------X---------B-------------------------------------B------------------B---X--------------------
------------------------X--------------------------------------------------------X----------------------------------B---B---XB-------------------------------X------------------------------------------
--X---------X-----------------------BX--------------------------B-----------------------------------------------------X---X-----------------------------B-----B-----------------------------------------
--------------X---------------------X--------------------------X-B-----B------------------------------------------------------------B---B--------------X-----B------------------------------------------
-----X--------------------------B-------------------------------------------------------------------------X------------------------X-------------------------------------------------------B-----X------
--------------------------------------------------------------------------X--X----------------------------------------------------------------------B--------------------------------------------------v
-------------------X------------X--------X--------------------------X----------B-------B---------------B-----------X------------------------------------------------------X---------------------X------f
-----------B---------------------X--X---B-----------B----------------------------------------XB-B-------------------------------------------------------------------------------X----------------------f
--X--------------B---------------------------B-----------------------------------------B--------------------------B------------X--------------X--------X--X--------------------------X--------------B--f
--------------------------------B-------------------B----------------B--------------------------B------------------------------------------------------------------------------------------------------f
-----B----------------------------------------------X--------------------------------B----B-----B--B-----------------------------------B-------------------------------------------X----------------B--f
-----------------------------------------------------------------------------B-----------------X---------------------------X------------------------------B--------------------------------------------f
m--------------------------B-X----------------------B-----------------------------B-----X-------------------------------------------------------------------X-------------------------B-----X----------X
XXXXXXXXXXXXXXXXXXXXXXXXXXXXXXXXXXXXXXXXXXXXXXXXBXXXXXXXXXXXXXXXXXXXXXXXXBXXXXXXXXXXXXXXXXXXXXXXXXXXXXXXXXXXXXXXXXXXXXXXXXXXXXBXXXXXXXXXXXXXXXXXXXXXXXXXXXXXXXXXXXXXXXXXXXXXXXXXXXXXXXXXXXXXXXXXXXXXXXXX
