-------------------X-------B-----B---B-B-o--o--------X-X-------------B-------B----B-------oo--o---B--o--B-----BB--------------------X------o---o--Xo-oB---------B-----X----B--------o--o--B--o----------
-X---o-o----------o-o--B-----B--X-B-B--BB--oB-o---X--X-----o-o------X---------B--o-B--B---B-------B-----B--o--oEBXB--o-o------------------------o---oB--B-----o--------------o-----------o---------B----
-----------------------oo-oo---o-------o-o-T-XB-------o--o-----------o---o------------BooBX--B----------Bo-----------B----------------X---------B------------------o-Bo--X-B-B--oo----------B---o-----X-
---B----o------------------o------o--------|---------------B--B--oo----oo-Xo------------------oX---------------------oX--o-------------ooo--B---X-------X-----X-----o---o------X--o------o---o---o--BBB-
--------X------------E-------BX-o-------B--|---X--?--B-----o--------B--oX--------X-o-------o-o------------ooo-B--o--------------------------Bo-o----------------------o--------X--------X-----B----B----
--o-X---ooo-X--------X----B---o-----BB----o|-----------------B--B-----B-------o--------------X------------X-----o--------------------B------o------B---o-oX---T----o------o-------o-----o-?o------o--BB-
-----------o--Mo----B-----------o--X-o---XB|--B----Eo---------------o----B-B------------o---------X-----o-X-Xo--o--o-Bo---B-----------o-BB-B----------o-----o-|---X--B---o-o----------o--X--------------
---oo------oB----X-BooB-----------o----B---|-----o---------------B-BB----Bo-B-o-o-----B--B--X-?----?-------------B-o------o--oXo--------------oX------B---o---|-B-oX-----B-o-B-----------o-oB-----B----v
-B--------X-B----?----------B------------oB|--B-------o-X---BX---oB-------o-o-----o---X--------o-----------------X-Bo-------o--o-----o---------Eo-------X---E-|--B--o--X-------o-o-------X-o----B-B----f
B----o----X---oo---o----o-o-----o---o---Xo-|--o-----------o----------o------o-o-o--X--------------o---B---oB----o---o--------------X--------B-o------o------E-|--oB---------------o--------B-o----o-o--f
------o--BX---o------B-----T-----B--B---X-o|-B--------o-Bo-----o--B-------oB-B-B----ooo----Bo-------------B---E-------X----B---------------E-o----o-----o-----|-X-------B--------------o--o----X-------f
------------X--------oo----|--oT-----E---BX|--B-----B--o----o-X-B-BB----------------------X-------B-----o-----------------------o--o--o-Bo----B-------B--Bo-o-|---o---------------------------------ooXf
-------------------o---B---|-o-|-ooo-X-----|---------------o-B-B----BX---------o----B----o--o-BBo---o---o---o---BX-------B-----o---------o--------------B--o--|-o-------------X-----B------------------f
-X---o-B-B--o----B---oE----|---|---o-------|--X------B--B-----------X--o---B-------B--o-Xoo-o---------B---o-oo---B--o---oBo-----------o---o----X-B--o---o-----|--o-----B--------B-B--o-X------XBX-----of
m---E-EXB------------------|---|--XXo--E---|-----X--B---------------E--------B--oo----X-o--oX-------------o-oBB-B----------------oo--------X----oBX--o---o-BM-|-------B----oooX------X-----o-B---ooX----
XXXXXXXXXXXXXXXXXXXXXXXXXXXXXXXXXXXXXXXXXXXXXXXXXXXXXXXXXXXXXXXXXXXXXXXXXXXXXXXXXXXXXXXXXXXXXXXXXXXXXXXXXXXXXXXXXXXXXXXXXXXXXXXXXXXXXXXXXXXXXXXXXXXXXXXXXXXXXXXXXXXXXXXXXXXXXXXXXXXXXXXXXXXXXXXXXXXXXXXX
