------B-oB---o--o-o-----------B--o---X-------oo-------------B--o---B-Xo--X---------------------------o----o----Bo--------------BX--o--BX---------------------o----------------------X---------B-----o--B
-------------oBo----------B---Bo-oo-oB------X-o-oB-------o-B--o--Xo----EX----------------X--o---oB---X-B-----B-------o-oX--B----B-oX--B-o-o-o---------------B----o--B------B-o---B---o--B----B----------
-----------o---------o--B------B-----------------------o-o-o-------B------E-o----o------o--B-------B-----X------Xo--B-----X-X-----------o-Boo--X-o-o--------------o-B--o-oo-B---o-------o--X---o-o------
----o----------E-o----o---BB-B--o--o--X-----oo---X---X---X-o--o-B--------------Bo---o-------X----oo--o--------o-o------------B----B-------B---oB--B-----------------------oT-B---oooE-o----------ooo----
o------X----X-o-o-------------B---------X-o---o-EB----E----oo----oo---B---B------B-X-B----X----o-B------------------B-BE------B----B---------X-----o-----o------o---B---B-o|-XBo---------o-----E------o-
----o-----BE--E---T----o-B-----Xo-o-----o-BoXo-----B-----XB-?---Bo-------------------------------oB---o---o---------oB--B----X--o-----E-X--X------o-------o-E----X---------|--o-XEo------T--------------
-o-----X---T------|------E---------------oB-------oo-B------o----X-------X-Xo?--------------B--------------B----------Bo--------B----BB-B---B-B------E----o---o---X-X--o--o|-------o-----|------o-------
o---B--B---|------|------------oB--B-----o-B------o---o--o--X---M-Bo-----------B-o-------------E-X---ooo---oo--B---B----o---o---o--o-o--o----oB---X--------X-B--BX-----Bo--|-----B-B-B---|----B--------v
-------B---|-o----|--T-X-o-XB-B---E--------B-o-BBE-oX-o-B-----B---o-T-------------B-----------B--o---------------B--------------B---B----o-------B-B-B----oo-B-----------o-|-o---X-------|-X-----o-----f
---o-BX----|-oB--B|--|-o-------XX-oo------------Xo----------------o-|----------X---oB--------------T--B---XX---B--o-----X--E-oo-X-----o-------E-----------o-Bo-------------|-B-------o-o-|---B-----o---f
-oo-B------|------|-o|---oB-o------o--oB---B------Bo-o-oB-B------o--|--o-B--o-B------B-B--B--X-----|------o-o-o-o----E-------Bo--------o-----B-B----X-----------XX---------|--o----------|--------o----f
--X--o---Bo|------|--|-------o-T--X-----o-oE---B-X---o-B---------o--|---o------oX-o-X---B-----o----|----Bo--X--B------?X------o---B--o-X-------BoB----o----o---B-o---B----o|---E------T--|--o----------f
o-------B-o|-----o|--|--ooo----|----B----o---o------o-o---o---------|----------X--o-o--o----o--o--E|----o-o--------o-B--B-------Bo--o-o---o--------o--------B--------------|---BB----o|--|---------B---f
X---o------|------|--|--o-o----|---------X-oB-o------o----o--?-B-X-X|--o-----X---o-------------Xo--|--B---o-----B--B---------o--B-X-B--o-X--------B---o---------------Bo--E|-----o--X-|--|---o--------of
m----oo----|--o---|--|--E---E-X|-E----E-B----B----o-------o---E-o---|--B--Bo-----B----BX----EB-----|----------B-BX---o---Xo--------E--B--------o--B--o----o-o-B--o-BEE-----|-BXE------|--|-B-----o------
XXXXXXXXXXXXXXXXXXXXXXXXXXXXXXXXXXXXXXXXXXXXXXXXXXXXXXXXXXXXXXXXXXXXXXXXXXXXXXXXXXXXXXXXXXXXXXXXXXXXXXXXXXXXXXXXXXXXXXXXXXXXXXXXXXXXXXXXXXXXXXXXXXXXXXXXXXXXXXXXXXXXXXXXXXXXXXXXXXXXXXXXXXXXXXXXXXXXXXXX
