--oo-oo-------X---X--o--o---------------------o-------BB-o---o---B-o---B----Bo-----B--------------B------o-X---X-----------o---B---B-o-------------Bo-oo-----------o--B-----B------------X----------o---
----o-B---------o------o-------------o-----B---B--------o---oo---X-------o------B--o----o----o------o--------o-E---------------------o-o---------------X-o--o---------o--o-------------B------o-B--B----
---------XX-B----B---o------------XB---oo-----X---B---B--B---o-o-o-----------B---o-o---------BB----o------X---o---X---------B------------------o----oo-------Bo-------B--oX-----X----------oBX--o-------
------Xoo---B--o-----o----BXooo--------Bo----------oB----oB---BX-------o--X--------o-----------B-------o--o---------------o-------B----XB-----o---X---ooo--o--o---o------B-o-------------------------o--
-----------X-----o-----B----------oX---B---E--------------o--B---X--------------ooB-----------B---------o---o-B--------------o-B--X---XB--ooB-------------o--X-----Xo--X-----B--------X-------B--B-o----
-o-----o------X------o------------------------o------o-o-X-----oX----X--------XB-------X-B-----B-------o---X----------o-oE----o------------o--B?B------B------X-Xo----------X-B--B-----------X-------o--
-----oo--X---o---o--------Xo-X---------o------o---X-B--X-----X---B----Bo--ooBo----X--X--------------B---------------------T--B-------------------o---------o--o-----o---o--o---o----B--o--------B-----B-
---------------?----XX--o-B----B-o--E--------------o-B---------o----------ooX--o----------o---Boo-o-B---------------------|----o----o--B-------------------------------oo-B------o-------o---------o-o-v
o-B-----o-----------------o----oo--B--B---o------X------o---------B---------o---B------oB----------o-o-X---oB----o-B------|-----B--------------------o--o-------BoB-------o--------oB-B-BBo-B--------o-f
-B---BB--------o---------o-----------------X---o-o-B---------------------------------o--o------------o--o-o------B-Bo-----|---o----------------o--o-o-o------B----------BB---o-----B--------?--o---B---f
o--T--------X-----o----o-----B-----Xo--X------TE---o--------o----o-------o-----B-o--B---oB--B---------------X----------o--|-----X------E---------X----------------oB--o--------------------------------f
---|----X--X---B-----X-E--------ooB------X----|--B--X---------X----X------o------X--B------------B---B--------o--BX-o--oX-|-----o---------o------------B-B--o-M-----------B--B-----B----o-------oX---o-f
-B-|---X-o--T--B------o-----oo-B--o-----B-----|--B----------o---------X-----X--?--oo--------------o------oo----o----------|----------X------------Xo-----------------------B--X-------B--------------B-f
---|---B--o-|----B-B-o-X-X--?Xo-----oX---o----|----o---------o---o------------X-----------o----------o-o------B-o---B-----|--o-------B-o---------------------B---------o--o--o---o----o--X---B---------f
m-B|-o--o--o|-o--o--o--o--B----oBB-o---o-E--E-|--o-----------X-E-------oM-----o----E-o------B---------------------B-o-----|---E-----ooB----B---B-o--X-----o-B-------------B----E-E--------oX-E------oX--
XXXXXXXXXXXXXXXXXXXXXXXXXXXXXXXXXXXXXXXXXXXXXXXXXXXXXXXXXXXXXXXXXXXXXXXXXXXXXXXXXXXXXXXXXXXXXXXXXXXXXXXXXXXXXXXXXXXXXXXXXXXXXXXXXXXXXXXXXXXXXXXXXXXXXXXXXXXXXXXXXXXXXXXXXXXXXXXXXXXXXXXXXXXXXXXXXXXXXXXX
