------------------------------------------------------------------------------------B????----------B-B------------X------B------------------B-----------?????---X-------------o--------X-----------X----
------------------------------------------------------------------------------------------BX--X------?------X---B---------------------X----------------X------------B-M-----------------?--B-----X------
-------------------------------------------------------------------------------------XXXX-XXXXB---o---M--------------X------X-----------B----B---------X------------B------B---------------BBBB---------
--------------------------------------------------------------------------------------------X-------T---T--XXXXXXXo-------B----------------------X----o--------------X--------X-------------------------
---------------------------------------------------------------------------X----------X---X------X-X|--T|-X--?---B---------------X-B-----X--------------------------------X----------XB-------------XoB-
-------------------------------------------------------------------B-------------------X-XX?---X-X-?|-T||X--X----X---T---X---B----------T--------M-B----B--------------------X-B------------------------
--------------------------------------------------------------------B-----------------o-XXX---------|-|||XTT---BBBXBT|B-----------X-----|------X--------------X----XB--------oX---X-?-------T-----BX----
---------------------------------------------------------------------------------------XXXX-------BM|-|||-||--X----X||---o-------B-----X|-X---------------X--B---B----X-------X---XX--X-B---|-X----B---v
----------------------------------------------------------------------------B-----X-X-XXXXX--------X|-|||-||---o??T?||------------------|-XX--X-----XXXXXXX----XX----?------------XXX-----B-|---X------f
-----------------------------------------------------------------------------------TXXXXXXX-MT------|-|||-||-X---T|-||---X---------B----|-XXX-------XB--B------XX----T----X------BXXXX----X-|---XX-----f
-----------------------------------------------------------------------------------|XXXXXXX--|-XT---|-|||X||XXX--||?||BBXBBB----M-------|-XXXX------XX-?-------XX----|-----------TXXXXX--XX-|---XXXB-B-f
-----------------------------------------------------------------------------------|XXXXXXXXX|-X|-X-|M|||-||--X-B||-||-XX-XXXXXXXX---T--|-XXXXX-----XXX-------XXXX--o|-----B-BB--|XXXXXXXXX-|---XXXX---f
----------------------------------------------------------------------------B-----X|XXXXXXX--|XX|XXX|X|||-||X--B-||B||XXX------------|--|-XXXXXX----XXXX-----XXXXXX-T|-----------|XXXXXXXXX-|---XXXXX--f
-----------------------------------------------------------------------------B--XXX|XXXXXXX--|-X|TXX|X|||B||?----||-||XXX--X---------|-T|-XXXXXXX---XXXXX---XXXXXXXX||-----------|XXXXXXXXX-|---XXXXXX-f
m------------------------------------------------------------------------------XXXX|XXXXXXXEX|XX||XX|X|||B||?X-E-||-||XXX----B--oE---|-||-XXXXXXXX--XXXXXX-XXXXXXXXX||-----------|XXXXXXXXX-|B--XXXXXXXX
XXX--------XXXXXXXXXXXXXXXXXXXXXXXXXXXXXXXXXXXXXXXXXXXXXXXXXXXXXXXXXXXXXXXXXXXXXXXX|XXXXXXXX-|oX||XX|X|||-||XXX--||X||XXXXXoXXXXXXoXX|-||-XXXXXXXXXXXXXXXXXXXXXXXXXX||XXXXXXXXXXX|XXXXXXXXXX|X?XXXXXXXXX
