---------------------------X------------------------------------------------------------------------------------X-----------------------------------------------------------------B---------------?????-
--------------------------------????????-------------------------------------------------------------------------------------------B------------------------------------------B-o--o--------------------
------------------------------------------------------------------------------------------------------------------------------------------------------------------------------X-------X--XXXXX------B-X-
---------------------------------------------------------------------------------------------------B----------------------------------------X----------M--------------------T----T-X---BBBBBoBB-----M-B-
-------------B-----------------------------------------------------------------------------------------------------------------------X----------------o---------------------|B---|Bo-M------------------
---------------------------------------------------------------------------------------------------o--------------------------------------X---------------------------------|---X|-B------T-X-TXBX------
-------X------------------B----------------------------------------------------------------------------------X--------------B--------------------------------------------XX-|----|--?---X-|XX-|X-XX-----
-------------------------------BT---B----------------B------------M-----------------------------------------XX---------X------------------------------------------------TXXX|XBT-|-------B|XXX|X-XXX---v
--------------------------------|----------------------------------------------------X---------------------XXX--------XX--o---------------------------------------------|-XX|--|T|--TX-o-X|XXX|X-XXXX--f
--------------------------X-----|-------------------------------------------------------------------------XXXX-------XXX------------------------------X----------------X|-XX|X-|||-X|X-MTX|XXX|X-XXXXX-f
----------------------X------X--|------------------------------------------------------B-----------------XXXXX------XXXX-B----------------------------------------------|-XX|TX|||-X|X-X|X|TXX|X-XXXXXXf
-----------------XX------------B|--------------------------------XXXXXXXX-------B--------X--------------XXXXXX-----XXXXX------------------------------------------------|-XX||X|||XX|XXX|X||XX|XXXXXXXXf
--------------------------------|---X------------------------------------------------------------------XXXXXXX----XXXXXX--M-------------------------------------------X-|-XX||X|||XX|XXX|X||XX|XXXXXXXXf
--------------------------------|---------------------------------------------------------------------XXXXXXXX---XXXXXXX-------------------------------o--------B-------|-XX||X|||XX|XXX|X||XX|X-XXXXXXf
m---------------------------E---|-------E------------------------------------------------------------XXXXXXXXX--XXXXXXXX---------B--------------------------------------|XXX||X|||XX|XXX|X||XX|X-XXXXXXX
XXXXXXXXXXXXXXXXXXXXXXXXX----XXX|XXXXXXXXXXXXXXXXXXXXXXXXXXXXXXXXXXXXXXXXXXXXXXXXXXXXXXXXXXXXXXXXXXXXXXXXXXXXXXXXXXXXXXXX------XXX----XXXXXXXXXXX-XXXXXXXXXXXXXXXXXXXXXX|XXX||X|||XX|XXX|X||XX|XBXXXXXXX
