---------B------------------B--o--o----------------------------B--------o------o--------------B-----o----------------B----o-oB--o-------------------o---o-o-----X--------------o--B--B------------------
---o-o------------B--B-------o-------------------o---Mo--------o---B-------------oo-oB---oB-----o---------------------------X---------oB-------------------------o-B-o--o-------o--XX------o------------
--B---o----o-----o----------B-o---------X-----o---------o--X-------o-XX---------------B-o--o-----o-B----------XB----o----------------B-----B-BX-------B--------------B--oB---o-o---------X------oo------
---BBo----o-oB------o-------o---o--B----B--B-----oX-o-o----------------o-o----------------------------B----B----------------------B--o--------B-----ooo---B-----o---------o-o--------o----B-X---------?-
------B-----------------------o--------------X----oBo---o-o--------oX-----?--B-B--B-----------o---ooB--------------X-B----B--X-B---o-----o-------Bo-------BoX-----------B----------o-o--E-X------------E
-o---------------------o---X---E-o---X---------------X--X---B-------X------------o-oo--------o--------o------o------o---o----B---oBX------X----------------------o----------B--o--E-----------Boo-------
-o---o--o---------------oo----B-X----------B----X--B----X---------oB----B----o---B--------------B----------BB-------o---------X-X----------o----------------o---------------------o------------B----X---
-----------B-----------------X-------o-o---o------o---------o--o-----o-------o------------------------B-----o---------oo-----------X---o------------B---B-o---o-o--o-----B-o------X-----------------B--v
--B----------B---B------oo--------?---B------E--------o--o--o------o--B--o---E-B------B-----oo--B------------B-----B-------------------------o-o---------B--o---o--------------------o-----------oo-oX-f
------------X-----X-----o--o-----------o----------X---------oB-----o---B-X-----oo-B----------------------ooX---B----o-B------E--X--B--------------BB------------------XXo--------B----B--B-----Bo------f
--------------------------B-o-----o--------B-B-------B--B---------------B-X---o-B---o--o----B-------o----o--o---------B--------------o--B-------------------------E--o---o---------------------o----o--f
-------B---o--B-----B-----------------------o-----?----X----X---B------oB--------------o-------------o-------B--------------ooo------o------o-X-X-------------o-------------o---B---B-----B------------f
---E----o----o------B--ooo-o------BB-----------------oo-o----o-B--------------B-------------------XB----o-B---o---------o---o--o--------------B-----o------oo--o----o-B--X----o-o---B-X-----B-o-------Bf
--------------o--B-------o--X------------XXB-----------o-----o------XB------o--o---o----X--B-o--------B-------B------o-------B-------o---o---XB-----o--B-------------------------X---X-o-o-B-B---B---o-f
m-----o-------BBX----Bo--o----B-----o--------B-------o-----o----B-o--o-------------------------o----B--X--o-XB----------B------o--B---o--E-----o--o-----------o-o-o-------o----Bo-o--o-B--o-o-------B--o
XXXXXXXXXXXXXXXXXXXXXXXXXXXXXXXXXXXXXXXXXXXXXXXXXXXXXXXXXXXXXXXXXXXXXXXXXXXXXXXXXXXXXXXXXXXXXXXXXXXXXXXXXXXXXXXXXXXXXXXXXXXXXXXXXXXXXXXXXXXXXXXXXXXXXXXXXXXXXXXXXXXXXXXXXXXXXXXXXXXXXXXXXXXXXXXXXXXXXXXX
