---------------------------------XXXXX-----------------------------------------------------------------------------BBB---------------????????-----------------------------------------------------?????-
---------------------------------------------------------------------------------------------------------------------------------------o--????????------------------------------------------------------
---------------------------------------------------------------------------------------------------------------------------------------------------------------o----------------------------------------
------------------------------------------------------------------------------------------------------------------------------------XXXXX---------------o-----------------------------------------------
-----------------------------------XXXXX----------------------------------------------------------------------------------BBBBBBB------????????-----------------?????-----------------------------------
-----------------------------------------------------------------------------------------------------------------------X---------------------------------------------------------------------o----------
---XXX--------------------------------------------------------------------------------------------o-------------------o------------------------------------------------------------------BBB------------
-------------------------------------------------------------------------------------------------------------------------------------------------------------------------------------------------------v
------------------------------------------------------------------------------------------------------------------------------------------------------------------------------------------X------------f
---------------------------------------------------------------------------------------------------------------------------------BBB----X-----------------------------------------------X--------------f
------------------------------------------------------------------------------??????-------------o---------------------XX---------------XX------------------------------------------X--XX--------------f
-----------------------------------------------------------------------------------------------------------------T----------------------XXX------------------------------------X--T---XXX-------------?f
----------------------------------T------------------------------------------------------------------------------|----------------------XXXX????----------------------------------|--XXXX--X-----------f
-------------------------------B--|------------------------------------------------------------------------------|----------------------XXXXX-------------------------------------|-XXXXX--------------f
m--------------------BB-----------|------------------------------------------------------------------------------|--------------------E-XXXXXX------------------------------------|XXXXXX--------------X
XXXXXXXXXXXXXXXXXXXXXXXXXXXXXXXXXX|XXXXXXXXXXXXXXXXXXXXXXXXXXXXXXXXXXXXXXXXXXXXXXXXXXXXXXXXXXXXXXXXXXXXXXXXXXXXXX|XoXXXXXXXXXXXXXXXXXXXXXXXXXXXXXXXXXXXXXXXXXXXX--XXXXXX------XXXX|XXXXXXXXXXXXXXXXXXXXX
