---oB----o------------o---o-------------?-----B-------X----------------------------------------------------B--------o---o---B--o---------------B-XX--o------------------------X----o-------o--o---------
--------o--------------------o-----------X--o----o----EB-----------------B-o----BXo----------X--oX--------------o-----------B-X------------------------oB---B------------B------------o-o----------B-o--
------oB----B-o---o---o------o--X-----o--------o-------o----E---------------o--o------o--------B----Bo-----X----B--X-------o---o----o-------------------oXo-------------------Eo-----o-----o-B--B-B-----
-----------o--------------oX------X---------------o-B----------X---o------o--Bo--------o-----Xo-------o-----o----B---o--------------B------o------o----------------B----Bo--B-B--ooBo-------------B-----
-------------B-o------X-------o-B-B-------B---------------------------B--B-----E-o-----------E---B----o-------B------------Xo---B---------B-E-oB---------B-------o------------------------------o-------
------------o----------B---------Bo---B-o------o-----B-----------Bo--B-o-----B-------B-----oo-oX----------E-B--------B----------o-------o--B------------------o-B---o---------B?o---X------------o----o-
----------------BX-o-----BB--B-----X-------o-----------o-X-E------------------X-B---o-------B-------------o-----------X-----o-----B---B--------B-------------o----B-----o-----------------o-------oo-o--
-----o---------X---------o-X----------o---------o----------o----------------------------X---XEo------XoB-------Bo------o-X------o---------o------------------B--o---o----------------o-------------ooo-v
---X-----X-----X--------B------X---------B-------o----o--Bo---B----B-X--o----B--------------B---------X------B------------------X--------------o-----o---o-B-B-------o------o---------------B----------f
-----------B-------------o--B-------------B----------oo-----o---X--X--------o---------o--oo-B--------o-----o-----o-B--X----o-X--------o----------B---------BX------o----X-----o-X-------------o------B-f
-Xo----------------------o-------X----o-------------B------oo-B-------------------------------------B--------Bo-------------------------o-------oB-oo-------------B---o-------------------------B------f
------------B--Bo--oo------oB-------E-oo-----------------o-----------oB--Bo---------B----------------------------X--------B---X-----X--o--------o-------o----o---------Bo--------B-----o-Bo-B----------f
--o-o----------------o-----Bo---o------o-o-----B----B--Bo-------o----X-----B----------B--------------o---E---o--------o-X---oo---oX------X-o----------B-B-----oX----o-X----------B-o-----------o-oX----f
------B-B---------B---B-o---X---------o--o---oB---------o-o-------------o------o-------------X---X--o---B-o---XB-------o------------oXoX---X----o--------o-----o----o----o-----------X-B-o-------o---X-f
m---o-----E-o--E-----E---E-X-o----o--BB----o--E--B----------X-----o----B-E--------EoXo----oXX--X----o-oo-B---------B-E----E-B---oXX-BBXX-B-oB-B--o---oo-----------------o-----B------B----o--o-------XE-
XXXXXXXXXXXXXXXXXXXXXXXXXXXXXXXXXXXXXXXXXXXXXXXXXXXXXXXXXXXXXXXXXXXXXXXXXXXXXXXXXXXXXXXXXXXXXXXXXXXXXXXXXXXXXXXXXXXXXXXXXXXXXXXXXXXXXXXXXXXXXXXXXXXXXXXXXXXXXXXXXXXXXXXXXXXXXXXXXXXXXXXXXXXXXXXXXXXXXXXX
