--------------------------------------------------------------------------------------------------------------------------------------------------------------------------------------------------------
----------------------------------------------------------------------------------------------B---------------------------------------------------------------------------------------------------------
---------------------------------------------------------------------------------------------o------------------------------------------o------------------------o--------------------------------------
-----------------------------------------------------------------------------------------???---------------------------------------------------BB-------------------------------------------------------
-----------------------------------XXXXX------------------------------------------------XXXXXXX-----M------------------------------------------------------------?????----------------------------------
--------------------------------------------------------------------------------------------------------------------------------------------------------------------------------------------------------
--------------------------------------------------------------------------------------------------------------------------------------------------------------------------------------------------------
----------------------------------------------------------------------------------------------o-----????????B??----------------------------------------------X-----------------------------------------v
------------------------------------------------------------------------------------o-------????------------------------------------------o------------------------------------------------------------f
-------------------------------------------------------------------------------------------------------------------------------------------------------------------------------------------------------f
---------------------------------------------------------------------------------------------------------------o----------------------------------o----------------BBBBB--------------X----------------f
-------------------------------------------------------------------------------------------------------------------------------------------------o------------------------------------XX---------------f
----------------------------------------------------------------------------------------------------------------X---------------------------------------------------------------------XXX------T-------f
-------------------------------B---------------------------------------------------------B------------B--------XX----XXXXXX------BBBBBBB---BBBBBBBB-----------T-------------------XXXXXXXX----T|-------f
m----------------------------------------------------------------------------E--------------------------------XXX-------------------o----------E------E-------|-X--------??-----------XXXXX---||-------X
XXXXXXXXXXXXXXXXXXXXXXXXXXXXXXXXXXXXXXXXXXXXXXXXXXXXXXXXXXXXXXXXXXXXXXXXXXXXXXXXXXXXXXXXXXXXXXXXXXXXXXXXXX---XXXXXXXXXXXXXXXXXXXXXXXXXXXXXXXXXXXXXXXXXXXXXXXXX|XXXXXXXXXXXXXXXXXXXXXXXXXXXXXXX||XXXXXXXX
