---------------------B---------------------------B---------X------------o---B-----------B-----------------------o--------X----------------------o------B-o----X--B------o-----------oo-o---o------------
B-------------o-----B-----BB------B----------o-X--------------------o---------o---X----oB---------B---------o-X---------oB----X----o----------o-----------X-----o----------B-----------------o----------
B-----------BBX-----o---B---X--BB---------------B-o---------o----------------o--oo-----o----B----B--o-----B------------ooB-----X-B---B--B---X---o-----------B-----------o-----XB-Bo----Xo---------B--B--
B------o-XB--------o----B---o---------oo----------X--B-B----------o------B-----------o------X------o--o--o-o---------o-----o-------o----o---o--------o-----o-----------B-B----B--------oo----ooo----o---
---o----o-------X-------o---------oBB----------o-Bo----------------------B---------------B------o-------X----oB--------------------o--------o-----X-------oX---B-X------------o-------B---X-------------
---X--------------o-----B---X---------E------------o-o--B-B------------------B-------o---------X--------o--------B-oBX----Xo---B-----o------------B--o---------------B-------------oX---B-Bo----o-------
--B-----------B----------------o-----B-----o-----o--oX--EX------o-------------B-----B---o------o---o---------o--o---B----B----------oXB--B------o--------o--------o---B-------o-?------------B----------
------o-----oo-----o-----------------------------B---B---o----o-------o-----------o--oo-B---------------Xo-B-oM---B----B----------------o-----------o------------o--E--o-------------------X----B-----ov
--------------o---------o--------------------------------B--o--o---------B--o------------o---------B-----oB---------oo------o----E--------BB--B---o--------B-B----------------o----X-o---B----o-----o--f
-----o-o----B--------o---------o------o-oo------B--B-oo-------------------------X------B--------------B---------------------------XX----E--------B-o--------B-----X-----X------------------o-B------B-Xf
X------------------------------------X---oo---------oBB------oo--------------------oB---------o---B----------B---B------B--X------------B----B---------------B--o-------B---o--o--o---o---o-o----Bo----f
Bo--o------E-----o-oBE-o---------------X-----B-----X------o-o-B------B-------oXB------o----------B--------------------B--------ooBo-o-------X-B------------o--o-------------o-----o-------B--B---------f
-o---------X-----o-------BE--X-o--o--------o--o---X-----oB---o-----------o------------------B--------------o---o-----o----------oooo------o-------------E----B--Bo--o-----B-----BB----M---o--------B--Bf
o--Xoo----X-----o--o--------B---oo----o--------------B---------o-B-------oB-oX--B--o---------X-----oo--B-o-o--------B--------B-o-----B---oo-o--EX---X----o---o--Xo---X---------X--B--------oB--------B-f
m-----oo---------o----E--B-oo----B--BE-BB------------------------B---o-----BE--o---B----o-----Boo--B-----E--o-------o--------BB-B-----X---EE-X-Eo----o--o-------B-o-EE----------X-------E-----o----B--o-
XXXXXXXXXXXXXXXXXXXXXXXXXXXXXXXXXXXXXXXXXXXXXXXXXXXXXXXXXXXXXXXXXXXXXXXXXXXXXXXXXXXXXXXXXXXXXXXXXXXXXXXXXXXXXXXXXXXXXXXXXXXXXXXXXXXXXXXXXXXXXXXXXXXXXXXXXXXXXXXXXXXXXXXXXXXXXXXXXXXXXXXXXXXXXXXXXXXXXXXX
