----------------------------BBB--------------------------------------------------------X---------------------X--------------------------------------------------------------X?--X-B--B-----B-----B?-----
-------------------------------------------------------------------------------------------------------o----------------------------------------------------------------------?--oBo-X-B--X-----X-----?-
-----------------------------------------------------------------------------------------------------------------------------------------------------------------------------o-B-X?X?B?BBBB------?------
------------------------------------------------------------------------------------------------------X----------T------------------------------------------------------------M-XB?o?-X--X-X---X--BB--B-
-------------------?-----------------------------------------------------------------------------X-XB------------|----------------------------------------------------------?B?B--B-?-o--XBBMBBB--X---X-
-------------------o----------------------------------------------------------M----T--------------XX-----------X-|------------------------------------------------------------X-------X-X-XX-o----oX-TX-
-----------------------------------------------------------------------------------|-------------XXX-------------|----X-------------------------------------------------o-XXX-BX--X-X-XXB-XXBXXTXXXX-|X-
-----------------------------------------------------------------------------------|----------B-XXXX-------------|----------------------------------------------------------XX-BT-o---XXXXXXX-X|-XXXX|Xv
---T-------------------------------------------B------------------------------M---?|????-------XXXXX-------------|----------------------------------------------------------XXX-|-----XXXXXXXX-|XXXXX|Xf
---|-------------------------------------------------------------------------------|----X-----XXXXXX--BBBBB---B--|-----------------------------------------------------B-X-XXXXX|--X-BXXXXXTXXX|XXXXX|Xf
---|-------------------------------------------------------------------------------|X--------XXXXXXX-------------|----------------------------------------------------X----XXXXX|-B---XXXXX|XXX|XXXXX|Xf
---|------------------------------------------------B------------------------------|--------XXXXXXXX-------------|---------------------------------------------------------XXXXX|X-XXXXXXXX|XXX|XXXXX|Xf
---|------------T-----------------------------------------------------T------------|-------XXXXXXXXX-----?-------|----------------------------------------------------o---BXXXXT|XX-XXXXXXX|XXX|XXXXX|Xf
---|------------|-----------------------------------------------------|------------|------XXXXXXXXXX-------------|------------------------------------------------------B--XXXX||XXTXXXXXXX|XXX|XXTXX|Xf
m--|------------|-----------------------------------------------------|------X-----|B----XXXXXXXXXXX-------------|-------------------------------------------------------o-XXXX||XX|XXXXXXX|XXX|XX|XX|XX
XXX|XXXXXXXXXXXX|XXXXXXXXXXXXXXXXXXXXXXXXXXXXXXXXXXXXXXXXXXXXX--------|XXXXXXXXXXXX|B---XXXXXXXXXXXXXXBXXXXXXXXXX|XXXXXXXXXXXXXXXXXXXXXXXXXXXXXXXXXXXXXXXXXXXXXXXXXXXXXXBXXXXXX||XX|XXXXXXX|XXX|XX|XX|XX
