----------------------------------------------X---------------------------------------------------------------------------------------------------------------------------------------------------------
---------o-------X---B----------o----B-------------o-----B-X----o-----o-------------B---------------------------------------------------------B----------B-o--Bo------------------?----o-o--------------
-----X----------------o---B-----------o-----?o-----B----B---E---------B-B--------------o------------oo--oo-----X-----------------------X---B----------------o-B-o-B--------B--o-----------------------o-
------o--o--------------------?--o-------o-----------B------o-------------oo--B----o------B-----?--------X---B--EoBB--E----------o--o----B------Bo-----X----------E------------B----o-------------------
-----------oo--o---o--------o-----------------Bo------------------o---------X---------------------------------X-------------------B-----------------E--------o---------------B--------------B-----------
-X----------------X-----------------B-----o---o----------------X-------o----------------B-------------------B--oX---------------EB------------------------------------o-------B------------B----------B-
--BX------B--B--------------------------o-------o-o--E---o---------------o------B-------------------------o-----B------B---------------------B---o--------------B---------------------B----------o------
-----------------o----o------B---------o-o-----------o--------------E-B----o----------------------B-----X------o-------o-----oo---o----------------o----------o--B----------------B----------B---o-----v
-B---------B------o----------------------------B--------------oB----B?------------B-------------------o-------B-------o---------------------B--------X------B----X---------------o---------------------f
--o---o--------------X---o-------o--------------------------B-------------------X--------------------------------------------B-----------o-----------o----------o---o-----------B--------B-------------f
--------------------------------------o---------o----------------oo--------oo--o-----------o-------------------------------o---------------------------o--------o------------Bo--B---------o---oB------f
-----o------X---------o------oBo----o---------------------E------------o-------o--------o------X-------o-------------B-o--o-----X--------------Bo--B----------------o----o---B----B------o--------B----f
-----------XXBo----------X----o--Bo-B------B-----------------------ooX-o-------------------------------------------------o-----------X-----------B-----o------------o---XB----------------B-o--o------Xf
-------o------------o---B-------B----B--B--o--o----------B---?o------------------------------E-----oB-----------o----X---------------o--B-Bo-------B---o-------B---o--o--B--B--?---------X----B-o----B-f
mo------o-----------Xo-------------------B--------o----B----------o------BX------------------o-B-----o-o--------oo----E--X---X---------------o---o-------------------o---B----B---o----o-------B--o----X
XXXXXXXXXXXXXXXXXXXXXXXXXXXXXXXXXXXXXXXXXXXXXXXXXXXXXXXXXXXXXXXXXXXXXXXXXXXXXXXXXXXXXXXXXXXXXXXXXXXXXXXXXXXXXXXXXXXXXXXXXXXXXXXXXXXXXXXXXXXXXXXXXXXXXXXXXXXXXXXXXXXXXXXXXXXXXXXXXXXXXXXXXXXXXXXXXXXXXXXX
