-------X-----o----X--oo----B-------------o--B--------X----o----B--o------X----o----o-----B--?-----Bo---B-----------o--o---oo----------X--------o-o---------B--B---X-Bo-----------------o---Bo-o----B----
-X----------X----------oo-----XX------B--------------o-----B------------------------B------X---------o------o------o--------X--oB--------o-----X----X------oB------o------B--o--------X-o-X-----------B-
-B-o--o-o---------XX------o----------------o--B--B--B-----------oB-----------B-------------o-o--BB-----T------o----BB-X---X----o--XX----E-B-X--------------B-o----oo-BX--------X----------B-------------
X-------o----B-oo-------o-o-------X---Bo--o-----------B---B-B-B----Xo---------------X--o----o-o--------|----------------------B---------X----B-B---Xo---Bo-----------o--oo---B--B-----------Xo---o---B--
-B----------------oo--BB---------oB---o----B---------------o--o-----------o----------oB----------X--X--|-------E----o--------oo-----------o-----X------BX-B------B--o------o-----o---o--B-o------------X
oB------B-?------------B---o---B----B--Xo------B-B----o---o--o--------o----o-B---------o-X-------------|-------X---X--E-B--------------------o--X-----------o-o-----o--o----oo-----------------ooX---X--
--------o--o-oo-----B---oo---------BX----------------B-------o-X--o--o-X--X--------o-B---X--------Bo--X|---o----------B--------o-----Bo--B--oX-o-o----oX-B-----o---------X--o------o------X-o--------?--
o-BBBB-o--X-o---------B-BB----o-B--------------B----o----------------B--B-----------oo----XoE------XXo-|-------B-----X-------B--o----o-BX----B----B-o-Bo----------o---o-----B-Bo--BB---B--B-------B-o--v
--o--X---o------------------o------B-----X--oBX----------o-o-------o------oo------------T---Xoo-----o-B|-X--------B--o------B-B----oB--------o-----------o--o---------EoB?--B-o------o------X----B-----f
-----B-o-X--oX----------------------o------B---------o--BB------X-X---o------B---X-B---E|-------oo-o--X|-------ooX-XB-----o-B-----X--X----o------------o-X------Bo----X-o-----o-B-o-----B-o-X---o------f
----------o-o----------o--X-----oB--o--------o-oo----------o-------------B--o-B--Xo-B--B|-----o-------B|---BXoo-----------Bo--X--B----o-------ET----BB-------X---EB-------------o-X-T-------------B----f
-------B-----o----o----------------XB------o--o---------o-o-oB-o------X----------o-----E|----B-o--o---X|--oX--o-----o------B-B-------o---B----B|--o-----------oo-XB-o--B-o--X--o---o|-----------o--o-o-f
-oo------X---B--?-o-Xo-----X-o---------B?-o-oB---X--o------B------BB-oB-?-Bo-o--X------X|-X-B----------|------------o----------T-----B---------|-B------B-------o--Bo----o-----o-o--|------oo-X-o--o---f
-X-----X------o-------o---T---o-------------o-------------o----B-----X-o----------------|-o---Bo--o----|-----o-Xo----?X--------|--B------X--X--|--o--o---------o-------B---Bo--oB---|-X----X-----------f
m--BBB---------X----E-----|-------------B-X---o----------X------oE------E-B-o--o-----XoE|------E-----X-|--------------o----B--B|---B---T-EB-E--|-B-EXT------EB----o------o--Xo-----B|-------X--BBB-B---X
XXXXXXXXXXXXXXXXXXXXXXXXXXXXXXXXXXXXXXXXXXXXXXXXXXXXXXXXXXXXXXXXXXXXXXXXXXXXXXXXXXXXXXXXXXXXXXXXXXXXXXXXXXXXXXXXXXXXXXXXXXXXXXXXXXXXXXXXXXXXXXXXXXXXXXXXXXXXXXXXXXXXXXXXXXXXXXXXXXXXXXXXXXXXXXXXXXXXXXXX
