-B------------------------------------------------------------------------------------------------------------------------------------------------------------------------------------------------------
-----XX-----------------------------------------------------------------------------------------------------------------------------------------------------------------------------------X-------------
--------------------------------------------------------------------------------------------------------------------------------------------------------------------------------------------------------
--------------------------------------------------------------------------------------------------------------------------------------------------------------------------------------------------------
----o-----X---------------------------------------------------------------------------------------------------------------------------------------------------------------------------------------------
-----M--------------------------------------------------------------------------------------------------------------------------------------------------------------------------------------------------
-------------------------------------------------------------------------------------------------------------------------------------------------------------------------------------------------??????-
-------------------------------------------------------------------------------------------------------------------------------------------------------------------------------------------------------v
-------------------------------------------------------------------------------------------------------------------------------------------------------------------------------------------------------f
-------------------------------------------------------------------------------------------------------------------------------------------------------------------------------------------------------f
--------B----------------------------------------------------------------------------------------------------------------------------------------------------------------------------------------------f
--------------------------------------------------------------------------------------------------------------------------------------------------------------------------------------------B----------f
-------------------------------------------------------------------------------------------------------------------------------------------------------------------------------------------------------f
---X---------------------------------------------------------------------------------------------------------------------------------------------------------------------------------------------------f
m-----------------------------------------------------------------------------------------------------------------------------------------------------------------------------------------------------MX
XXXXXXXXXXXXXXXXXXXXXXXXXXXXXXXXXXXXXXXXXXXXXXXXXXXXXXXXXXXXXXXXXXXXXXXXXXXXXXXXXXXXXXXXXXXXXXXXXXXXXXXXXXXXXXXXXXXXXXXXXXXXXXXXXXXXXXXXXXXXXXXXXXXXXXXXXXXXXXXXXXXXXXXXXXXXXXXXXXXXXXXXXXXXXXXXXXXXX??X
