---------------------------------------------X----------------------------------------------------------------------------------------------------------------------------------------------------------
-----------------------------------------------------------------------------------------------------------------?---------------------------------------------??????-----------------------------------
--------------------------------------------------------------------------------------------------------------------------------------------------------------------------------------------------------
----------------------------------------------------------------------o---------------------------------------------------------------------------------------------------------------------------------
----------------------------M-----------------------------------------------------------------------------------------------------------------------------------------------------------------X---------
--------------------------------------------------------------------------------------------------------------------------------------------------------------------------------------------------------
--------------------------------------------------B-----------------------------------------------------------------------------------------------------------------------------------------------------
-----------------------------------------------------------?-------------------------------------------------------------------------------------------------------------------------------------------v
-------------------------------------------------------------------------B-----------------------------------------------------------------------?-----------------------------------------------------f
--------------------------------------------------------------?????------------------------------------------------------------------------------------------------------------------------------------f
-----------------------------------------------------------------M-------------------------------------------------------------------------------------------------------------------------------------f
-------------------------------------------------------------------------------------------------------------------------------------------------------------------------------------------------------f
-----------------------------------------------B---------------------------------------------------------------------------------------o--------o------------BBBBBBB-----------------------------------f
-------------------------------------------------------------------------------------------------------------------------------------------------------------------------------------------------------f
m-----E-------------------------------E--------------------------------------------------------------------E-----E---------------------------------------------------------------E---------------------X
XXXXXXXXXXXXXXXXXXXXXXXXXXXXX----XXXXXXXXXXXXXXXXXXXXXXXXXXXXXXXXXXXXXXXXXXXXXXXXXXXXXX---XXXXXXXXXXXXXXXXXXXXXXXXXXXXXXXX--XXXXXXXXX-XXXXXXXXXXXXXXXXXXXXXXXXXXXXXXXXXXXXXXXXXX-------XXXXXXXXXXXXXXXXX
