-----------------X-o---B--------------------oo--------oX----o--------B-------B--X-----B---oo---o-----o--o-----B---------------------X----B--B-oo--X-o-B--------------o--------------o-X---B--oo---------
-----o-oo-o----o----o--X-----o--XX------------------BX-------o------BX----o-----o--B-------o------o-o-oXB-----o-o----o-o-----o-----B------------B---oB--B------B-----o--------o----------------o--B-----
-----B---o-------o---B-o-------o-------o---T-XBo------o----B-o--------o-Bo-----Bo---------X-o----o--------B-o------------E-----o---E-BX-o---------------o----------o-B---X----o--B---------o----o-----X-
------Xo-----X-------------------oo-B------|---------Eo----B--?-oo---------o-------------B-----------o--X--X-B----B-o-------------------oo------E---B-X-X-----X--------o----o-B--B-------o-X--o--o---B--
------------------o--E--X-------o--o-------|--------------o--------oB---------------------Bo--o-----oE-o--o-o-B-------X---------------o----------BB--o----------------o------B----B---B------------?----
-oo-X-o-Boo----------B----B-ooo-----------o|--B-o---------------------B-------o-----------B---o--------o--XX----o-B-o------------------X-o--o----X-------o---oT---E------------B-----o-B-o?-------o--BM-
--------B-oo-------BB-X-----------BX-X----B|--------o-------o------------------------o--------o---X-------X-o--o-Boo-B---X--------X--o--oE---------o---B-oo---|----------o-----B------o----X-----o------
----o--------B------o----------------B----X|-----o----BX-----B--B--o--X---oo------o------B-----o---?B--X-------X-----B-----B---o--------B-B---oXo--B--o-o-----|----X---B-----B--B-X----o--------oBo----v
-------B---oBo---?X--X-o-------o---o----B-B|--B----B-oo------X-------B-------oB-------X------B----o---------------------X------o--o--o----------o-------------|--oB--------------o-------X-----oo------f
B--B----------o----o---o-----X----------BB-|--o------X--B-------B----o----o-----o----o----oo--B--------oo-----------o------B---o---X---B---BB-o-o--B-o----B--B|---B---Xo------o----o--------Xo------o--f
-----oB------X--X-----B-oB-T-----B-XB-----B|---o-B------B------oo--------o---B-B--oooo----------------oB-B-------o---B---o-X-B---oo-----o--------------oo-----|-X--------o------o-----o---o-------B----f
-----------XX------oX------|---T-o-oB----B-|--B--------oB--o---EB-B----o---o----B--X-----Xoo--o---------B---B--------B-X---------B----o-o-----X-Boo--o------o-|--------B---------B---------o-Bo--------f
-------o-----B-----B--oB---|-o-|--oo?o-----|-X--------B----o-B-B---------B-oB----o-oB-o-------------o-------o-B--X-----------o--------B--o------B-o--B-B------|-o-Bo-o---BX----B-----X--X----o--------Xf
-X----------o--------------|---|----o---B-B|--X----B----------o---ooX-------B-o-o-----o-XXo-----o-----B----B-------o----------B-oo----o---------------------o-|--Xoo--B---------B-B--B-oB----B-Bo-----of
m------B--B---B--X------BX-|---|--X-o------|-B---X-o--Eo--oBo----------X---------B-o-BX---B-XoX-B-----------oXB--BB-------------o---------BXo---o----o---B----|--oB---B------B-X---------B---B-o--oX----
XXXXXXXXXXXXXXXXXXXXXXXXXXXXXXXXXXXXXXXXXXXXXXXXXXXXXXXXXXXXXXXXXXXXXXXXXXXXXXXXXXXXXXXXXXXXXXXXXXXXXXXXXXXXXXXXXXXXXXXXXXXXXXXXXXXXXXXXXXXXXXXXXXXXXXXXXXXXXXXXXXXXXXXXXXXXXXXXXXXXXXXXXXXXXXXXXXXXXXXX
