----------------------------X--------------------------B-------------------------------------------B----------------B--------X--------------------------------------------------------------------------
------------------------------------------X-----------------------------------------------------------------------X---------------o------------------------------------------------------------------o--
-------------------------------------------------------------------------------------------------------------------------------------o------------------------------------------------------------------
-----------------------------------------------------------------------------------------------------------------------------?--------------------------------------------------------------------------
--------------------------------------------------------------------------------------------------------------------------------------------------------------------------------------------------------
--X---------------------X-------------------------------------------------------------------------------------------------------------------------------------------------------------------------------
-----------------------------------------------------------------------------------------------------------X--------------B-----------------------------------------------------------------------------
-X-----------------------------------------------------------------------------------------------------------------------------------------------------------------------------------------------------v
-------------------------------------------------------------------------------------------------------------------------X-----------------------------------------------------------------------------f
------------------------------------------------------------------------------------------------------------------------X---BXX------------------------------------------------------------------------f
-----------------------------------------------------------------------------------------------------------------------XX----XX------------------------------------------------------------------------f
-----X-----------------------------------------------------------------------------------------------------------XX---XXX----XXX----------------------------------------------------------o-X----------f
---------------------------------------------------------------------------------------------------------------------XXXX----XXXX-----------------------------------------------------------XX---------f
-----------------------------------------------------------------------------------------------------------------X--XXXXX----XXXXX----------------------------------------------------------XXX--------f
m-------------------------------------------------B----------------------------------------------------------------XXXXXX----XXXXXX---E-----------------------------------------------------XXXX-------X
XXXXXXXXXXXXXXXXXXXXXXXXXXXXXXXXXXXXXXXXXXXXXXXXXXXXXXXXXXXXXXXXXXXXXXXXXXXXXXXXXXXXXXXXXXXXXXXXXXXXXXXXXXXXXXXXXXXXXXXXXXXXXXXXXXXXXXXXXXXXXXXXXXXXXXXXXXXXXXXXXXXXXXXX-----XXXXXXXXXXXXXXXXXXXXXXXXXXX
