-----------------------------?--------------------------------o--------o-----------M---------M-----o---------------X----------------------------------------------------------------M-------B-----------
-----------------------------------------------------------------------BBMB----------o???------------?--------------------------------------------------------------------------------------------------
-------------------------------------------------------------------??------------????M?--------------------BBBBB--------------------------------------------------------------?????o--------------------
-------T------------------------------------?--------------X----------M?BTBBBBB-------B----B---o------------?-----------------------------------------------------------------------------B-------------
-------|--------T--------------------?-----------------------o--------o--|---------??o???--------XoT----------------------------------------------------------------------------o---------TXXXXX---X----
-------|--------|------------------------------------------------X--o---X|-o------o-M----X----M-XX-|-X---------T-----------------------------------------------------------o-----T--o-----|--------X--X-
-------|--------|-----------------------------------------T--------X----X|M----TX-BX-----------XXX-|BXX---o---X|-----------------------------------------------------------------|--------|-----------X-
-------|--------|---------------------------------------T-|---BBBBB-----X|X----|XXTX--X-oB----XTXXX|XXXX-BBoBB-|--------------------------------------------T------------M----X--|XXXXXX--|-o---------Xv
-------|--------|---------------------------------------|-|-----------?XX|XX---|XX|X--XX-----XX|XXX|TXXXX------|---X----------------------------------------|-------------?------|----XX--|--------M--Xf
----T--|XXXX----|-------------------------M-------------|-|-----------XXX|XXX--|XX|XX-XXX---XXX|XXX||XXXXT-XXXX|X-------------------------------------------|----------X---------|----XXX-|-------o---Xf
----|?-|--------|----------------------X----------------|-|-----BBBBBXXXX|XXXXX|TX|XXTXXXXXXXXX|TXX||XXXX|XXXXX|--------------------------------------------|----------XX--------|--?-XTXX|--------B--Xf
----|--|--------|--------------------------o------------|-|--o--X---XXXXX|XXXXX||X|TX|XXXXXXXXX||TX||XXXT|XX---|--------------------------------------------|----------XXX------T|----X|XX|---X-------Xf
----|--|--------|---------------------------------------|-|--TMXX--XXXXXX|XXXXX||X||X|XXXXXXXTX|||X||XTX||XXXX-|---X-X--------------------------------------|----------XXXX-----||----X|XX|X-XX-------Xf
----|--|--------|---------------------------------------|X|XX|XXX-XXXXXXX|XXXXX||X||X|XXXXXXX|X|||X||X|X||XXXXX|---XXXX-------------------------------------|----BBBBBXXXXXX----||----X|XX|XXXX------XXf
m---|--|--E-----|---------?--E---------------------X----|-|--|XXXXXXXXXXX|XXXXX||X||X|XXXXXXX|X|||X||X|X||XXXXX|X--XXXXX????E?------------------------------|---------XXXXXXX---||X-EXX|XX|XXXX---E-XXXX
XXXX|XX|XXXXXXXX|XXXXXXXXXXXXXXXXXXXXXXXXXXXXXXXXXXXXXXX|X|XX|XXXXXXXXXXX|XXXXX||X||X|XXXXXXX|X|||X||X|X||XXXXX|---XXXXXXXXXXXXXXXXXXXXXXXXXXXXXXXXXXXXXXXXX|XXXXXXXXXXXXXXXXXXX||X-XXX|XX|XXXX----XXXXX
