-----------------------------B-B----------------------------------------------------------------------B--?---???-----------B---------------B-----B-------------------------------------------------X----
-----------------------------------------------X----------B---B---o-----------------------------------------------------------Bo-----------------B-------------BX--o------------------------------------
--------------X----------------------B-------------B------------------X------------------------------------------X--B------------------B--------o-----B---------BBoB----X-----M-X---------------BBBBBBB-
-------------------------------------B-------------B-X-----------M-------------X-----o------------------B--X----XT-BXB----BBo-------B------M-------????----o----------BM--o---------X--------T----------
-------------------------------?--------o---------BT?-----B-------X--------------------------B--B-------X------B-|------------------------Bo---X-----------T-------T-X---M--------BBBB----X--|----------
--M----------------------------------X-------------|T------------XX-X--T----------------------X---------XB-------|-------B--T---X--o--------------TBXX----?|-------|XX----T-o--------X-------|----------
------------------------------------------B---X----||X----------XXX-T-B|-----------------------------------X-B---|--B-o--BBB|--B-X--X----X--T----X|--------|X------|XX----|------------------|-X--------
----------------------------------------------XM-X-||----------XXXX-|--|X------B-----------X-------------------X-|-----B----|------XXXT--XX-|---XX|-------X|------X|XX----|----------?-------|-XX-----Xv
------------------------B----------------X---------||----TB---XTXXXX|--|-------------------------X-------o-----BB|BBBB-BBXX-|--?---XXX|--XXX|T-XXX|-----B-B|-X---XX|XX--B-|X---o-------------|-XXX-----f
------------------------------B------------------B-||-T--|---XX|XXXX|--|X-----X------------X---------------------|--XXXXXXXX|B------XX|X-XXX||XXXX|--------|o---XXX|XX----|BBBBB-B---X-------|-XXXX--XXf
------------------------------X--------------------||-|--|--XXX|XXXX|XX|XXXX-----------------------------BM------|----X-----|-------XX|XXXXX||XXXX|--------|---XXXX|XXX---|----------XX---X--|-XXXXXXXXf
--XXXXXXXX-----------------------------------------||-|X-|-XXXX|XXXX|-X|------------------------------X------B---|--------X-|------BXX|XXXXX||XXXX|-----BBB|--XXXXX|XXXXB-|----------XXX-XX--|-XXXXXXXXf
---XX-------------------------------------X-XXXXXXX||-|--|XXXXX|XXXX|--|--------B-------------------------------X|-X--XXXXXX|--X---BXX|XXXXX||XTXX|--BBBBBB|-XXXXXX|XXXXX-|----------XXXXXX--|-XXXXTXXXf
---XXX----------------------X-----------BXXXBB---X-||-|--|XXXXX|XXXX|--|----------------X----X-----X-----X-------|---------B|-------XX|XXXXX||X|XX|B--X----|XXXXXXX|XXXXXX|----------XXXXXXBB|-XXXX|XXXf
m--XXXX------------------B--------------XXXB---B---||-|-X|XXXXX|XXXX|--|---------------EXX----------B--------E---|---------E|---EEE-XX|XXXXX||X|XX|--------|XXXXXXX|XXXXXX|BBB-E---EMXXXXXX-E|XXXXX|XXXX
XX-XXXXX-XXXXXXXXXXXXXXXXXX-------XXXX?XXXXXXXXXXXX||X|XX|XXXXX|XXXX|XX|X----BXXXXXXXXXXXXXXXXXXX-----XXX--------|--BX-oXXXB|XXXXXXXXX|XXXXX||X|XX|X---B--X|XXXXXXX|XXXXXX|XXXXXXXXXXXXXXXXXX|XXXXX|XXXX
