-------------------------------------------------------------------------------X------------------------------------------------------------------------------------------------------------------------
----o---------------------------------------------------------------BBBBB----------------????????-------------------------------------------------------------------------------------------------------
----------------------------------------------------------------------------------------------------------------------------????------------------------------------------------------------------------
--------------------------------------------------------------------------------------------------------------------------------------------------------------------------------------------------------
------BB-------------------------------------------------------------------------------------------------???????-----------------------BBBBB------------------------------------------------------------
-----------------------------------------------------------------------------------------------------B----------------BBBBB-----------------------------------------------------------------------------
------------------------------------------------------------------------------------------BBBBBBB-------------------------------------------------------------------------------------------------------
-----?---------------------------------------------------------------------------------------B---------------------------------------------------------------------------------------------------------v
--------------------------------------------------------------------------------------------------------------????--XXXX-------------------------------------------------------------------------------f
----------------------------------------------------------------------------------------------------------X--------------------------------------------------------------------------------------------f
-----------------------------------------------------------------------------------------------------X----B----???------------------------------------------------------------------------------------?f
----------------------------------------------------------------------------------------------------------o-----T--------------------------------------------------------------------------------------f
----------------------------------------------------------------------------------------------------------------|--------------------------------------------------------------------------------------f
-----------------------------------------------------------------------------------------------?????------------|--------------------------------------------------------------------------------------f
mE-----------------------------------------------------------------------------------------E-E------------------|---------XXX--E-----------------------------------------------------------------------X
XXXXXXXXXXXXXXXXXXXXXXXXXXXXXXXXXXXXXXXXXXXXXXXXXXXXXXXXXXXXXXXXXXXXXXXXXXXXXXXXXXXXXXXXXBXXXXX----XXXXXXXXXXX--|XXXXXXXXXXXXX------XXXXXXXXXXXXXXXXXXXXXXXXXXXXXXXXXXXXXXXXXXXXXXXXXXXXXXXXXXXXXXXXXXXX
