-------X---------------------------------------------------------------------------XXXX-----?---------------------------------------------------------------------------------------------------------X-
--------------------------------------------------------------------------------------------------------------------------------------------------------------------------------------------------------
--------------------------------------------------------------------------B-----------XXXXXXX--------B---------------------------------------------------------------------------------------X---B------
--------------------------------------------------------------------------------------------------------------------------------------------------------------------------------------------------------
----------T------------------------------------------------------------------------------??--T----------------------------------------------------------------------------------------------------------
----------|----------------------------------------------------------------------------------|--------------------------------------------------------------------------------------------------------B-
----------|-------------------------------------------------------------o--------------------|----------------M-----------------------------------------------------------------------------------------
---X------|--------------------------------------------------------T-------------------------|------------------------------------------------------------------------------------BBBBB-X---T----------v
---XX-----|-------------------------------------o------------------|-T--X--------------------|-----------------------X------------------------------------------------------------------XX--|----------f
---XXX----|--------------------------------------------------------|-|--XX-------------------|-------???????--------XX------------------------------------------------------------------XXX-|----------f
---XXXX---|--------------------------------------------------------|-|--XXX--------------o---|---------------------XXX------------------------------------------------------------------XXXX|----------f
---XXXXX--|--------------------------------------------------------|-|--XXXX-----------------|--------------------XXXX----------------------------------------------------------------T-XXXX|----------f
---XXXXXX-|--------------------------------------------------------|-|--XXXXX-----------?o---|-------------------XXXXX----------------------------------------------------------------|-XXXX|X----T---Xf
---XXXXXXX|------------------------------X-------------------------|-|--XXXXXX----XXXXXXXX---|------------------XXXXXX----------------------------------------------------------------|-XXXX|XX---|--TXf
m--XXXXXXX|-----------------------------XX-------------------------|-|--XXXXXXX--------------|------o------EXXXXXXXXXX----------------------------------------------------------------|-XXXX|XXX--|--|XX
XXXXXXXXXX|XXXXXXXXXXXXXXXXXXXXXXXXXXXXXXXXXXXXXXXXXXXXXXXXXXXXXXXX|X|XXXXXXXXXX---XXXXXXXXXX|XXXXXXXXXXXXXXXXXXXXXXXXXXXXXXXXXXXXXXXXXXXXXXXXXXXXXXXXXXXXXXXXXXXXXXXXXXXXXXXXXXXXXXXX|XXXXX|XXXX-|-X|XX
