----------------------------------------------------------------------------------------------------------------------------------------------------------B---------------------------------------------
-----------------------------------------------------------------------------------------------------------------------------------------------------------------B----------B---------------------------
-----------------------------------------------------------------------------------------------------------------------------------------------------------------------o--------------------------------
--------------------------------------------------------------------------------------------------------------------------------------------------------------------------------------------------------
--------------------------------------------------------------------------------------------------------------------------------------------------------------------------------------------------------
----BBBBB-----------------------------------------------------------------------------------------------------------------------------------------B-----------------------------------------------------
-------------------------------------------------------------------------------------------------------------------------------------------------------------------------------BBBBB--------------------
---------------------------------------------------------------------------------------------------------------------------------------------------------------????-----B------------------------------v
----------??-------------------------------------------------------------------------------------------------------------------------------------------------------------------------------------------f
----------------------------------------------------------------------------------------------------------------------------------------------------------X-----o--------------------------------------f
----------------------------------------------------------------------------------------------------------------------------------------------------------------------------------------------------X--f
--------????X?-----------------------------------------------------------------------------------------------------------------------------------B---------------------X---------------------------B---f
-----------XX-------------------------------------------------------------------------------------------------------------------------------------------------------------------------------X-X-----X--f
----------XXX-----------------------------------------------------------------------------------------------------------------------------------------T----B---T--------X-----XBBB-----o-----XX--------f
m--------XXXX-----------------------------------------------------------------------------------------------------------------------------------------|--------|---E-------------E-----X----XXX--------X
XXXXXXXXXXXXXXX--XXXXXXXXXXXXXXXXXXXXXXXXXXXXXXXXXXXXXXXXXXXXXXXXXXXXXXXXXXXXXXXXXXXXXXXXXXXXXXXXXXXXXXXXXXXXXXXXXXXXXXXXXXXXXXXXXXXXXXXXXXXXXXXXXXXXX|XXXXXXXX|XXXXXXXXXXXXXXXXXXXXXXXXXXXXXXX------XXX
