----------------------------------------------------------------------------------------------------------------------------X--M--X--------B-------------XM-----?????B??-------------M--B-B-X-----------
--------------------------------------------------------------------------X----------------------------B--------B-----------------X--------X----BX-----B?----B-------B--------------B---Xo---X------X---
-------------------------------------------------------------------------------------------------------B------------------------------------o-XBB--B---X----X--B---------------------XBBB---?---B-------
----------------------------------------------------------------------------------------------------------------X-----------------------???X-TT------------X------B--B------------X--------X????------X-
-X---------------------------------------------------------------------------------------------------------XB---------------B---B----BBBB?BBB||---------X--T-T---------------X------X-TXBX--?-X--XX---X-
-----------------------------------------------------------------------------------------------------------------B-------------B---MXXX----B-||-M---X---BB-|-|B-B--X--------XX-----X?X|?XoXTTXMXXX?-B-X-
------------------------------------------------------------------------------------------------------------------B-----------B------------o-||-B-----o--XX|X|-B-----------XXX-----BoB|?BB-||XXXXTo--XX-
---------------------------------------------------------------------------------------------------B--------------------------------------X--||-o--T------X|X|---B--------XXXX-----B?-|TX--||XXXX|XXXXXv
------------------------------XXXX---------------------------------------------------------------------------------------------------o----XX-||---o|-XoT--X|X|-----------XXXXX--------||XXM||XXXX|-XXXXf
------------------------------------------------------------------------------B------------------T----------------XXXX---------B--------B-XXX||----|BMX|X-X|X|--X-------XXXXXX-o---Bo-||XXX||XXXX|XXXXXf
---X---------------------------------------------------------------?-----------------------------|-----------------------------?----------XXX||----|-BX|XXX|X|X?-------XXXXXXX----B--B||XXX||XXXX|XXXXXf
------------------------------------------------------------------------------------------------B|-----X---------B---------B----------X---XXX||BXXX|---|XXT|X|XXTBBBBBXXXXXXXX--B--?BB||XTX||XXXX|XXXXXf
-------------------------------------------------------------------------------------------------|---------------------------X-B-B--------XXX||XXX-|BBB|XX||X|XX|----XXXXXXXXX-------B||X|X||XXXX|XXXXXf
-------------------------------------------------------B-----------------------------------------|------------------------------------B---XXX||XXXX|--X|XX||X|XX|X--XXXXXXXXXX--B-----||X|X||XXXX|XXXXXf
m------------------------------------------------------------------------------E----------E------|----------------E-------E-----B---E-XXXXXXX||XXXX|BXX|XX||X|XX|XXXXXXXXXXXXX----BEXE||X|X||XXXX|XXXXXX
XXXXXXXXXXXXXXXXXXXXXXXXXXXXXXXXXXXXXXXXXXXXXXXXXXXXXXXXXXXXXXXXXXXXXXXXXXXXXXXXXXXXXXXXXXXXXXXXX|XXXXXXXXXXXXXXXXXXX-XXXXXXXXXXXXX------XXXX||XXXX|XXX|XX||X|XX|XXXXXXXXXXXXXXXXXXBo-||X|X||XXXX|XXXXXX
