------------------------------------------------------------------????----------------------------------------------------------------------------------------------------------------------------------
---------------------------------------------------------------------------------???--------------???--------------------XXXXXXX-BBBBBB-----------------------------------------------------------------
------BBB----------------------------------------------------------???????------------------------------------------------------------------------------------------------------------------------------
-----------------------------------BBBBBBB-----------------------------------------------------------------BB---------------------------------------------------------------??-----------------------B--
------------------------------------------------------------------------XXXXXoX--------------------------------------------------------------------------------BBBBBB------------BBBBBBB----------------
--------------------------------------------------------------BBBBBB---------------------------------------------o--------XXXXXXX-????------------------------------------------------------------------
----------------------------------------------------------------BBB------------------------------------------------------------------B-------------------------------------------------------------o----
--------------------------------------------------------------------------------BBB---------BBBBBBBB------------------------------------------------------------------------------------------X--------v
------------------------------------------------------------------------------------------------------------????---------------------------------------------------------------------------------------f
----------------------------------------------------------------BBBB-----------------------------------------------------------------------------------------------------------------------------------f
----------------------------------------------------------------------X-----------------------------------------------X--------------------------------------------------------------------------------f
---------------------------------------------------------------------XX----??--------X-------------------------------XX-------------------------------------------------------------------------------Bf
--------------------------------------------------------------------XXX-------------XX------------------------T-----XXXBB------------------------------------------------------------T-----------------f
-------------------------------------------------------------------XXXX------------XXX------------------------|----XXXX--------------------------------------------------------------|-----------------f
m-----------------------------------------------------------------XXXXX-----------XXXX------------------------|---XXXXX--E-----------------?X-----------E--------------X-------------|-----------------X
XXXXXXXXXXXXXXXXXXXXXXXXXXXXXXXXXXXXXXXXXXXXXXXXXXXXXXXXXXXXXXXXXXXXXXXXX---XXXXXXXXXXXXXXXXXX--X--XXXXXXXXXXX|XXXXXXXXXXXXXXXXXXXXXXXXXXXXXXXXXXXXXXXXXXXXXXXXXXXXXXXXXXXXXXXXXXXXXX|XXXXXXXXXXXXXXXXXX
