---o---------------o--X-----X------o--------o--------------o-o-B---o--o------------o-----------------o-----o-o---------------B---o----------BB-------B---------X--o------------o-----BB--------o----X---
--------oo---o---o--------o--XX------------B------------B-----B--o--------B---X-----------o--------B--B----------o----------------X------B--------o----o---------------o---------------o-----o--------B-
--X-----B---B---------------o-B---o----o----o----o-B------E------------------------oX------XBoo------B----------------o----------o------------oE---o-XoB-----------------------X---X-B----Boo---o-----oo
-------B-X-----------B-------------------X-----X---o----oo----B--o--------o-X-----o--------o-------B-X--o-----------------B--oo---B----o--BB--o-----------X---B-B--B-o-----o-----B---B---------------o--
--oo-?----------------o------B---------------------o----B----o-------------------o--------o-o------o-----E-----------B--o-------------o--X-------B-------------------o--X----o---------------XB---------
---o---------------------------o----B---o----------------------------X-------oB-o----------------X--B-----X--------------------o----B--------o----o--o------------------o--B-------o----Boo-B----------B
-B---------o---Bo--X---------o-----------------o-o--o------o----------------B--B----B-------------o---------B-o-------o-------------B-----------------oo-o--------B------B---B-o----o--------------o-o--
----B---B----B------o----o----o-X----------------------E-----oo----o-X-----B-o-------------------------BoB-o-o------------o-----------------------------------X--------------B---------------B-oo------v
--B--o----X----------o---o--XX-------o--X-----o--------------X--------X---B-E-B----------------o---o----o-----------X--o-------------------------o------BB----------o--------o----o--?---XB------------f
--X------X------X--------o-B------o-X----o-------o---------o-----o----B--o------------------------B---o-o-B--------B------------------X----B-B-o------------------------X--B-------o------o-o-------o--f
----X-------------BX------------------------oB---o--B-o--X-------------------BB--------------o----------------------------XB-?--------B--------B----o-oo---------oB--------------B-----------B------o-of
--o--X-o---o--o--------E--------X--------B--------------o------o------o-------------------------o-o---o------------B--B------o---o----o----------B-Bo---------------o----------B------o--X------o------f
------------ooX--o-----o---o----X----------o--------o--------B-o---------------X--------o--Xo--------oo-----o-----o-Bo-------o----o-----------o--o-o---?-o--------------------------------oo----------Xf
---oo---------E-o------o------EB-------B------------------------B---E-o-----o----------o-E--o-----oo------o-----------oooo-o-------E-o--o------B--o---------o-----E-E-----o--o-B-----------------------f
m---------B-----?---oE-o-XB----BB------o----------EE-----o----B-----------B-B-o---o--o-o--------o-X-------E-o-B----------E-o----B--------------o--Bo-o----oo-B----o---------o---X-------EXX-o----------X
XXXXXXXXXXXXXXXXXXXXXXXXXXXXXXXXXXXXXXXXXXXXXXXXXXXXXXXXXXXXXXXXXXXXXXXXXXXXXXXXXXXXXXXXXXXXXXXXXXXXXXXXXXXXXXXXXXXXXXXXXXXXXXXXXXXXXXXXXXXXXXXXXXXXXXXXXXXXXXXXXXXXXXXXXXXXXXXXXXXXXXXXXXXXXXXXXXXXXXXX
