----------------------------------------------------------------------------------------------------------B----------BX-------BBBB-----------X---BBBBBXXoXX---X-X-------------------o-------------------
--------------------------------------------------------------------------------------------o---------B-M----BBBBBB---Bo-B---X-------X-B-B-B-BB-X-Bo---B-X-----B------B------------XX--------------o----
-----------------------------------------------------------------------------------------B----X-BB-----X---?B--?--------Xo---X--B---X-----BM--?B--B----X----B--B---BB----------------X?XXXXX-??????-----
-------------------------------------------------------------------------------------------T--B--T---------------X--M-T---BM-----oBB-----X----------T-----BBBBBBBB-?--------------?-------BBBBXBXBX--B--
----------------------------------------------X------------------M-------------------------|-----|------XXXXXXXXX--X--|----XX--X--XB---------XB-X-XX|---T--B-oB-------X----------------X------T----XX---
----------------------------B-------------------------------------------B-M----------------|---B-|XX-M----XX------B-TB|X--X---BB-----T-BBXXXBXM-XX--|T--|T-----------XX-------B--X----?M-----T|---XXTT--
-------------------------------------------------------------X------------X-----T---B------|---X-|--M-oB-XXX------BX|M|--B---TTXB-X-X|---XXX--XXXXTX||--||----?-----XXX----------XX----X----M||--XXX||--
--------------------------------------------------------------------------T-----|--------T-|-----|--B-T-XXXX-B-BB-X-|B|-BB---||-BXX-X|oTBTXXXBXXX-|T||BX||-X-T-----XXXX---------BXXX---------||-XXXX||?v
----------------------------------------------------------B------------B--|-B---|--------|B|-X--?|---X|XXXXX-----XXX|?|-BB-X-||-XXXBX|X|X|XXXXXXX-||||T-||XXX|--X-XXXXX-XXXX-----XXXX-o------||XXXXX||Xf
--------------------------------------------------------------------------|-----|--------|-|-----|----|XXXXXBXB---XX|-|oT-X-T||XXXX-X|X|X|XXXXXXT?|||||B||XXX|---XXXXXX-BBBBBB---XXXXX--?B---||XXXXX||Xf
--------------------------------------------------------------------------|--o--|--------|-|-----|TX-X|XXXTXXXX---XX|X|-|B--|||XXXXXX|X|X|TXXXXX|X|||||-||TXX|X-XXXXXXX--T---X---XTXXXX------||XXXXX||Xf
---------------------------------------------------------------------?----|--B--|-X------|-|-----||-XX|XXT|XXXXXo-XX|X|-|-M-|||XXXXXX|X|X||XXXXX|X|||||X|||XX|XXXXXXXXX-M|-------X|XXXXX---BX||XXXXX||Xf
--------------------------------------------------------------------------|---??|XXX-----|-|--Bo?||XXX|XX||XXXXTX-XX|X|X|B-?|||XXXXTX|X|X||XTXXX|X|||||X|||XX|XXXXXXXXXBB|-----T-X|XXXXXXX-XX||XXXXX||Xf
---------------------------------------------------------------------X----|-----|-XXX----|X|--B--||XXX|XX||XXXX|TXXX|X|X|--X|||XTXT|X|X|X||X|XXX|X|||||X|||XX|XXXXXXXXX--|-----|-X|XXXXXXXXXX||XXXXX||Xf
m---------------------------------------------------------E---------XX----|--EE-|-XXXXEE-|X|EE-E-||XXX|XX||XXXX||XXX|X|X|XXX|||X|X||X|X|X||X|XXX|X|||||X|||XX|XXXXXXXXX--|-E---|-X|XXXXXXXXXX||XXXXX||XX
XXXXXXXXXXXXXXXXXXXXXXXXXXXXXXXXXXXXXXXXXXXXXXXX----XXXXXXXXXX-----XXX----|--XXX|XXXXXXXX|X|X--BX||XXX|XX||XXXX||XXX|X|X|XXX|||X|X||X|X|X||X|XXX|X|||||X|||XX|XXXXXXXXX--|XXXXX|XX|XXXXXXXXXX||XXXXX||XX
