---------------------------------------------------B---------------------?X-----B----M-------------XB-------------B----BXXXXXX--B----------------------B----?--MB-----------BX--------------------------
-------------------------------------------------------------Bo????---------------X-----------------X------------------X--------------X--------------M----X-----X----------X---X------X---B-M---?XB-----
----------?-----------------------------------------------------------------B--------X------?--X------X------------------------------------o------------------------X--------------------B----XB--------
-----------------------------------------------------------BB-----o------------------------X-------X------------o--------X------B-----X---B--------------------X-X---?-T--?B-X----??o?XXXXXXX--T--XX--T-
---------------------------------X-------X--------------B------B-------------------B---------T-----X----------X-----B------B--T------------------------T------------BT-|-B-------------------T-|B-BBBX|-
--------------------------------XX--------------------------B--------T--B-----X----------o---|--------------------T-------X--X|-B----o-----------------|------XB---M-|-|-----X-----T---X-----|B|BBB-o-|-
-------------------------------XXX----------------------BBBBT------X-|---------B----B-----X--|------X-T-X-----B---|---------XX|-X-----BXB----?--X----X-|------XXX---X|-|BB--XX-----|----X--?B|?|XB?--X|-
------------------------------XXXX--------------------------|--------|B----B-----------------|--------|-XX--------|--------XXX|o--M-----XXXXX-BXXXM---X|-----XXXX----|T|T--XXT-----|---MXXXB-|-|XX--XX|v
-----------------------------XXXXX-------------------------X|-B-X---B|-----------------------|?-------|BXXX?B--X--|-X-----XXXX|---------------BXXXX----|--B---XXXX?X-||||-XXX|----T|-BX-TXXB-|B|XXXXXX|f
----------------------------XXXXXX--X---------------????B---|-------B|--X-?????-----------T--|X-------|-XXXX------|X----XXTXXX|---------T------XXXXX---|-T----XXXXX--||||XXXX|TXXX||X-o-|XXX-|?|XXXXXX|f
---------------------------XXXXXXX------------------------B-|--------|----BoB----------X-?|??|???-----|-XXXXX----B|-B---XX|XXX|---------|------XXXXXX--|-|----XXXXTXX||||XXXX||-XX||----|XXXX|B|XXXXXX|f
--------------------------XXXXXXXX----B------------X------XB|-?---B--|X-------T-----------|--|--------|-XXXXXX----|M---XXX|XXX|--XoB--B-|-X----XXXXXXX-|-|----XXXX|XX||||XXTX||XXX||B---|XXXX|-|XXXXXX|f
-------------------------XXXXXXXXX-----------------XX-X-----|--------|XX-XX--o|-Xo---B----|--|-BB-----|-XXXXXXX---|---XXXX|XXX|---------|------XXXXXXXX|X|---?XXXX|XX||||XX|X||XXX||-B--|XXXX|X|XXXXXX|f
------------------------XXXXXXXXXX-----------------XXX-B----|X-------|XXXX----|-----------|X-|------X?|-XXXXXXXXM-|-oXXXXX|XXX|X--------|-T---oXXXXXXXX|-|----XXXX|XX||||XX|X||XXX||-XXX|XXXX|X|XXTXXX|f
m---------E------------XXXXXXXXXXXE----------------XXXX-E-E-|--E--E--|XXXX----|XX--o-E--E-|XX|-------E|oXXXXXXXXX-|-XXXXXX|XXX|E-------X|E|----XXXXXXXX|X|--X-XXXX|XX||||XX|X||XXX||E-EE|XXXX|X|XX|XXX|X
XXXXXXXXXXXXXXXXXXXXXXXXXXXXXXXXXXXXXXXXXXXXXXoXXX-XXXXX-XXX|------X-|XXXXX---|B---------B|XX|X---B---|-XXXXXXXXXX|XXXXXXX|XXX|--XX----X|-|---XXXXXXXXX|X|----XXXX|XX||||XX|X||XXX||----|XXXX|X|XX|XXX|X
