-----------------------------------------------------------------------------------------------------------------------?-X---------------------------BX--------B-------------?????-------------XXXX-----
---B-------------------------------------------------------------------------------------------------------------------------------------B-B-B----------------B----B-------X----------X-----------------
---------------------------------------------------------------------------------------------------------------------------------------------o-----B--------------B-----o---------o-----M----B---B------
--B-----------------------------------------------------------------------------------------------------------------B-----B---------------X--------------BBBBBX--XXoX----BB----X-----------B------------
---------------------------------------------------------------------------------------------------------------------------------------------------------------------------------------X-----?--B-B--TX-
------o---------------------------------------------------------------------------------------------------------------------------------------------------------------------o---BBBBBBBXX------------|X-
-X----------------X-------------------------------------------------------------------------------------------------------------?????----------------------o---o-----T-BBB---X-B------XT------------X|X-
-----------------------------------------------------------------------------------------------------------------X-X------------------M-----------------------B------|-B-----------X-XX|XXXX---XXXXXX|Xv
---------------------------------------------------------------------------------------------------------------------------------------------------------------------|?---???-X-----XXX|---------oXXX|Xf
----------------------------------------------------------------------------------------------------------------------------X---------------------------------X----BB|--------XX---XXXX|------B--XXXX|Xf
-----------------------------------------------------------------------------------------------------------------------B---XX--------X------------X--B--------oo----X|------X-XXX-XXXXX|--B-----XXXXX|Xf
--------------------------------------------------------------------------------------------------------------------------XXX--------------------XX-------------T----|--M---XXXXXXXXXXX|----?--XXXXXX|Xf
-------------------------------------------------------------------------------------------------------------------------XXXX-------------------XXX-B----------T|----|--B-B-XXXXXXXXXXX|--M---XXXXXXX|Xf
------o-------M---------------------------------------------------------------------------------------------------------XXXXX------------------XXXX------------||X---|---X-XXXXXXXXXXXT|-----XXXXXXXX|Xf
m-----B--------------X-------------------------------------------------------------------------------------------------XXXXXX-----------------XXXXX------------||--X-|E--E-XXXXXXXXXXX||BE-EXXXXXXXXX|XX
X------XXXXXXXXXXXXXXXXXXXXXXXXXXXXXXXXXXXXXXXXXXXXXXXXXXXXXXXXXXXXXXXXXXXXXXXXXXXXXXXXXXXXXXXXXXXXXXXXXXXXXXXXXX-----XXXXXXXXXXXXXXXXXBXXXXXXXXXXXXXX------B--||X-XX|XXXX-XXXXXXXXXXX||XX-XXXXXXXXXX|XX
