---------------------------------------------------------XXXXXXX----------------------------------------------------------------------------------------------------------------------------------------
-----------------------------------------o--XXXXXXX----------------BBBBBBBB-----------------------------------------------------------------------------------------------------------------------------
----------------------------------------------?????----------------------------------------------------------------------------XXXXX--------------------------------------------------------------------
---------------------------------------------------------------------------------------------------------------------------------------------------------------------o----------------------------------
---------------------------------------B-----BBBB--------------------------------------------------------------------------------------------------------------------------------X----------------------
-------------------------------------------------------------------------------------------XX---------------------------o-------------------------------------------------------------------------------
-----------------------------------------BBBBBB---------------------XXXXXXX-------?-----XXXXXX----------------------------------------------------------------------------------------------------------
-------------------------------------------------------------------------------------------------------------------------------------------------------------------------------------------------------v
-------------------------------------------------------------------------------------------------------??????----------------------------------????????------------------------------------------------f
-------------------------------------------------------------X----------------B----------------------------------?------------------------------------------------------------------------------BBBBBB-f
-------------------------------------------------------------------------------------------------------------------------------------------------------------------------------------------------------f
-----------------------------------------------T---------------------------T------------------------------------?---------------X------------------------------XXXX------------------------------------f
-------------------------------------------????|?BBBB-----????T???---------|---------------------------------------------------XX------------------X---------------------------------------------------f
-----------------------------------------------|-----T--------|------------|------------------------------???BBBBB------------XXX-----------------XX---------------------------------------------------f
m?---------------------------------------------|-----|BBBBBB--|------------|---------------------------------BBBB-----E------XXXX-XE-------------XXX------E-----????????-------------------------------X
XXXXXXXXXXXXXXXXXXXXXXXXXXXXXXXXXXXXXXXXXXXXXXX|XXXXX|XXXXXXXX|XXXXXXXXXXXX|XXXXXXXXXXXXXXXXXXXXXXXXXXXXXXXXXXXXXXXXXXXXXXXXXXXXXXXXXXXXXXXXXXXXXXXXXXXXXXXXXXXXXXXXXXXXXXXXXXXXXXXXXXXXXXXXXXXXXXXXXXXX
