----------------------------------------------------------------------------------------------------X--------------------------------------X-------B---------XXXXXBXX------------------M-------------XX-
---------------------------------------------------------------------------------B------------------------------------------------------------------------------------X-------------------------X-------
--------------------------------------------------------------------------------------------------------------------------------------???-X-----BBBBB-------X------B----?-------------------------------
----------------------------------------------------------------------------------------------------------B-?-BBB-------------------------X------X------------------------X------X-----------T??--X-----
-----X--------------------------------------------------------------------------------------------X---------------------------?---------------------o---T-----o-----------X------------------|-------??-
---B-------------------------------------------------------------------------------------------------M----M-------------------------------??--o-X-------|TXXXXXX-M-------XX------------------|-BX-------
----B----------------------------------------------------------------------------------------------------------T-----------------------T---------------B||----XX--------XXXB------------o----|----------
----------------------------------------------------------------------------------------------------BBBBB------|--------XX-------------|----------------||---XXX-------XXXX?--B--o-X-----X--M|---o-----v
------------------------------------------------------------------------------------------------------oBBBBB---|-----------------------|----------------||T-XXXX------XXXXX-----X-------XX---|---------f
---------------------------------------------------------------------------------------------------------------|-----T--------------?--|-------B--------|||XXXXX-----XXXXXXXXXXXXBX----XXX---|------X--f
----------------------------------------------------------------------------------------------X--------------T-|-----|------------XT--X|--T-B------X--B-|||XXXXX----XXXXXXX-B-XX------XXXX---|---------f
--------------------------------------------------------------------------------------------------T----------|-|-----|-------------|---|--|-------------|||XXXXXT--XXXXXXXX---XXX----XXXXX---|---------f
------------------------------------------------------------------------------------------T-------|?---------|-|-----|-------------|---|--|-------o-----|||XXXXX|-XXXXXXXXX---XXXX--XXXXXX---|------X--f
------------------------------------------------------------------------------------------|-----X-|-B--------|-|-----|-------------|---|-X|------------X|||XXXXX|XXXXXXXXXX---XXXXXXXXXXXX---|B?---XX--f
m-----------------------------------------------------------------------------------------|-----XX|-E--------|-|---X-|--oE---------|---|--|-----------XX|||XXXXX|XXXXXXXXXX--EXXXXXXXXXXXXE--|-o--XXX--X
XXXXXXXXXXXXXXXXXXXXXXXXXXXXXXXXXXXXXXXXXXXXXXXXXXXXXXXXXXXXXXX?---XXXXXXXXXXXXXXXXXXXXXXX|XXXXXXX|XXXXXXXXXX|X|X-XX-|--X???XX--XXX|---|XX|XXXXXXXX--XXX|||XXXXX|XXXXXXXXXXo-XXXXXXXXXXXXX-XX|XXXXXXX-XX
