------B---------------o--------------------------X-o---?---------------X---------------------------------------------------------?---------------------------XXXXXXXB-----------------------------------
----------X--------------------------------------------------------------------------------------------------------------------------------X--------------------BBMBoBX--------------------------o------
--B-----X-B--X-XM-???????------------------------------------------------------------------------------M------------------------------???-------BBBBB-X------o--------------X----------B-B--------------
----X--------X------T---------???--------BBBBB---------------------------------------------------------------------------------------------------X------BBBBB-------------X-----------------------------
------------T-------|----T---------------------------------------X------------------------------------------------------------?-----------XB-T-------X-----------------T--X---B------------------B------
------------|---B---|-BT-|--------------------------------------XX--------------------------------------------------------------------------B|--X---------XXXX-X-------|-XX--------------------BX-------
-----M------|-----X-|--|T|----B-------------------X------------XXX-------------------------------------------------------------------------B-|--B----M-B------XX-------|XXX--------------BB-------------
------M--X--|-----XX|--|||-----------------------XX-----------XXXX---------------------------X--------------------------------------B--------|--BTBBBBB------XXX-----B-|XXXX-------X--X--X-------------v
---------X--|-----XX|--|||----------------------XXX-B-X--X---XXXXX---------------------------XX----------------------------------------------|---|------o-T-XXXX-X-B--X|XXX-------BBBBBBXX-X-------B---f
-----B-B----|--X--XX|XX|||------B--------------XXXX--XX-----XXXXXX--------M------------------XXX----------B--------------------BBBB----------|---|X-------|XXXXXXX---XX|XXXXoXXXXXX----XXX----T--------f
----X-------|---o-XX|XX|||---------???B-------XXXXX-XXX----XXXXXXX--X---X--------------BBBBBBXXXX-----------------------------------------X--|---|--------|XXXXXXX--XXX|XXX---XX-----XXXXXX---|--------f
--------X---|-----XX|XX|||-------------------XXXXXXXXXX---XXXXXXXX-XX------------------------XXXXX----------------------------------------X--|---|-X-----X|XTXXXXX-XXXX|XXX---XXX----XXXXX---X|X---o-T-f
------------|----MXX|XX|||B-----------------XXXXXXXXXXX--XXXXXXXXXXXX------------------------XXXXXX---------------X----------------------BB--|-X-|XX----XX|X|XXXXXXXXXX|XXX---XXXX--XXXXXX--TX|XX----|-f
-----X------|-----XX|XX|||-----------------XXXXXXXXXXXX-XXXXXXXXXXXXX----XXXXX-----------X---XXXXXXX--------------XX---------------o-------?-|XXX|XX---XXX|X|XXXXXXXXXX|XTX---XXXXXXXXXXXX--|X|XXX---|-f
m---EB--BBBB|BBBBBXX|XX|||X------E-X------XXXXXXXXXXXXXXXXXXXXXXXXXXX--X----------X-----XX---XXXXXXXX-------------XXX--o-------E-----o----EE-|--X|XXEEXXXX|X|XXXXXXXXXX|X|X--EXXXXXXXXXXXX--|X|XXXX--|EX
XXXXXXXXXXXX|XX??XXX|XX|||XX-------XXXXXXXXXXXXXXXXXXXXXXXXXXXXXXXXXXXXXXXXXXXXXXXXXXXXXXXXXXXXXXXXXXXXXXXXXXXXXXXXXXXXXXXXXXX--MXXXXXXXXXMXB|XXX|XXBXXXXX|X|XXXXXXXXXX|X|X--XXXXXXXXXXXXXXX|X|XXXXXX|-X
