------------------X----------------------------------------------------------------------------------------------------------------------------------------------B--------------------------------------
--------------------------------------------------------------------------------------------------------------------------------------------------------------B---------------B-------------------------
---------B-------B--------------------------------------------------------------------------------------------------------------------------------------------------------------------------------------
--------------?-----------------------------------------------------------------------------------------------------------------------------------------------------------------------------------------
----------------------B---------------------------------------------------------------------------------------------------------------X------------o------------X----------------------------------B----
--------------------------X---------------------------------------------------------------------------------------------------------------o---------------------------------------?---------------------
--------------------------------------------------------------------------------------------------------------------------------------------------------------------------------------------------------
-------------------------B-------------o-----------------------------------------------------------------------------------------------------------------------------------------------------------B---v
--------------------X----------------B-----------------------------------------------------------------------------------------------------------------------------------------------------------------f
-----------------------B-----------------XB-----------------------------------B----------------------------------------------------------------------------------------------------------------X-------f
----------------------------------------XX---------------------------------------------o---------------------------------------------B------------------------------------------------X----------------f
--------------------------X------------XXX---------------------------------------------------------------------------------------------------------X---------------------------------------------------f
----------------B---------------------XXXX--------------------------------------------------------------------------------------------------------XX---o----------------B------------------------------f
---------------B--------------------XXXXXX-----------------------------------------------------------------------X-----------T---------B---------XXX-------B?????--------------------------------------f
m----------X----------o-------------XXXXXX-----------E----------------------------------------------------------------------X|------------X-----XXXX-----------------------------B-------------------o-X
XXXXXXXXXXXXXXXXXXXXXXXXXXXXXXXXXXXXXXXXXXXXXXXXXXXXXXXXXXXXXXXXXXXXXXXXXXXXXXXXXXXXXXXXXXXXXXXXXXXXXXXXXXXXXXXXXXXXXXXXXXXXX|XXXXXXXXXXXXXXXXXXXXXXXXXXXXXXXXXXXXXXXXXXXXXXXXXXXXXXXXXXXXXXXXXXXXXXXXXX
