--------------------------------------------------------------------------------------------------------------------------------------------------------------?BBB----o-------------------------------M-
--------------------------------------------------------------------------------------------------------------------------------------------------------?-----------------------------------------------
--------------------------------------------------------------------------B-------------------------------------------------------------------------------?------BBBBBBB-----------------------o--------
-------------------------------------------------o----------------------------------------------------------------------------------------------------T-----T---------o---------------------------M-----
---------------------------------------------------T---------------------------------------------------------------------------------------------T----|-----|---------X-?-------------------------------
---------------------------------------------------|---------------------------------------------------------------------------------------------|----|--X--|---T-X-MXX-T-BBB---------------------------
---------------------------------------------------|---------------------------------------------------------------------------------------------|----|T-XX-|---|T-TXTX-|-------------------------------
---------------------------------------------------|-------------------------------------------------------------------------------------------o-|----||-XXX|XXX||-|X|XX|XXXX-X------------------------v
------------------------------------------------o--|-T-------------------------------------------------------------------------------------------|----||-XXX|XX-||X|X|X-|XT--XX----XX------------------f
----XX---------------------------------------------|-|--B--------T----------------------------------------------------------------------------T--|----||-XXT|XXX||X|X|X-|X|-XXX---XXX-X----------------f
----XX---------------------------------------------|-|---------M-|----------------------------------------------------------------------------|--|T---||-XX||XXX||X|X|XX|X|XXXX--XXXXXX----------------f
----XXX--------------------------------------------|T|-----------|-------------------------------------------------------------T--------------|--||---||-XX||XXX||X|X|XX|X|XXXXBXXXXXXX------------o---f
----XXXX-------------------------------------------|||-----------|-------------------------------------------------------------|--------------|--||---||-XX||XXX||X|X|XX|X|XXXXXXXXXXXX----------------f
----XXXXX--------------------------X-----------?---|||-----T-----|-------------------X-----------------------XXXXX-------------|--------------|--||---||-XX||XXX||X|X|XX|X|XXXXXXXXXXXX----------------f
m---XXXXXX-----------------------------------EE----|||-----|-----|------------E-----XX------------------------------------E----|--------------|--||---||-XX||XXX||X|X|XX|X|XXXXXXXXXXXX----------------X
XXXXXXXXXXXXXXXXXXXXXXXXXXXXXXXXXXXXXXXXXXB-----XXX|||-----|-----|-------XXXXXXXXXXXXXXXXXXXXXXXXXXXXXXXXXXXXXX?XXXXXXXXXXXXXXX|XXXXXXXXXXX---|XX||XXX||-XX||XXX||X|X|XX|X|XXXXXXXXXXXXXXXXoXXXXBXXXXXXX
