----------------------------B---------------------------------o----------------------B------B-----------o---------------------B----------B-------------o---------------o-----B--------------------------
------------------o-------------------------B----------?----X-oX-----X-----------oo-----------------------B-------------------B--o---------o------------------------------------------------------------
---------oB---------B---------X------oo--X-------------------------o------oo------X-----X-------Bo---------------o------B-----------------------------------------B---o--------------------------B------
--------o--o----o-----------------B-----o-------------o---o-----------o---------B--------o-o---------o----------B---------------------o--------------------------------------------X-------B------------
--o--------oo---------o--------------o-----B-B-----o-----------------o---B----X--o--------M-----o--o-----o-B---------------o------B-----o-----XB--oo--------------------------------o-------o---B-------
----X--o--o-----oB--------o---------B--o----------o-------------------o-o--o---------o--o------------o-X---------------------B-------------o--o------X---B-B--------B----Bo----------B------------------
----------Xo---oo---o--------B-------E------o-----------------X--------------------X--------XoX-----o-----Bo-----o---------o----------B------------------X--B---------------o-------o----B-------X---B-X
-------X----o---X-o-----------------------------------o-------o------------------------------o---------B----o--------o-o------X----------o-----B------o-----------E-----B-B---------------o------------v
---------o-----B---------------------B--------o----------------------?B--------------B-----------B--------o-o---------o----o-o-----------o-----------o---o------------o--------------------------------f
-----------Bo---------------------------X--------o-o-o----o------------B-o----------B-------------------o---------o----------X----------B---XX---B----X--------------B------Bo-------------------------f
-B----------o---------------Bo---------------------o------------o-----------o-----X-------------o---o------------o----------------------B-------E-----------B---o---------------o-----X------------B--of
---------XB---E----------------B----oB-------o------B-oo-----o---------B---o-----o-o--------E-----------X--X-E-------B--o--X---------B------------X--------o--------Bo----Bo--------------X--------BX--f
---o----BX-------------------oX------B--------o---o--------------B-----X---o------oX----------o----o---------o-----------------o---------B--o------------o--------X--------X-----B---------------o-----f
--o--------B-o--------X------------o--------o-------B-------B-o--------------------o----------B------------------X------------B--X-------------------BB-X----------B---Bo------------E------------o---Xf
m-----------X---------B---------E---o-----------X---oo---X-----------o------?---------B--------B----o-o-B--------------B-----oB---B--------------o------E--o---o-X--E---o----B---o-----B--o------------X
XXXXXXXXXXXXXXXXXXXXXXXXXXXXXXXXXXXXXXXXXXXXXXXXXXXXXXXXXXXXXXXXXXXXXXXXXXXXXXXXXXXXXXXXXXXXXXXXXXXXXXXXXXXXXXXXXXXXXXXXXXXXXXXXXXXXXXXXXXXXXXXXXXXXXXXXXXXXXXXXXXXXXXXXXXXXXXXXXXXXXXXXXXXXXXXXXXXXXXXX
