-------o---XoB---X----o-----X--oB----B-------o-----o---X-X------B-B----------------------------o---------oo-o--B--BX-------X----o------oX----B-XX--o-o-----B--B----BX-------o---B---X----o------o--X--o-
--------B------B-----Bo------------o---------------oo--------X-----o-X-o---o--X--o---------o-B------B-X--?oo---o-o--------------------oo-o-----B---E-o--o--B--oBo-BXX---Bo-----o----X----B----------X---
--o-oo--Bo-X---o-oo--X--E-----X--o---oB-o---oo------------------B-B-o--o------------------o-B-----B----B--o--B-----o-Bo------o-o--X-B-----B--X--B--B---o-o----o---B--------B---o--------oB--------------
o---B-----X--o----------X----------BB----o------o-o--------------------B--------Xo---T---B----------o----------------BT-----o--B--o------B--B---B---T-------B------B-----------------------o-B--B--B--o-
---XB---o--B--o---B-------o--------------o----o-------Bo-Bo-----------o--o-B---------|---B---o----------X-----o---o---|---------oo---o------------o-|--o---------Bo--o--X----o-------------X---------o--
B-B-----------B-ooo---XX---X------X-----X--------o--------oBoE----------B----o-------|----o-B--------o-------XB--B----|-------o-----?----------oE---|--B-----------------------oB----------B-----B------
-X---------B-----o------------oo--o-?--------B-B---o--B------B--o---Bo-X-o---Bo------|----------B--o----o---B----?--X-|------B---o--------------BBB-|--o-------------oB--B------o-o-B-----o-------o-----
---X-o-o-----X----BB-----X-B------B-------oX-----------B-oo-----B--o-o--B----o---o---|-------o-B--B-------XBo---o-o---|-B--o-o-B---Bo----------o----|-X------o----------o----X--------------oE-------o-v
---X----------oE---------------------------X-------------------X-------E-------X-----|---------B--------------------B-|-----o----------B---o-----o--|----B--BB----------------X----B------X--Xo----o--Bf
o-------------oX---oB-BBo------B---B---o-------BB-------o-----o--------XB----------B-|----------o-------o--------o----|---------o-----------B----o--|----X--------XB-oo-------o-----o---o----B---------f
--o---B-B---B-----E---B-B----------------------------B----Xo-------------o------o--o-|----B-o-----T------X---------X--|-----------B--B-----o----o---|-----o-o----o------B----T-o-o-----o----o----------f
-B----------------?-----X----X---X---T-B--o-----B-------------o--X------------ooB-B-B|------------|---Bo-------BX-----|--oo-----------B--------o----|---B------o----E-o------|-----o---------o--------of
----o--oX-----------------B-o--oo----|----B-----------o--B-----------oo--o---B-----o-|-------o----|---o------B--------|-oB-oX-----o--------oo-o--B--|-------o-------X--------|-o------B----------------f
BB---B-Eo-BB------o-o----B-BB--------|-E------XE-B-------o---X----B-------------XoX--|-X-X--B-oo--|--o----------B-----|-o--B------B----XXo----o-----|----o-X---o------o-o---B|-----o--------o--o------Bf
mo-----B-----------------o------B--B-|-B------oB----o--o----o-E---------B-o----------|-----B----o-|-X-oX-------o------|-o-----o---BB----o--B--XE-o--|----B--------E--------o-|------XB----BX-B--o------X
XXXXXXXXXXXXXXXXXXXXXXXXXXXXXXXXXXXXXXXXXXXXXXXXXXXXXXXXXXXXXXXXXXXXXXXXXXXXXXXXXXXXXXXXXXXXXXXXXXXXXXXXXXXXXXXXXXXXXXXXXXXXXXXXXXXXXXXXXXXXXXXXXXXXXXXXXXXXXXXXXXXXXXXXXXXXXXXXXXXXXXXXXXXXXXXXXXXXXXXX
