----------------------------------------------------------------------------------------------------------?---------------------------------------------------------------------------------------------
----------------------------------------------------------------------------------------------------------------------------------------------------------------------------------------------------X---
-----------------------------------------------------------------------------------------------------------------------------------------------------------------B--------------------------------------
-------------------------------------------------------------------------------------------------------------------------------------------------------------------M------------------------------------
--------------------------------------------------------------------------------------------------------------------------------------------------------------------------------------------B----T------
----------------------------------------------------------------------------------------------------------------------------------------------------------------------------------------???B??---|------
-To-----------------------------------------------------------------------------------------------------------------B--------------------------------------------------------------o-------------|-B----
-|-----------------------------------------------------------------------------------------------------------------------------------------------------------------XB--------------------B-------|-M---v
-|---------------------------------------------------------------------------------------------------------------------------------------------------------------B-------------------------------|----Xf
-|----------------------------------------------------------------------------------------------M-----------------------------------------------------------------------------------------X------|---XXf
-|--T---------------------------------------------------------------------------------------------------------------------------------------------------------------------------------XT---------|--XXXf
-|--|o--------------------------------------------------------------------------------------------X--------------------------------------------------------------BMM------------------X|---X----T|-TXXXf
-|--|--------------------------------------------------------------------------------------T------------------------------------------------------------------------------------------X|X--XX---||X|XXXf
-|--|--------------------------------------------------------------------------------------|------------------------------------------------------------------------B-----------------X|XX-XXT-T||X|XXXf
m|--|-------X------------------------------------------------------------------------------|---------------------------------------------------------------------BBB-----------------EX|XXXXX|X|||X|XXXX
X|XX|XXXXXXXXXXXXXXXXXXXXXXXXXXXXXXXXXXXXXXXXXXXXXXXXXXXXXXXXXXXXXXXXXXXXXXXXXXXXXXXXXXXXXX|XXXXXXXXXXXXXXXXXXXXXXXXXXXXXXXXXXXXXXXXXXXXXXXXXXXXXXXXXXXXXXXXXXX---XXXXXXXXXXXXXXXXXXXXX|XXXXX|X|||X|XXXX
