---X---o------------------------------------o-----------------X---B-------------o-------------------------o--------------------------o-----------------------BXo-o-B------o-X---E-------------B---------
-----B-------------------o----------o-----X--------------o----o-----BX-----oooo--Eo---o-------o----o---------------B----X------E------------o----B------o-----X----X----o---------o---------X---o-o-----
-----o-------B---------------B-B---------------------X-----X--o-----X--Bo--B---------------------B----------o------X---------------------o---Bo------------------o-----B-B---o-X-----Bo-------------B--E
-------------o--Xo-----B------o----------o-----------------o---------------------------B----B-----B--E-------X--o--o-----B---o--------B--o-----------------B--------B---o------B---------B-B------------
--oB-X----o--------Boo------o-X---------------o--oBBo-------------X----------E--o-----------o-B----ooB--------o---o--o--o------o-B-------o---X--o-------------------------X----B---------ooo--------o---
------------------------X-B---o--o---o--B-o--o----o---o------o--------o---o---------------o-------------oB----------X------B--------o---------oB----------B------------------------------------------oo-
-----------o-o-----XB-o-----------o-------o-o-B---o-BoB----------o-B--o-------o-----X----B---------------o-B--B---E-----------E----o-----o-B-o-----ooo----------o--o-B---------------B-o-X-o-----o------
---o-X---o---B----o-------o-------o-o-----Xo----X-----------o---o--B-----o------------------o-o-BB-------------B-------o------oo-------------------X-X-----------B-o----B---------B----B---------------v
------X----B-----o---B----o---o--------B---------o------o---o--o--------X---------------XBE---o---X----B-o---------o---------B------o---X--BB-------B---------B--------oXX-------------------B-oo--o---f
------oB----o-o-o-o---------B--------------B-------------------------------oo------o---X---------B-----B--o-BE--------------------o-----X---B-------------B-oo----B-o------oB-------------o------E---o-f
---oo---B-------------B-B---------------------------------------------B------oo---------o---Boo-----o---------o-----o----o------B---o----------oB------B-----------------------------------------o---o-f
---------o--------------o---o---------------o--------------o-----o---------B---B-------o--o---------o--o-------o-----------B-------B---B---o--B-------B------------o--o---------B--B-------------------f
--o----o---o---------X------X----o-------------o-----oB-o---B------------------------X-----XB-X--oo-o-----------------------o--oX---o------o----o-o---?-------o-------X--------E----B---o---Bo-B-------f
-o-----X--E----o----o-----o---------------------o--------------o----------------o-o---------E-oo-o--------------------------M------o-----------------------------o--o----o--------------o-------oB--E--f
m--o---------o---------E-----o-------B----oo----o----o------o--o---X-o-----B-------o-------------o-BBo--------o--o-----------E----X---o------MXB-B-----------------Xo---B--oB---------o--X--o-----Eo---X
XXXXXXXXXXXXXXXXXXXXXXXXXXXXXXXXXXXXXXXXXXXXXXXXXXXXXXXXXXXXXXXXXXXXXXXXXXXXXXXXXXXXXXXXXXXXXXXXXXXXXXXXXXXXXXXXXXXXXXXXXXXXXXXXXXXXXXXXXXXXXXXXXXXXXXXXXXXXXXXXXXXXXXXXXXXXXXXXXXXXXXXXXXXXXXXXXXXXXXXX
