-----------------------------------------------------------------------------------------------------------------------------------------------------------------------X----------------------BBB-------
----------------------------------------------------B----------------------------------------------------------------------------------------------------------------------------------B----------------
---------------------------------------------------------B--------------------------------------------------------------------------------X----------------------------------------------------------??-
-----------------------------------------------------------------------------------------------------------------------------------------------X------------------------B---------------------??--X-----
------------------------------------------------------------------------------------------------------------X-------------------------------------------------o------X-T-T------------------------------
----------------------------------------------------------o------------------------------------------------XX--------------------B----------B----------M---------------|-|--T---------------------------
----------------------------------------------------------------------------------------------------------XXX------------------------------------------B----------XXXXX|-|--|----XXXX----BB------XXX----
--BBBB--------------------------------------------X-----X------------------------------------------------XXXX--------------------B----------o---BTBBBBB--------B----XX-|-|-?|---------------------?----v
----------------------------------------------------B---------------------------------------------------XXXXX---------------------------------T--|--XXo--B----o----XXX-|-|--|--------------------------f
---------------------------------------------------B---------------------------------------------------XXXXXX---------------------------------|--|-------T--------XXXX-|-|--|--------------------------f
---------------------------------------------XBBBBBB--------------------------------------------------XXXXXXX----------------------BBB-------T|--|-X-----|-------XXXXX-|-|--|-----X-----------X----X---f
----------------------------------------------X-------X---T-----------------o------------------------XXXXXXXX--------------X--------------X--||--|--X----|------XXXXXX-|-|--|----oXX----o----XX--XXX---f
-----------------------------------------------------XX---|-----------------------M-----------------XXXXXXXXX--------------XX----------------||--|-------|-M---XXXXXXX-|-|XX|-----XXX-------XXX-B------f
---X------------------------------------------------XXX---|B---------------------------------------XXXXXXXXXX--------------XXX---------------||--|-X-----|-???XXXXXXXX-|-|--|-----XXXX-----XXXX--------f
m--XX----------------------------------------------XXXX---|-?E------------------------------------XXXXXXXXXXX--------------XXXX-----E--------||--|-------|XE-XXXXXXXXXE|-|--|-----XXXXXE--XXXXX--E-E-E-X
XXXXXXXXXXXXXXXXXXXXXXXXXXXXXXXXXXXXXXXXX-----XBXXXXXXXXXX|-XXXXXXXXXXXXXXXXXXXXXXXXXXXXXXXXXXXXXXXXXXXXXXXXXXXXXXXXXX-----XXXXXXXXXXXXXXXXXX||XX|XXXXXXX|XXXXXXXXXXXX-|B|-X|---XXXXXXXX-XXXXXXXXXXXXXXX
