---------------------------------------------------X-------------------o-----------M-----XXX-Mo----oM----XMXXXXXXBMXXo---?M-o-----Bo?--XXXXXX-----------------------------------------------------------
-----------------------------------------------------------------------------------------------------?-------XXX----oBBBBBBBBBXBBBoM--?-----------------------------------------------------------------
------------------------------------------------------------------------------X------B-----------o?????--XXBBBBB---???M----X?Xo--X--M-------------------------------------------------------------------
-------M------------------------------------?--------------X----------M--TT-----------B----X---o--B---o--TT-?--T--TBBBoB-TTBTT?o??--??M?????------------------------------------------------------------
-------------------------------------------------M----------------M--Xo--||------T-??o????????-T-XoTo--T-||?oBB|BT|XX?--X||X||-----XXXXXXXX--X----------------------------------------------------------
------------------------------------------------------M----------X----MX-||------|--M----X----M|XXT|XXX|X||To--|X||XX-XXX||-||--????T-T-----XX-X-------X------------------------------------------------
-------------------------------------------------------M--T-----------MXX||-----X|-X-T---------|XX||XXX|-|||X-X|X||XXXXXX||?||?oXX--|-|-o--XXXXX------XX------------------------------------------------
------------------------------------------M-------------o-|---T--------XX||--o--X|TX-|X-oT-B--X|XX||XXT|X|||XX-|X||XXXXXX||X||X-XXX-|-|---XXXXXX-----XXX-----B-----------------------------------------v
----------------------------------------------------------|---|-------XXX||-----X||X-|XX-|---XX|XX||TX||X|||XXX|X||XXXXXX||X||XXXXXX|B|--XXXXXXX----XXXX-----------------------------------------------f
----T-----------------------------------------------------|---|------XXXX||X----X||X-|XXX|--XXX|TX|||X||X|||XXX|X||XXTXXX||X||XTXXXX|-|-XXXXXXXX---XXXXX-----------------------------------------------f
----|?----------------------------------------------------|---|-----XXXXX||XX-XXX||XX|XXX|TXXXX||X|||X||T|||XXX|X||TX|TXX||X||X|XXXX|-|XXXXXXXXXX-XXXXXX-----------------------------------------------f
----|-----------------------------------------------------|--o|-X--XXXXXX||XXXXXX||XX|XXX||XXXX||X|||X||||||XXX|X|||X||XX||T||X|XXXX|X|XXXXXXXXXXXXXXXXX-----------------------------------------------f
----|-----------------------------------------------------|---|XX-XXXXXXX||XXXXXT||XX|XXX||XXTT||X|||X||||||XXT|X|||X||XX|||||T|XXXX|X|XXXXXXXXXXXXXXXXX-----------------------------------------------f
----|-----------------------------------o-----------------|---|XXXXXXXXXX||XXXXX|||XX|XXX||XX||||X|||X||||||XX||X|||X||XX|||||||XXXX|X|XXXXXXXXXXXXXXXXX-----------------------------------------------f
m---|-----E------------------------------------E---E-----E|--X|XXXXXXXXXX||XXXXX|||XX|XXX||XX||||X|||X||||||XX||X|||X||XX|||||||XXXX|X|XXXXXXXXXXXXXXXXX--------------E--------------------------------X
XXXX|XXX---XXXXXXXXXXXXXXXXXXXXXXXXXXXXXXXXXXXXXXXXX--X--X|XXX|XXXXXXXXXX||XXXXX|||XX|XXX||XX||||X|||X||||||XX||X|||X||XX|||||||XXXX|X|XXXXXXXXXXXXXXXXXXXXXXXXXXXXXXXXXXXXXXXXXXXXXXXXXXXXXXXXXXXXXXXXX
