------------B-----------------------o----------------B-o-------------------------o---B------------------X---------X-o------B--o------------------o------------------X--------------o-------o---o--------
-----------o---X---------X----o--------------------X-------------------------------------------X----------------B--o-----o---------------------B------E---o-------------------------------B-o-----o-----
-------X---oo-------E---o-------o--X-------o----------o--B-ooB-------?----X---B----X--------B----------B-----B-------o--oB--B------Xo-------------o---X----o----B-B-Xo-o---XXo--------o----o---------B--
-----X------B-o---o-o------X-----------o---------------oB----o----------o---ooB-----B------oo------o---------X---o------o-----------------o----o--E------Bo--oBB----Xo-o----oo------------B-------------
------B-------o-B--------X--X-------o---X-B------o--------Bo---o---------B---------B-X---B-----------------------------------B-------o-----------o----------o----B----X----B------X----------o----o-----
-oB-oo-------o---o-----------o------XB----------B-o-X------o---X-o--------oo---------o---o--------------X-------o---B-----o-----X-o-B----------X--o--o--------o-XX-----------B--------oo-----o----------
---------B-----o------B------------------X----------------X--o----------X-o--------------B---------------------------------B------X-----BoB---------------------------B---o-B-------o----B----X---o----B
--B--------Xo-XB-------E-----------B------------------------X---o-B---------------o----B-B-o-o---------o----B-B--X-------------------X-------o-----------------Bo--------B--BB------X---o-----o--------v
---------X-o--B---o-------------o------E----------E------o-o-------------X----o--------------o-XB-----------o-BE--B---o---------------------o-o----o-o-----o---o--------E-X-o----B-----o----X----X-X---f
------X-E----EE--B-o--B--------oo------?--o-----o--o---o----------------------------------oo---o----o-----oo-o--o---X----o------------------X-B--XEB---o-oX---o-----X--------------B---o---B-----o-o---f
-------B---------o--o--------------o-o-------------------oB-----------------------------------oo-----M--------B---------o-o--B----B--B--o-E-------EX------------------------o-o------------ooBX--------f
---B----B-----------------BBB--------------------B-X-----------B----------------X---B--------------------o---o-----?------B------X-B--------X--B-----o------B-----------X-----X--B---B---o-oE-------oB-f
-B--B-----o--o----------o-----------Eo-o-X-------B-X--Bo-----B-----o-----B--B---o---XB-----------Bo---B--E---oB-------B--------------o----BB-----B--------B-----o------o-----------ooo---oB--o----o-B--f
-B-----------B----------------o-----------o----X---B----B----------------X--B----B---------o---------------------o------o---B-------Xo---oo-X-------B---------X------X-Bo----------B-o-----------------f
m---oo-o-BB--o-------X-------B---Eo--------o---B---------E-------EE--XB-ooo-------X--------------Xo-oEB-o---------------X---------oo-o---o----o--B----E---o-o---X---B----X---------X------B---X-o---B-B-
XXXXXXXXXXXXXXXXXXXXXXXXXXXXXXXXXXXXXXXXXXXXXXXXXXXXXXXXXXXXXXXXXXXXXXXXXXXXXXXXXXXXXXXXXXXXXXXXXXXXXXXXXXXXXXXXXXXXXXXXXXXXXXXXXXXXXXXXXXXXXXXXXXXXXXXXXXXXXXXXXXXXXXXXXXXXXXXXXXXXXXXXXXXXXXXXXXXXXXXX
