--------------------------------------------------------------------------------------------------------------------------------------------------------------------------------------------------------
--------------------------------------------------------------------------------------------------------------------------------------------------------------------------------------------------------
--------------------------------------------------------------------------------------------------------------------------------------------------------------------------------------------------------
------------------B-------------------------------------------------------------------------------------------------------------------------------------------------------------------------------------
-------------------------------X---------------------------------------------------------------------------------------------------------------------B---------------------------X------------------XXX-
----BBBBB----------X------------------------------------------------------------------------------------------------------------------------------------------------------------------X-----------------
--------------------------------------------------------------------------------------------------------------------------------------------------------------------------------------------------------
-------------------o------------XXXXXXX-------------------------------------------------------------------------------------------------------------------------------------X--------------------------v
----------??-------------------------------------------------------------------------------------------------------------------------------------------------------------------------------------------f
-----------------------------------------------------------------------------------------------------------------------------------------------------------------------------------------X-------------f
-------------------------------------------------------------------------------------------------------------------------------------------------------------------------------BB-------------oB------of
--------????X?-------B--------------------B--------------------------------------------------------------------------------------------------------------------------------------------------------?---f
-----------XX------------------------------------------------------------------------------------------------------------------------------------------------------------------------------o----T------f
----------XXX-------------------------TX--------------------------------------------------------------------------------------------------------------------------------------------------------|------f
m--------XXXX--------------B----------|X---------------------------------------------------------------------------------------------------------------------------------------E--X--------BE---|------X
XXXXXXXXXXXXXXXXXXXXXXXXBXXXXXXXXXXXXX|XXXXXXXXXXXXXXXXXXXXXXXXXXXXXXXXXXXXXXXXXXXXXXXXXXXXXXXXXXXXXXXXXXXXXXXXXXXXXXXXXXXXXXXXXXXXXXXXXXXXXXXXXXXXXXXXXXXXXXXXXXXXXXXXXXXXXXXXXXXXXXXXXXXXXXXXX|XXXXXXX
