---------------------------B-------X-----------------oo-------------------------------------XB---------o---o------B---o---------------------B---o-----o-----------------o---o-----------o-------BB-----o
-------o----B-o----B---------o------------B-----------Bo----------oB----------o------B------------o--------------------o--------o------oB----------o--Bo--B--------oo---o-------o------------------o--o-
-------Eo---------o---------------B-----B-----X---o--X------B--------------X--B-----BX------oE----------B-o--o--B-o---X--o--XB-----B-----------B--X-----------------------------o------o--B--------X----
X-------------o---------------o-B-----------ooB-----o------------B--o--o-B----------B--B----o----------------X----o---o---------------------------------------Xo---B-------B---------o-------------B----
--oBB------------o---B------o-------o---o--o--------X----o----------------o-o------B-o-------o-------------------------B-----B-o----B-------------o-B------------X-----X-------------B-----B-ooo---o--Bo
----Xo----o------B-----B----------o---X--o--------X--B--------B-----oX-----------B-------X--o---o------------o--------o--------o--B------o-oBB-----o----o---------------BB-----------o---oX---o--E---Bo-
----o-o--o--B--------------o-o-----B------B-----o--B---X---o-oE-------------------------o--B-----Bo-o--X----B------Bo---X---o-------B-o-------o-----o--o-----E---------------------o--------B-o--B--o---
o---o------X----------o-X---Bo-------o---------B---------B------?--------B--------B-----------------o--o-o---o--X--o-o--------E-B-----B----o-----o----o----X-----X-o------o--o---X-----B-o------o-B--o-v
---------B--------------------------------B---------------------B--o---------o----------o---------oB-o-------o-----o---------X----X----o--X-E--o--------------o-------------o--Bo-------B--------------f
-----X-----o---o-B---------------------------o------------------o-------B---X--------------------------B-----------------o--------B------X------o---?----oB------------------------o-o-----X-------B---f
--B--o-o---Bo---o-o-B---oX--------------o--------------o--o---------B-X--------------o---------o------------o----X--Bo-oB---------------B-----o-X-------o-------------X--------E-o------o--------------f
-----------------o--------------------B--B--o-----B------B--X-E--------------------o--BBo-----------o----o----X------------o----oo-oBB-o-o-------o-o-B-----------X-------------B------------------o-X-of
--------B-----------------o--oB-------------o-----------X----B-------oo-----------B--------B--------oB--o-oo---o-----o-B---X-----oo---------o-----------B--o---X-----o--o---X-Eo---o--X-----------o----f
-----o---B-X-o----------------------B-----B----o------o------------------o-o--Xo-----B-o-ooX------o-------o-o-----------------X---E----oo--o-------B--X---B-o--o--X--X--------Bo---o------B-----------of
m----oo------E---------BBX-o-------o-------B--Bo-B--X-B--B-o-------------------X---------o-Bo-BB----------------B---X-----------o----------o---o--B------B-----------B------------o--X-----------------X
XXXXXXXXXXXXXXXXXXXXXXXXXXXXXXXXXXXXXXXXXXXXXXXXXXXXXXXXXXXXXXXXXXXXXXXXXXXXXXXXXXXXXXXXXXXXXXXXXXXXXXXXXXXXXXXXXXXXXXXXXXXXXXXXXXXXXXXXXXXXXXXXXXXXXXXXXXXXXXXXXXXXXXXXXXXXXXXXXXXXXXXXXXXXXXXXXXXXXXXX
