------------------------------------------------------------X---------------------------------B------------------------------o------B--------B-B-M---XXXX------------B-------------?--------------------
---------------------------------------------------------------------------------------------------------------B-----XX--------------o--X----------B----------------------BB---B----B---B---------o-----
----------------------------------------M--------------------------------------------------------------------------------M-o----B-----------------?----X-------B-----------B----------------?M?????-o---
-----------------------------------------------------------------X------o------------X------------------M-----T---------------B-------------------M-----------------------------o-----o---------------B-
-----------------------------------------------------------------------------------------------------------o-T|-----?-----------X---B-----------X--------------------------M----------B-----o------X-X--
-----------------------------------------------------------------------------------X-------------------------||---T----o----M--XX----T---------XX---?-??????------------o---?------B-----B--------XXXXX-
-----------------------------------------------------------------------------------------------------Bo--X---||---|BXBBBBX----XXX---M|-------BXXX-----------X------------X-----------?-----------XXXXXX-
---------------------------------------------------------------------------------------------------------XX--||---|-XX----T--XXXX--B-|-------XXXX------------?----?????BXX----------------------XXXXXXXv
----------------------------------------------------------------B--B----XXXX--------o--------------------XXX-||---|-XXT---|BXXXXX----|------XXXXX--------BX---X--------XXX--B------X----------XXXXXXXXXf
---------------------------------------------------X-----------------------------------------------------XXXX||---|-XX|X--|XXXXXX--B-|-----XXXXXX--------------?o???--XXXX-----X--------X----XXXXXXXXXXf
-----------------------------------------------------------------------------------------------?-----X---XXXX||---|?XX|XX-|XXXXXXXB--|----XXXXXXX------------------BBXXXTX-----XX------XX---XXXXXXXXXXXf
-------------------------------------------------------------------------------------------------------X-XXXX||X--|-XX|XXX|XXXXXXX--?|BX?XXXXXXXX-----------B-------XXXX|X----XXXXT---XXX--XXXXXXXXXXXXf
-------------------------------------------------------------------------------------------------------XXXXXX||XXB|-XX|XXX|XXXXXXXX--|XXXXTXXXXXX--------------o---XXXXX|X-----XXX|--XXXX-XXXXXXXXXTXXXf
-------------------------------------------------------------------------------------------------------XXXXXX||XXX|XXX|XXX|XXXXXXXXX-|XXXX|XXXXXX-----------------XXXXXX|X-----XTX|XXXXXXXXXXXXXXXX|XXXf
m-----------------------------------------------------------------------------E-----------------------XXXXXXX||XXX|EXX|XXX|XXXXXXXXXX|XXXX|XXXXXX-E--E-----------XXXXXXX|X-E---X|X|XXXXXXXXXXXXXXXX|XXXX
XXXXXXXXXXXXXXXXXXXXXXXXXXXXXXXXXXXXXXXXXXXXXXXXXXXXXXXXXXXXXX---XXXXXX---XXXXXXXXXXBXXXX---B--B-XXXXXXXXXXXX||XXX|XXX|XXX|XXXXXXXXXX|XXXX|XXXXXX----????X------XXXXXXXX|X-----X|X|XXXXXXXXXXXXXXXX|XXXX
