---------------------------------------------------------------------------------------------------------------------------------?----------------------------------------------------------------------
--------------------------------------------------------------------------------------------------------------------------------------------------------X-----------------------------------------------
---------------X-----------------------------------------------------------------------------------------------------------------------------------------------------------------------B----------------
--------------------------------------------------------------------------------------------------------------------------------------------------------------------------------------------------------
-------------------------------------------------------------------------------------------------------------------------o------------------------------------------------------------------------------
------------------------?-------------------------------------------------------------------------------------------------------------------------------------------------------------------------------
-----------------------------------------------------------------------------------------------------------------------------------------------B-----------------------------------------BB-------------
-------------------------------------------------------------------------------------------------------------------------------------------------------------------------------------------------------v
-------------------------------------------------------------------------------------------------------------------------------------------------------------------------------------------X-----------f
------------------------------------------------------------------------------------------------------------------------------------?------------------------------------------T-----------------------f
-------------------------------------------------------------------------------------------------------------------------------------------------------------------------------|-----------------------f
------------------------------------------------------------------------------------------------------------------------------------------X--------X---------------X-----------|--------o--------------f
--------------------------------------------------------------------------------------------------------------------------------------------------XX--------------XX-----------|--------------M--------f
---------------------------------------------------------------------------------------------------------------------------------------------XXXXXXX-------------XXX------B----|---------X-------------f
m----------------------------------------------------------------------------------------------------E-------------------E-----E----------------XXXX-----EE--X--XXXX-----------|--------XX-------------X
XXXXXXXXXXXXXXXXXXXXXXXXXXXXXXXXXXXXXXXXXXXXXXXXXXXXXXXXXXXXXXXXXXXXXXXXXXXXXXXXXXXXXXXXXXXXXXXXXXXXXXXXXXXXXXXXXXXXXXXXXXXXXXXXXXXXX-----XXXXXXXXXXXXXXXX--XXXXXXXXXXXXXXXXXXX|-------XXXXXXXXXXXXXXX-X
