--B---BB---o-----------------X-------------------------------------------------------------B---B----X--------------o------------o---------------------o----------------------------o-o------------------
--o----o-----o------X-----o-------B-----------------oB----o------oX--o----o----------------o---B-------------o------------oX----X-------------B----------------------X-o-------------o----B-----BB------
--------X-----B---o---B--------------X----------o-------------B---------------B-----o-----EB-------------o----B-------B------B-XB------o--o-B------o------o----------B-----o----B----------o---------o-X
------o--------o-----BX-o--o----o----o----------------B--B------X---------------B----------------------o--B---X-------X-------XBX--o-----o-----------X-----XB--X-----oo-o------------------o--oo---o----
--B---o-----B------o-o-o-----------o---------o--------------o-----------B----o-E------XB-------------o-----o----------------o-----o--------o--------o---o------------------oo-o-------------------o--o--
--------B-------o------------B-----------B----B-o----------------o-----ooo---ooX---o-------------X-------------o------------B---------B-----------o--o---o-------o-------o------X-------------o------o-B
----Bo--o----XBo---------------------B---XB-----o------------------------o--oX--------B---X--------B-------------------o----BX------------------X-------------o-Xo-o---------------------BB------------o
------------------------o--o-----------o----o---BX-o-----------------B--o--B--------B----XX--------o---------B--X-----B-----------B-----o------B-----------------B------ooo-------------B-----X----X--ov
-----------B------------------B-------Bo--B-o--------------B---------B-----o----Xooo------o-o----------BX----o--------B-X-----o----B----B--Eo------B-o-o---B---------E-------o----------------E---o-B--f
------o---------B-----B----------B-------B-------------------ooB-------------ooX---------------B-------o-Bo------o----oo----------------o------------oo------------------X----B-----------------oo--o--f
---o----------o------B----------------B------B----o-BX--X---Xo-?--o--B-------B-B--------------------oB----B----oB-------B---X-X-----E-o------B--------------o--B-----------------o------o--o--B--oEX-o-f
----B--X------o------o-X----B-----------o--------o-----------------------B-B-B-oooo-o-----------o-B--o---o-B---X---B-X---o---o-------------------o--------o---------B-BXB---o----B-----B-o-B------ooX--f
----o--------o---o----BB---------------o---BX-Bo-X-----o--------B-o-----o--X------o-o-B----------B-oBB------XBX-X--------------------Bo-----o-B--------X----B-----------o---------------------------B-Xf
---------Eo--oXEB-----o--------o--------B--------oB--------B---XX-------o------o-o--o------------X---E------o-X----o-B-----X-----------X-------BX---X------B------o-o----o--o------oBo-o--------X------f
m---o-o--oo-o-------X--o---------oo--------X--B------o-------B-E----E-o------------Bo-------------BBB-------------------X---oBB------o------------o-o--------B-oo---o----------X-B----o--o------B------X
XXXXXXXXXXXXXXXXXXXXXXXXXXXXXXXXXXXXXXXXXXXXXXXXXXXXXXXXXXXXXXXXXXXXXXXXXXXXXXXXXXXXXXXXXXXXXXXXXXXXXXXXXXXXXXXXXXXXXXXXXXXXXXXXXXXXXXXXXXXXXXXXXXXXXXXXXXXXXXXXXXXXXXXXXXXXXXXXXXXXXXXXXXXXXXXXXXXXXXXX
