--------------------------------------------------------------------------XXXXXXXX-------?--------------------------------------------------------------------------------------------------------------
------BBBBB-------M-------------------------------------------------------------------------------------------------------------------------------------------------------------------------------------
--------------------------------------------------------------------------XXXXXXX-----------------------------------------------------------------------------------------------------------------------
--------------------------------------------------------------------------------------------------------------------------------------------------------------------------------------------------------
------------------------------------------------------------------------------------X-------------------------------------------------------------------------------------------------------------------
--------------------------------------------------------------------------------------------------------------------------------------------------------------------------------------------------------
--???--------XXXXX-------------------------------------------------------------------------------------------------XXX---------------------------------------------------BB-----------------------------
----BBBBB---------------------------------------------------------------------------------------XXX----------------------------------------------------------------------------------------------------v
-BBBBBBB----------------------------------------------------------------------------XX---------------------------------???----BBB--------------------------------------------------------o-------------f
-------------------????--------------------------------------------------------------------------------------------------------------------------------------------------X-----------------------------f
--------------------------o------------------------------------------------------BBBBB------------BBBBBBBB--------------------------------------------????--------------------------?????--------------f
-------------------------------------------------------------------------------------------------------------------X-----------------------o-----------------------------------------------------------f
---XXXXXX--------------T-----------------------------------------------------------------------------------------------T----------------BBBBB----------------------------------------------------------f
-----------------------|-----------------------------------------------------------------------------------------------|---------------------------XXXXXXX-----------------------BB-------------???????f
m----------------------|--------------------------------------------M---------------------XXXXXXX----------------------|-------------------------------------------------------------------------------X
XXXXXXXXXXXXXXXXXXXXXXX|XXXXXXXXXXXXXXXXXXXXXXXXXXXXXXXXXXXXXXXXXXXXXXXXXXXXXXXXXXXXXXXXXXXXXXXXXXXXXXXXXXXXXXXXXXXXXXX|XXXXXXXXXXXXXXXXXXXXXXXXXXXXXXXXXXXXXXXXXXXXXXXXXXXXXXXXXXXXXXXXXXXXXXXXXXXXXXXX
