-----?BB----------------------------------???????----BBBBBB---------------------------------------------------------------------------------------------------------------------------------------------
---------------------------------------------------------BBBBBBB----------------XXXXXX------------------------------------------------------------------------------------------------------------------
-------------------------------------------------???----------------------------------------------------------------------------------------------------------------------------------------------------
-----------------------------------------------------------------BBB----X-------------------------------------------------------------------------------------------------------------------------X-----
--------------------------------------------o------------------------------------------------------------------------------------------------------------BBBBBBBB---------------------------------------
--------------------------------------------------------------------------------------------------------------------------------------------------------------------------------------------------------
---------------------------------------------------------------BBBB?????------XXXXXX--------------------------------------------------------------------------------------------------------------------
---------------------------------------------------------------------XB-----------------------------------------------------------------------------------------------------???????--------------------v
-----------------------------------------------------------X------------------------B----------------------------------------------------------------------------------------B-------------------------f
-------------------------------------------------------------------------------------------------------------------------------------------------------------------------------------------------------f
---????????-------------------------------------------BBBBBBB-------------B----------------------------------------------------------------------------------------------------------------------------f
----------------------------T--------------------------------------------------------------------------------------------------------------------------------------------------------------------------f
---X------------------------|-------------------------------------------------XB-------X-----------------------------------------------------------------------BBBBBB---------------M------------------f
----------------------------|---------------------------------------------------XXXXX-----------------------------------------------------------------------------------------------------------------Bf
m--E------------------------|------------------------E------------------X----------------------------------------------------------------------------------------------------------------------E-------X
XXXXXXXX----XXXXXXXXXXXXXXXX|XXXXXXXXXXXXXXXXXXXXXXXXXXXXXXXXXXXXXXXXXXXXXXXXXXXXXXXXXXXXXXXXXXXXXXXXXXXXXXXXXXXXXXXXXXXXXXXXXXXXXXXXXXXXXXXXXXXXXXXXXXXXXXXXXXXXXXXXXXXXXXXXXXXXXXXXXXXXXXXXXXXXXXXXXXX
