--------------------------------------------------------------------------------------------------------------------------------------------------------------------------------------------------------
----------------------------------------------------------------------------------------------------------------------------------------------------------------------------------????????-------B------
---------------------------------------------------------------------------------------------------------------------------------------------------------------------------------???????----------------
--------------BBBBBB-----------------BBBBBBBB-----------------------------------------------------------------------------------------------------------------------------------------------------------
--------------------------------------------------------------------------------------------------------------------------------------------------------------------------------------------------------
--------------------------------------------------------------------------------------------------------------------------------------------------------------------------------X-----------------------
-------------------------------------------------------------------------------------------------------------------------------------------------------------------------------------------o------------
-------------------------------------------------------------------------------------------------------------------------------------------------------------------------------------------------------v
-----------------------------???????-------------------------------------------------------------------------------------------------------------------------------------------------------------------f
-------------------------------------------------------------------------------------------------------------------------------------------------------------------------------------------------X-----f
----------------------------------------------------------------------------------------------------------------------------------------------------------------------------------XXXXXXX--------------f
---------------???-------------------------------------------------------------------------------------------------------------------------------------------------------------------------------------f
-----------------B------------------------------------------------------------------------------------------------------------------------------------------------------------------------------------Xf
---------------------------------------------------------------------------------------------------------------------------------------------------------------------------------------X--------------Xf
m-------------------------------------------------------------------------------------------------------------------------------------------------------------------------------------XX-------E-----XXX
XXXXXXXXXXXXXXXXXXXXXXXXXXXXXXXXXXXXXXXXXXXXXXXXXXXXXXXXXXXXXXXXXXXXXXXXXXXXXXXXXXXXXXXXXXXXXXXXXXXXXXXXXXXXXXXXXXXXXXXXXXXXXXXXXXXXXXXXXXXXXXXXXXXXXXXXXXXXXXXXXXXXXXXXXXXXXXXXXXXXXXXXXXXXXXXXXXXXXXXX
