-B------------------------------------------------------------------------------------------------------------------------------------------------------------------B-----------------------X-----------
------------------------------------------------------------------------------------------------------------------------------------------------------------------B---------------------------------X---
-----------------------------------------------------------------------------------------------------------------------------------------------------------------X--------------------------------------
-X--------------------------------------------------------------------------------------------------------------------------------------------------------------------------------------------------T---
---------------------------------------------------------------------------------------------------------------------------------------------------------------???X?--------------------------------|---
-----------------------------------------------------------------------------------------------------------------------------------------------------------------X----------------B-----------------|X--
----------X------------------------------------------------------------------------------------------------------------------------------------------------------------------------------------B----|---
----------XX---------------XXXXXX---------------------------------------------------------------------------------------------------------------------------X---------------------------------------|--v
----------XXX-----------------------------------------------------------------------------------------------------------------------------------------------XX----------X---------------------------|--f
----------XXXX----------------------------------------------------------------------------------------------------------------------------------------------XXX--------------------------------B-X--|--f
----------XXXXX---------------------------------------------------------------------------------------------------------------------------------------------XXXX------------------------------------|--f
----------XXXXXX--------------?-----------------------------------------------------------------------------------------------------------------------------XXXXX-----------------------------------|--f
----------XXXXXXX-------------------------------------------------------------------------------------------------------------------------------------------XXXXXX------------------------------B---|--f
----------XXXXXXXX------------------------------------------------------------------------------------------------------------------------------------------XXXXXXX--??-----------------------------|--f
m---------XXXXXXXXX-----------------------------------------------------------------------------------------------------------------------------------------XXXXXXXX--------------------------------|--X
XXXXXXXXXXXXXXXXXXXXXXXXXXXXXXXXXXXXXXXXXXXXXXXXXXXXXXXXXXXXXXXXXXXXXXXXXXXXXXXXXXXXXXXXXXXXXXXXXXXXXXXXXXXXXXXXXXXXXXXXXXXXXXXXXXXXXXXXXXXXXXXXXXXXXXXXXXXXXXXXXXXXXXXXXXXXXXXXXXXXXXXXXXX-----XXXX|XXX
