---------------------------X------------------------------------------------------------------------------------------------------------------------X----B------------------------B---------------?????-
-------------B---------------------------------------------------------------------------------------------------------------------B---------X---------X-------------------------------------------?----
------------------------------------------------------------------------------------------------------------------------------------------------------M-------------------------------o---------------X-
-----------------------------------------------------------------------------------------------------------------------------------------------------T-M---------------X---------------BBBBBBBB-------B-
-----------------------------------------------------------------------------------------------------------------------------------------------------|----------------------------B---------------------
---------------------------------------------------------------------------------------------------------------------------------------------------T-|----???????-----------B-------------T----X-X------
-------X-----------------------------------------------------------------------------------------------------------------------------------------X-|-|X------------------X----------X---X-|---XXXXX-----
---------------------------------------------------------------------------------------------------------------------------------------------------|-|XX----------------------------------|--XXX-XXX---v
---------------------------------------------------------------------------------------------------------------------------------------------------|-|XXXX-----------------------------o--|-XXXX-XXXX--f
--------------------------X----------------------------------------------------------------------------------------------------------------------B-|-|XXXX--------------------------------|XXXXXBXXXXX-f
----------------------X----------------------------------------------------------------------------------------------------------------------------|-|XXXXX-------------------------------|XXXXX-XXXXXXf
-----------------XX--------------------------------------------------------------------------------------------------------------------------------|-|XXXXXX---------------B------------XX|XXXXXXXXXXXXf
---------------------------------------------------------------------------------------------------------------------------------------------------|T|XXXXXXX------------------X-------XXX|XXXXX-XXXXXXf
------------------------------------------------------------------------------------------------------------------------------------------------B--|||XXXXXXXX----------------XX------XXTX|XXXXX-XXXXXXf
m---------------------------------------------------------------------------------------------------------------------------------------------E----|||XXXXXXXXX------------B-XXX----BXXX|X|XXXXX-XXXXXXX
XXXXXXXXXXXXXXXXXXXXXXXXXXXXXXXXXXXXXXXXXXXXXXXXXXXXXXXXXXXXXXXXXXXXXXXXXXXXXXXXXXXXXXXXXXXXXXXXXXXXXXXXXXXXXXXXXXXXXXXXXXXXXXXXXXXXXXXXXXXXXXXXXX-|||XXXXXXXXXXXXXXXXXXXXX-XXXXXXXXXXXX|X|XXXXXXXXXXXXX
