-----------------------------------------------------------------------------------------------------------------------------X--------------------------------------------------------------------------
----------X---------------------------------------------------------------------------------------o--------------------------------B-----------------------------------------------------------------o--
----X---------------------B----------------------------------------------------------------------------------------------------------X------------------------------------------------------------------
---------------X----------------------------------------------------------------------------------------------------------------------------------------------------------------------------------------
------------------------------------------------------------------------------------------------------------------------------?--------------------o----------------------------------------------------
---------------------------------------------------------------------------------------------------------------------------------------------------------------------------------------B----------------
------------------------------------------------------------------------------------------------------------------------------BBBBBBBB------------------------------------------------------------------
----------------------------------------------------------------------------------------------------------------------------------o--------B-----------------------------------------------------------v
-----------------------------------------------------------------------------------------------------------X-------------------------------------------------------------------------------------------f
-----------------------X----------------------------------------------------------------------------------XX----------------XXXX--------X---------------------------------------------X----------------f
---------------------------------------------------------------------------------------------------------XXX-------------------------------------------------------------------------------------------f
-----X--------------B---X-------------------------------------------------------------------------------XXXX---------------------------------------B----------------------------------------X----------f
---------B---------X-X---------------------------------------------------------------------------------XXXXX------T-------------------------------------o-B-----X---------------------------XX----X----f
--------------B---------------------------------------------------------------------------------------XXXXXX---X--|-T-----------------------------------------------------------------------XXX--XXB---f
m----------------------------------------------------------------------------------------------------XXXXXXX---XX-|-|-------------B-------------------E-------------------------E-----------XXXXXXX----X
XXXXXXXXXXXXXXXXX--X----XXXXXXXXXXXXXXXXXXXXXXXXXXXXXXXXXXXXXXXXXXXXXXXXXXXXXXXXXXXXXXXXXXXXXXXXXXXXXXXXXXXXXXXXXX|X|XXXXXXXXXXXXXXXXXXXXXXXXXXXXoXXXXXXXXXXXXXXXXXXXXXXXXXXXXXXXXXXXXXXXXXXXXXXXXXXXXXX
