-------------------------------------------------------------------X------------B-------X-------------------?-----B----BXXXXXX------------------------------?B---?--------XXXX--------------------------
---------------------------------------------------------------------------------------------------MX-------------X-------BBBBBBBBBXBBX-------------------X--------------------X----------------B-------
------------------------------------------------------------------------------o-----------------------X--X--------------------------??????---B---------------------B---------------------X--------------
------------------------------------------------------------B-------------------------X---------X--X-------X-------------X-------------o--BX-o---------------X-X----B--------X--T-----------------------
-T-------------------------------------------------------------B---------------------X-----X-T-----X-X-------XX-B---------TB-BX---X---------------X-----?-----X----------B------|------------X--B----X--
-|-----------------------------------------------------------------------------X-------------|-----------T-------------B--|-BXX-B--X------BBBB---X------------XB--BM-B----B--X-T|------BBBBBBB----------
-|--------------------------------------------------------------------------------------B----|-B-o--X---X|----B---X--XT---|-XXXXX-----B-T----??-XX-X----------XXX--?X-------XX-||-------X----------X----
-|-------------------------------------------------------------------------------------------|----------X|------------|X--|XXXXT--M-----|X-----XXX---B--B-----XXX----------XXX-||-------XX-------------v
-|---------------------------------------------------------X-T------B------------------------|---------XX|X?-----X-X??|XX-|XXXX|---BBX-?|?????XXXX----M-X-B---XXXXXX-XX---XXXX-||-TB-BX-TXX-XX---M-----f
-|--------------------------------------------B--------------|-------X-----------------------|----------X|XX--T--XXXX-|XXX|XXXX|-----X--|----XXXTXBX---------BXXXXX--XXX-XXXXXB||X|-----|XXX-----------f
-|-----------------------------------------------------------|------XX-----------B-----X---X-|-------X--X|XXX-|B-XXXXX|XXX|XXXX|----X-TX|---XXXX|TXXX-------?-XXXXTX-XXXXXXXXX-||X|----B|XXXX---------Xf
-|-----------------------------------X---------------------B-|-----XXX-----------------------|----------X|XXXX|--XXXXX|XXX|XXXX|--B--X|-|-XXXXXX||XXXX------o-XXXX|XXXXXXXXXXX-||X|-B---|XXXXX--------Xf
-|----------------------------------------------------X------|----XXXX-----------B-----------|--B-------X|XXXX|--XXXXT|XXX|XXXX|-----X|-|BXXXXXX||XXXXX-X-----XXXX|XXXXXXXXXXXX||X|--B--|XXXXXX-------Xf
-|-----------------------------------------------------------|---XXXXX-----------------------|------X---X|XXXX|X-XXXX||XXX|XXXX|-----X|X|XXXXXXX||XXXXXXXTX---XXXX|XXXXXXXXXXXX||X|-----|XXXXXXX-o----Xf
m|---------------------------------------------------------B-|-EXXXXXX----------------E---X--|--------EoX|XXXX|XXXXXX||XXX|XXXX|---B-X|X|XXXXXXX||XXXXXXX|--X-XXXX|XXXXXXXXXXXX||X|-----|XXXXXXXX----XXX
X|XXXX------XXXXXXXXXXXXXXXXXXXXXXXXXXXXXXXXXXXXXXXXXXXXXXXXX|XXXXXXXXXX--------XXXXXXXXXXXXX|XXXXX-----X|XXXX|XXXXXX||XXX|XXXX|-XXXXX|X|XXXXXXX||XXXXXXX|--X-XXXX|XXXXXXXXXXXX||X|XXXXX|XXXXXXXXXX-XXXX
