--------------------------------------------------------------------------------------------------------------------------------------------------------------------------------------------------------
-----------------------------------------------------------------------------------------------------XXXXXX---------------------------------------------------------------------------------------------
---------------------------------------------------------------------------------------------------BBBB-------------------------------------------------------------------------------------------------
-B-------------------------------------------------------------------------------------------------------------------------------????-------------------------------------------------------------------
--------------------------------------------------------------------------------------?----XXXXXX----------------XXX------------------------------------------------------------------------------------
----------------------------------------------------------------------------------------B--------------????---------------------------------------------------------------------------------------------
--------------------------------------------------------------------------------------------------------------------------------------------------------------------------------------------------------
-BBBBBBB----------------------------------------------------------------------------------???????------------------------------------------------------------------------------------------------------v
-----------------------------------------------------------------------------------------------------------????????------------------------------------------X-----------------------------------------f
-------------------------------------------------------------------------------------------------XX---------------------------------XXXX---------------------------------------------------------------f
------------------------------------------------------------------------------------------------------------------------------------------------------------------------------???????------------------f
-----------------------------------------------------------------------------------T-----------------------XXXXXXXo------------------------------------------------------------------------------------f
-----------------------------------------------------------------------------------|-------------------------------------------------------------------------------------------------------------------f
-----------------------------------------------------------------------------------|------------BBBBB--------------------------------------------------------------------------------------------------f
m----------------------------------------------------------------------------------|--EE---------------E----------------------------------------E------------------------------------------------------X
XXXXXXXXXXXXXXXXXXXXXXXXXXXXXXXXXXXXXXXXXXXXXXXXXXXXXXXXXXXXXXXXXXXXXXXXXXXXXXXXXXX|XXXXXXXXXXXXXXXXXXXXXXX-XXXXXXXXXXXXXXXXXXXXXXoXXXXXXXXXXXXXXXXXXXXXXXXXXXXXXXXXXXXXXXXXXXXXXXXXXXXXXXXXXXXXXXXXXXXX
