---------------------------------------------------------------------------------------------------------------------------------------o-XXX-----X-B-----X--------?BX----BBX-----?-o--------------------
--B---------------------------------------------------------------------------------------------------------------------------------------------------??X????----X---------XXXXXXXX-BM--XXXXXXXX--------
--------------------------------------------------------------------------------------------------------------------------------------------------------X--------X----------M--X----X-------------B-----
-----B----------------------------------------------------------------------------------------------------------------------------------------------------???-------T-----X------------B----------------
-----B---------------------------------------------------------------------------------------------------------X------------------------------------X---------BX--X-|--XX---------BX-----------XTXXXXXX-
----------------------------------------------------------------------------------------------------X-----------------------------------B-----o-----B-----------XX--|--XX-T----T--B-B-----------|X---XX-
-----------------------------------------------------------------------------------------------------------------------------------------X--------B--------?----X---|-XXX-|---X|---MX-TB--------|-X---X-
----------------------------------------------------------------------------------------------------------------------------------B----o------------T--TB-??X-----B-|XXXX-|----|---X--|--B-o----|XX--XXv
--------------------------------------------------------------------------------------------------------X-------------------------------------------|--|----XX-X--BB|XXXX-|--B-|------|-X-------|XX-XXXf
---------------------------------------------------------------------------------------------------------------------------------------------X------|-B|---BXXX--o-X|XXXX-|-X--|------|X---X---X|XXXXXXf
----------------------------------------------------------------------------------------------------------------------------------X-------X--XX-----|--|?X--XXXX-oXX|XXXX-|-XX-|------|-------XX|XXXXXXf
----------------------------------------------------------------------------------------------------------------------------------------T----XXX----|-X|----XXXXXXXX|XXXX-|-XXX|------|---B--XXX|XXXXXXf
----------------------------------------------------------------------------------------------------------------------------------------|X--XXXXX---|-B|---XTXXXXXXX|XXXXX|XXXX|--BB--|-----XXXX|XXXXXXf
----------------------------------------------------------------------------------------------------------------------------------------|---XXXXTX--|--|-XXX|XXXXXTX|XXXX-|-XXX|XBoT--|X--TXXXXX|XXXXXXf
m----------------------------------------------------------------------------------------------------------------------------------EE---|E--XXXX|XX-|-E|-XXX|XXXXX|X|XXXX-|EXXX|XX-|--|-E-|XXXXX|XXXXXXX
XXXXXXXXXXXXXXXXXXXXXXXXXXXXXXXXXXXXXXXXXXXXXXXXXXXXXXXXXXXXXXXXXXXXX?XXXXXXXXXXXXXXXXXXXXXXXXXXXXXXXXXXXXXXXXXXXXXXXXXXXXXXXXXXXXXXXXX-|XXXXXXX|XXX|-X|XXXX|XXXXX|X|XXXXX|-XXX|XXX|-X|--X|XXXXX|XXXXXXX
