------------------------------------------------------------------------------------------------------------------------------------------------------------------------------------------------XXXXXX--
--------------------------------------------------------------------------------------------------------------------------------------------------------------------------------------------------------
--------------------------------------------------------------------------------------------------------------------------------------------------------------------------------------------------------
-------X------------------------------------------------------------------------------------------------------------------------------------------------------------------------------------------------
--------------------------------------------------------------------------------------------------------------------------------------------------------------------------------------------------------
--------------------------------------------------------------------------------------------------------------------------------------------------------------------------------------------------------
--------------------------------------------------------------------------------------------------------------------------------------------------------------------------------------------------?-----
-------------------------------------------------------------------------------------------------------------------------------------------------------------------------------------------------------v
-------------------------------------------------------------------------------------------------------------------------------------------------------------------------------------------------------f
------------------------------------------------------------------------------------XXXXX---------------------------------------------------------------------------------------------------------o----f
-----------------X-------------------------------------------------------------------------------------------------------------------------------------------------------------------------------------f
----------------XX----------------------------------------------------------T--------------------------------------------------------------------------------------------------------------------------f
---------------XXX----------------------------------------------------------|--------------------------------------------------------------------------------------------------------------------------f
--------------XXXX----------------------------------------------------------|------------------------------------------------------------T-------X-----------------------------------------------------f
m------------XXXXX----------------------------------------------------------|------------------------------------------------------------|-------XX----------------------------------------------------X
XXXXXXXXXXXXXXXXXXXXXXXXXXXXXXXXXXXXXXXXXXXXXXXXXXXXXXXXXXXXXXXXXXXXXXXXXXXX|XXXXXXXXXXXXXXXXXXXXXXXXXXXXXXXXXXXXXXXXXXXXXXXXXXXXXXXXXXXX|XXXXXXXXXXXXXXXXXXXXXXXXXXXXXXXXXXXXXXXXXXXXXXXXXXXXXXXXXXXXXX
