B------B--oB---------Bo--------o------oX--------B------B----X-B-------o----------o-----T--------------XX--Xoo--------------o-o-----oo---B--o----------X---------Bo-o-----o------oo--o----B-------B--o---
---o---oo---o------------B-o-o-oB-----BB-o--------------------------------------B------|----o-o---B--X-------------o----o------B------oX--B--BB----o-------------------o----Bo-B---------o---T----------
-o---Bo-------B-BX--------------oX-oo-X-o----oo---Bo----X---o--------------B-B-------o-|------o---o-------------------o-XX---X--o--------------o---------o-----------o--E--X------oB-oB-B?---|----------
XX-B-B-o----o-----------------o-------o----o-o-X--------o-------B-B------B--BB----oooo-|--------o-------B--o-o-X-----------------Bo-o----------------BB-------o----B----X------o-----o-B-----|-------B-o
--X--o------oB----Xoo--------B-X---------T----B-B-----------oB--------o----------o-----|--------------------------o--B----o--o----oB--E---B----------o--o----o---B---o--oB-o--B---Xo---------|---Bo-X-o-
-----------------B--Xo---o-------------B-|-o---------B-X---B------------o--o--------oo-|------o--B-B-----B--o---o-o-----B-o--o----o--BX--o---o---B--------Bo-----o--------B---------B--o-----|------?-B-
--------B----X---------o-X---B---o-oB----|-oB---B-B--X-----B---o--------oX---o-o-o-----|---------oB--B-X-----Xo-o-----------------------o---oB-----------Xo------------o--o--o------------o--|--B-X----B
-------Xo--o--B----------E---------------|-----------o-oXoo-o------?--X-B---o-o--------|--oo--o---X---------X--------o-B--o-------------------B---o----X---Bo-----o-------o--Xo----o-o--oB---|--oEB----v
B---o-----T--X----oo-----BT----------B-o-|---o----------oo---------------------oB-o----|-BBB----oo-o-------oB-o---------------o-------------------?-?-X-X----o---B-o--E-o--o--o---------o----|---XB---of
----------|---X----------B|-BX-------Bo--|-----o-X----------o-o---------o-------o--BT--|---o-o---E--------------X-o--o-----------B--T-o--------------------o-B-----oo-B-----o-o-X------o-----|---------f
-----B----|---------------|--------o-----|---B-B-------X---------o--X-------------X-|--|---o-----X-o----------?-----B---------------|------------X--o-oB-B-------o---o------o--B-o-o----B----|-X-----Bof
o---B-----|-oB----B--o----|-----B----?X--|--B--------o---------B---B----XB---------B|--|-o-B-B-------oT------o-----o---o------X-B-B-|--Xo-o------o---oB-----B-----X--B--X--B---o-----XX------|--o------f
B--B-B-BX-|----------o----|---------o-X--|--B----E------X-X---X---------------------|--|----B---------|---oo---o--X-----o-------X-B-|-o-------------X------BX---B---oB-----XX-B-o------B-----|-----X---f
o---------|---o----B------|-o---o----?---|---o---X----------o-----BB---B---oo-----B-|--|--B-o---------|-X-o---o---------B-B-o---BE-o|--o--oo--o-o-o----X----o-----o---X----X--------o--B-----|---o---o-f
moE--oXo--|---o--B---X----|--oo-------o--|-----E---o----B-o---X----o------X----oB---|--|--B--X--------|-------o----------o---o-o-BX-|-BX-------------o--o---o--B--o--------------Xo--o-------|--------oX
XXXXXXXXXXXXXXXXXXXXXXXXXXXXXXXXXXXXXXXXXXXXXXXXXXXXXXXXXXXXXXXXXXXXXXXXXXXXXXXXXXXXXXXXXXXXXXXXXXXXXXXXXXXXXXXXXXXXXXXXXXXXXXXXXXXXXXXXXXXXXXXXXXXXXXXXXXXXXXXXXXXXXXXXXXXXXXXXXXXXXXXXXXXXXXXXXXXXXXXX
