X---o-----BBo--B---o--oX---------B------------B-------------------------B-X-X---Xo---------X-------B------------------XBX---B----o-------------------------B---------------BB--oo-o---------T----o------
-B---o-X-o--B-------o--o-B----------B---oB----o-----------------B---o-----B-B--XX--X---o------XBX------o----------------------B--oo------------------o-XB--------B----o------BB--X----------|-------o---
--B-----o-o-----B-o-B-BoX-X-Xo--------------------oo---B----o--------o-----o-oo-oB-o-o-X--B--B--B--o--------------E---o----o------------X---B-B----X---------X---o-----------Bo-o--BoB-X----|-----------
X-----BB------Xo---X-XB---X-o-o----X-------oB----------X-------o--o---B---o----------o---------B-o-------------------BB------B-----X-------?--------------------B----X-----------o----Bo----|-oB--------
-----------oB-oo-----X-o-------o--o-o----BB--o-----o-o-------ooo----B-B---o----------o----B-B---o----o-----------------o-----Eo---B-o-B----B-----B-----o-BX----o-------B--X------Bo----BoB-B|----B-XB---
-T-B----o-----oXo-----B--------o---X--------Bo--------o--B-----------------B-oX-Bo-----oooo--------B---------o-----------o-------oo--B---B--E-B----oo-----------o---X------o----B-X---------|--oT-----o-
B|-------------------Boo-------X-X-BX-------B-o--o---B-oo-B---o--oB-------o----------------------B----B-o---Xo--o--o---------BX------o----oB----o-----o-o------BoBB--B-------o-----o--------|---|---o---
-|----------B------o---BB----B------B---------o-----------B---B-----------XX-----B---------o---o-o--------------------B--------B--B---o-------------o--B----o--o-------------o------B---X---|---|------v
B|--------B--T----------------------E-------M--o------o----o------X---oo-----o--------------B-X----------------------o-----B-----o-oo-oB--------------X-oX----------B----------------o-Xo-oX|---|------f
-|--B-o---B--|----------Bo-------E---------o-X---------------------X-B-B-o-------------o-B-B----B-B------B---B-----B-------o--BX-o----o--------BoB--XX-----B-o-------X-Bo--o-o------X-----o-|-oB|------f
o|-----------|--X---------o-oo------X----X--------------B-o--BBo---------------B------X---------------o----BX----------B-----------o--o--oo-----BEE---Xo----B-----o---------o----o--B-----B-|---|--BX--f
-|-o-------Xo|--------o-B--o------o-----o----o--------B--o--------o-B-------Bo------------o---o-B--X-oB---B---B----------------------------o-----------------B-------B--------------------o-|---|------f
-|-oo------o-|-o-B-----------------B-------X---B---------o-X---------X------B---E-X--E----oo------------B----BT---B--Xoo------------------------o--B---o----------X---------B-B---o---o-B-Bo|--B|---B--f
-|-oXB------o|--X-o------o----------o--BB------------------oE-B-----------o--B---o--B---EE-----B-----------Bo-|-----B-Bo--------X--T-----ooo----B--B------o------------------------o-oo-oBB-|---|---B--f
m|--E-B------|-o----E---B--XB----Boo-B-oX----oB----------oo---B--B---------------B-o--B-o---o--E---o-o--X---o-|-o---o-oB---o-------|-B----o----o--E---------o--B-o--E-----B-X------o-------o|-B-|-------
XXXXXXXXXXXXXXXXXXXXXXXXXXXXXXXXXXXXXXXXXXXXXXXXXXXXXXXXXXXXXXXXXXXXXXXXXXXXXXXXXXXXXXXXXXXXXXXXXXXXXXXXXXXXXXXXXXXXXXXXXXXXXXXXXXXXXXXXXXXXXXXXXXXXXXXXXXXXXXXXXXXXXXXXXXXXXXXXXXXXXXXXXXXXXXXXXXXXXXXX
