--------------------------------------------------------------------------------------------------------------------------------------------------------------------------------------------------------
------------XXXXXXX--------------------------------------------------------------------------------------------------------------------------------?????-----XXXXXXXX-----------------------------------
------BB--XXXX-------------------------------------------------------------------------------------------------------------XXXXXXX----------------------------------------------------------------------
----------------???????-----XXXXXX---------------------------------------------------------------------------------------------------------BBBBB--------------------------------------------------------
-----------------------------------------------------------------------------------------------------------------------------------------------------------------------???------------------------------
--------------------------------------------------------------------------------------------------------------------------------------------------------------------------------------------------------
--------------------------------------------------------------------------------------------------------------------------------------------------------------------------------------------------------
----------------XXXX---------------------------------------------------------------------------------------------------------------------------BBBBBB--------------------------------------------------v
-----------?----------------------------------------------------------------------------------------------------------------------------------------X--------------------------------------------------f
-------------------------------------------------------------------------------------------------------------------------------------------------------------------BBBBBB------------------------------f
----------------------------------------------------------------------------------------------------------------------------------------?????-----------------------------------------??????-----------f
------------------------------------------------------------------------------------------------------------------------------------------------------X------------------------------------------------f
------XXXXXXXX----------------------------------------------------------------------------------------------------------------------------------------XX--????-----------------------------------------f
--------????????--------------------------------------------------------------------------------------------------------------------------------------XXX----------------------------------------------f
m-----------------------------------------------------------------------------------------------------------------------------------------------EM---?XXXX------BBBB-----------------------------------X
XXXXXXXXXXXXXXXXXXXXXXXXXXXXXXXXXXXXXXXXXXXXXXXXXXXXXXXXXXXXXXXXXXXXXXXXXXXXXXXXXXXXXXXXXXXXXXXXXXXXXXXXXXXXXXXXXXXXXXXXXXXXXXXXXXXXXXXXXXXXXXXXXXXXXXXXXXXXXXXXXXXXXXXXXXXXXXXXXXXXXXXXXXXXXXXXXXXXXXXX
