-------------------------------------------------------------------------------------------------------------------------------------------B-----------------------X----B--------------------X---B------
--------------------------------------------------------------------------------------------------------------------------------------------------------------------------------------------------------
------------------------------------------------------------------------------------------------------------------------------------------------------B------------------o----B--------------------B----
------------------------------------------------------------------------------------------------------------------------------------------------------------------------------------X-------------------
-------------------------------------------------------------------------------------------------------------------------------------------------------------------------------X-----------X------------
------------------------------------------------------------------------------------------------------------------------------------------------------------------------------------B-------------------
-B----------------------------------------------------------------------------------------------------------------------------------------------------------X--------------------------------X-X--------
-----------------------------------------------------------------------------------------------------------------------------------------------------------------------B--M------------------B---B-----v
---------------------------------------------------------------------------------------------------------------------------------------------------------------------------X---X----B--------B---------f
-B-----------------------------------------------------------------------------------------------------------------------------------------------------------------------------------------------------f
---------------------------------------------------------------------------------------------------------------------------------------------------------------------------B----------X--------------X-f
---------------------------------------------------------------------------------------------------------------------------------------------------------------------------------------X---------------f
-------------------------------------------------------------------------------------------------------------------------------------------------o--------------X--------------------------------------f
------------------------------------------------------------------------------------------------------------------------------------------------------B-------------------------------?------------B---f
m------------------------------------------------------------------------------------------------------------------------------------------------------------E----------------------E---M-------E------X
XXXXXXXXXXXXXXXXXXXXXXXXXXXXXXXXXXXXXXXXXXXXXXXXXXXXXXXXXXXXXXXXXXXXXXXXXXXXXXXXXXXXXXXXXXXXXXXXXXXXXXXXXXXXXXXXXXXXXXXXXXXXXXXXXXXXXXXXXXXXXXXXXXXXXXXXXXXXXXXXXXXXXXXXXXXXXXXXXXXXXXXXXXXXXXXXXXXXXXXX
