--------------------------------------------------------------------------------------------------------------------------------------------------------------------------------------------------------
----------------------------------------------------o---------------------------------------------------------------------------------------------------------------------------------------------------
--------------------------------------------------------------------------------------------------------------------------------------------------------------------------------------------------------
--------------------------------------------------------------------------------------------------------------------------------------------------------------------------------------------------------
--------------------------------------------------------------------------------------------------------------------------------------------------------------------------------------------------------
-------------------M-----------------------------------------------------------------------------------X------------------------------------------------------------------------------------------------
---------------------------------------------------------------------------------------------------------X----------------------------------------------------------------------------------------------
--------------------------------------------------------------------------------------------------------XX---------------------------------------------------------------------------------------------v
-------------------------------------------------------------------------------------------------------XXX---------------------------------------------------------------------------------------------f
------------------------------------------------------------------------------------------------------XXXX---------------------------------------------------------------------------------------------f
-----------------------------------------------------------------------------------------------------XXXXX---------------------------------------------------------------------------------------------f
----------------------------------------------------------------------------------------------------XXXXXX---------------------------------------------------------------------------------------------f
---------------------------------------------------------------------------------------------------XXXXXXX---------------------------------------------------------------------------------------------f
--------------------------------------------------------------------------------------------------XXXXXXXX---------------------------------------------------------------------------------------------f
m--------------------------------E----------------------------------?----------------------------XXXXXXXXX--------------------E--------------------E---------------------------------------------------X
XXXXXXXXXXXXXXXXXXXXXXXXXXXXXXXXXXXXXXXXXXXXXXXXXXXXXXXXXXXXXXXXXXXXXXXXXXXXXXXXXXXXXXXXXXXXXXXXXXXXXXXXXX--------XXXXXXXXXXXXXXXXXXXXXXXXXXXXXXXXXXXXXXXXXXXXXXXXXXXXXXXXXXXXXXXXXXXXXXXXXXXXXXXXXXXXXX
