--------------------------------------------------------------------------------------------------------------------------------------------------------------------------------------------------------
------------------------------------------------------------------------------------------------------------------------------------------------------o-------------------------------------------------
-------------------------------------------------------------------------------------------------------------------------------------------------------------------XXXXX--------------------------------
--------------------------------------------------------------------------------------------------------------------------------------------------------------------------------------------------------
--------------------------------------------------------------------------------------------------------------------------------------------------------BBBB--------------------------------------------
---???????------------------------------------------------------------------------------B---------------------------------------------------------------------------------------------------------------
--------------------------------------------------------------------------------------------------------------------------------------------------------------------------------------------------------
----------------------------------------------------------?--------------------------------------------------------------------------------------------------------------------------------------------v
-------------------------------------------------------------------------------------------------------------------------------------------------------------------------------------------------------f
-------------------------------------------------------------------------------------------------------------------------------------------------------------------------------------------------------f
-------------------------------------------------------------------------------------------------------------------------------------------------------------------------------------------------------f
----------------------------------------------------------------------------------------------------------------T--------------------------------------------------------------------------------------f
----------------------------------------------------------------------------------------------------------------|--------------------------------------------------------------------------------------f
----------------------------------------------------------------------------------------------------------------|--------------------------------------------------------------------------------------f
m-----------------------------------------------------------------?--X------------------------------------------|---------------------------------------E-------------E-----------E------???--E--------X
XXXXXXXXXXXXXXXXXXXXXXXXXXXXXXXXXXXXXXXXXXXXXXXXXXXXXXXXXXXXXXXXXXXXXXXXXXXX--------XXXXXXXXXXXXXXXXX--------XXX|XXXXXXXXXXXXXXXXXXXXXXXXXXXXXXXXXXXXXXXXXXXXXXXXX--XXXXXXXXXXXXXXXXXXXXXXXXXXXXXXXXXX-X
