--------------------------------------------------------------------------------------------------------------------------------------------------------------------------------------------------------
--??---------------------------------------------------------------------------------------------------XXXX---------------------------------------------------------------------------------------------
----------------------------------------------------------------------------------------------------------??--------------------------????--------o-----------------------------------------------------
-------------------------------------------------------------------------------------X---------------------???????--------------XXXXXX------------------------------------------------------------------
--------------------------------------------------------------------------------------------------------------------B-----------------------------------------------------------------------------------
-----------------------------------------------------------------------------------------------------------------------------------------------------------------------XXXXXX---------------------------
------------------------------------------------------------------------------------------------------------------------o------------X------------??????------------------------------------------------
-------------------------------------------------------------------------------------------------------------------------------o-----------------------------------------------------------------------v
-X--------BBBBBBBB--------------------------------------------------------------------------------------------------------XXXXXXX----------------------------------------------------------------------f
-----o--------------------------------------------------------------------------------------------------------------------------------------------------??---------------------------------------------f
---------------------------------------------------------------------------------------------------------------------------------------------XXXXXXXX--------------------------------------------------f
----------------------------------------------------------------------------------------------------------------------?----XX--------------------------------------------------------------------------f
--T------?---------------------------------------------------------------------------------------------------------------XX----------------------------------------------------------------------------f
--|----X---------------------------------------------------------------------------------------------------XXXXX----------o--B----BBBBBBB-------------------------------T----X--------------T---T------f
mE|-----X-------------------------------------------------------------------------------------------------------???????-------XXXXX---------------X---E-----------------|---XX--------------|---|------X
XX|XXXXXXXXXXXXXXXXXXXXXXXXXXXXXXXXXXXXXXXXXXXXXXXXXXXXXXXXXXXXXXXXXXXXXXXXXX--XXXXXXXXXXXXXXXXXXXXXXXXXXXXXoXXXXXXXXXXXXXXXo-----XXXXXXXXXXXXXXXXXXXXXXXXXXXXXXXXXXXXXX|XXXXXXXXXXXXXXXXXXX|XXX|XXXXXXX
