-----------------------------------------X-------------------------------------X---B--------------------X--BB--------X---------M----------------------------------------------------------M-------------
-----------------------------------------------------------------------M--------------------------B--X?------M-----B--M----M---------B---------------------X----------B----BBBBBBBX------B--------------
---------------------------------------------------------------------------------------------X------X----------------B-------------------------------------X----------?--------------B------------------
-------------------------------------------------------------------------------------------------TB-o-B----B?---------------B--B------------------------------------------------------------------------
------B-----------------------------------------------------------------------------------------B|---o----T--X----------X----BBT-X--X--------------????????--------------------------------B------------
-----M-----------------------------------------------------------B---------------X------------o--|-----T--|-XX---------XX--B-MB|--------------------------------------------------------------------X---
-----------------------------------------o----------------------------------------oB--T----------|-XXXX|XX|XXX-----BBBXXXB-----|---------------?-----B---------------B------------------------------XXX-
---------------------------------------------------------------------------------X----|---------X|-----|--|XXXX?----XXXXT------|---X??????X----X---------------------?---------------------B-----------v
--------------------------------------------------------------------------------------|---B--XXTX|X--B-|BX|XXX------XXXX|------|-----B--------XX------------X-----------------B------------------------f
--------------------------------------------------------------------------------------|-----X--|-|-----|XX|XXX-----XXXXX|BB----|------X------XXX---X--T------B--------X--------------X----?------------f
--------------------------------------------------------------------------------------|-----XX-|X|-----|XX|XXX----XXXXXX|--X---|-------Bo---XXXX---XX-|--------------XX----------------------???????---f
--------------------------------------------------------------------------------T-----|-----XXX|-|--BXX|XX|XXXX?MXXXXXXX|--XX--|-----------XXXXXX--XXX|-------X-----XXX--------------------------------f
------------------X-------------------------------------------------------------|-----|-----XXX|-|---TX|XX|XXXXXXXXXXXXX|--XXX-|-------X--XXXXXX---XXX|--XBXo--XB--XXXX---------------XB---------------f
--------------------------------------------------------------------------------|-----|-----XXX|X|--X|X|XX|XXXXTXXXXXXXX|--XXXX|-----o---XXXXXXX---XXX|X----X-XX--XXXXX--------------------------------f
m----E------------------------------------E-------------------------------------|-----|-----XXX|X|-XX|X|XX|XXXX|XXXXXXXX|-EXXXX|X---o--EXXXXXXXX---XXX|XX----XXX-XXXXXX---------------E----------------X
XXXXXXXX----XXXX------XXXXXXXXXXXXXXXXXXXXXXXXXXXXXXXXXXXXXXXXXXXXXXXXXXXXXXXXXX|XXXXX|XXXXXXXX|X|XXX|X|XX|XXXX|XXXXXXXX|--XXXX|XXXXXXXXXXXXXXXXXXXXXX|XXXXXXXXXXXXXXXXXXXXXXXXXXXXXXXB----X------XXXXXX
