-X--------oo----B-----------o--Bo--o----B---------o-----XX-----o-----B-o------------B----o--------X-----o-----Xo--B-----------B----B--oo---o----o----------o------o--o-BBBo----------XB-----------o-----
-----------B-------o------oX-------------o----B----o----------B-----------------B-X----B?----o---------B----------------o--o---------B--o-E-----B--X---X----E-------X----X--X-----o-o------B--oooB-o--B-
-----o-X-B----o-------------o-----o-----------o--X-ooB-o--------o-o--X----------Bo--X----o------o---------o---o-B--------o---B-o----o-----B-----B-----------B---B-Bo-----T-----------------Booo-B-------
X--Xo--X-------------B----o-Xo-X--Bo------X---B----------E-----o--oXo--------o--X----o-----B------B----X-----oX---X-B-------X-X------------B--------o------BB----------X-|-B-----oo-----o---------------
B-------B--o------o-o-B---------------BB--------o--------X--B----B---------B-o-X--------o-X-----------B-o-----o------------o---o----B--------X---o--B-----Bo-------------|----------B--ooE-X-o-----BX---
-Xo-----E-X---X------o---B------T----T--o----------------oB---o----o-----B-------------------X-o--o---E-B-------B--o------B-o--X--o------XB-o------------?-X---------X---|-B-------------X---oo-----o---
--------X--------------B-o------|----|--BX----B----B-----B-----X-----o-------B-----XB--B------oo----o-B--X--------------o-BB--------T--B------BE--o--------o---------B-X-|----o-------o--B---------X-B--
---o------B-----X--X------o--X--|---B|------X------B--o-B-----------------BX--X------Xo--------X----X--------B---o-------B---------o|-o------o-X---------------o---------|---o-------X-B-------o-------v
B-X-B--Xo-X-E-----B--o--ooE--o--|----|------X--oB--Bo-oo-----BX-----oooo------o----------Bo-------o--o-----o-----o-----Xo----o-B--B-|-------o-o----oo---oo-Bo-o-o-o----o-|--------o-X-----B-X-X--------f
---------o--B-oo--B-BB----Bo--B-|----|------------------o--------XB-----B-o------o-----B-----B-----------o---------Bo--oo--B-----B--|------------------------------oBoBo-|-------o----------oB-------B-f
o--o-B-----B------o------?X-----|----|--o---o--B--------o---B--o------o--o------BXoo----------o---o-B--X-------------------o--B--oB-|------o-------X-X----oB---oB--------|----o---------o-----o--------f
-------X----B-------------------|----|-----oB--------B------oo---B-----------B-------------o----------------------B-----------------|--o---------X-o-----o-o-------------|-----o-XB--o---------B-o-----f
----------X-----oBB---o-o---Xo--|----|---?------o-o---B---o-------o------B----o---------B----o-o------?-----------Bo--BBo--B---B----|---X------o-------------X-----o-----|--Bo--------o--------o---BoX-f
---X---B---------o----oB--------|----|--X-o-X----B---oB-----------B----B-o--Bo-T--------------------------X-B--o-----------E----Bo--|-B---------B----oB-----------B----B-|---o-o---------------T--B----f
mo----Eooo-E--E-B-Bo-oBEB-BX-oE-|----|----o-------o----o-------B-----o--o--ooBo|--B---E---o------oB--o------------o---B----B-----X--|--E---B----E-oo-----------X---------|-----B---------------|-------X
XXXXXXXXXXXXXXXXXXXXXXXXXXXXXXXXXXXXXXXXXXXXXXXXXXXXXXXXXXXXXXXXXXXXXXXXXXXXXXXXXXXXXXXXXXXXXXXXXXXXXXXXXXXXXXXXXXXXXXXXXXXXXXXXXXXXXXXXXXXXXXXXXXXXXXXXXXXXXXXXXXXXXXXXXXXXXXXXXXXXXXXXXXXXXXXXXXXXXXXX
