--------------------------------------------------------------------------------------------------------------------------------------------------------------------------------------------------------
--------------------------------------------------------------------------------------------------------------------------------------------------------------------------------------------------------
--------------------------------------------------------------------------------------------------------------------------------------------------------------------------------------------------------
--------------------------------------------------------------------------------------------X-----------------------------------------------------------------------------------------------------------
--------------------------------------------------------------------------------------------------------------------------------------------------------------------------------------------------------
--------------------------------------------------------------------------------------------------------------------------------------------------------------------------------------------------------
--------------------------------------------------------------------------------------------------------------------------------------------------------------------------------------------------------
------------------------o------------------------------------------------------o------------------------T-----------------X----------------------------------------------------------------------------v
----T-----------------o---------------------------------------------------------------------------------|----------------------------------------------------------------------------------------------f
----|---------------------------------------------------------------------------------------------------|----------------------------------------------------------------------------------------------f
----|-?-----------------------------------------------------------------------------B-------------------|----------X-----------------------------------------------------------------------------------f
----|----------------------------------------------------------------------------------X-BT-------------|----------------------------------------------------------------------------------------------f
----|-------------------------------------------------------------------------------------|-------------|----------------------------------------------------------------------------------------------f
----|-------------------------------------------------------------------------------------|-------------|----------------------------------------------------------------------------------------------f
m---|------------------------------------------------------------E---------------------E--|-------E-----|----------------------------------------------------------------------------E-----------------X
XXXX|XXXXXXXXXXXXXXXXXXXXXXXXXXXXXXXXXXXXXXXXXXXXXXXXXXXXXXXXXXXXXXXXXXXXXXXXXX--------XXX|XXXXXXXXXXXXX|XoXXXXXXX-------XXXXXXXXXXXXXXXXXXXXXXXXXXXXXXXXXXXXXXXXXXXXXXXXXXXXXXXXXXXXXXXXXXXXXXXXXXXXXXX
