---------------------------------------------------------------------B-------------M---------M------M----------------------------------------------------------X----o-----------------------------------
-----------------------------------------------------------------------------------o-------------------------------------------------------------------------------------------------------M------------
-----------------------?---------------------------------------------------------????B?-----------------------------------------------------------------------------------------------------------------
-----------------------BBB-------------------------------------------------T---------------B------B-----------------------------------------------------------------------------------------------------
-------------------------------------------------------------------------T-|---------------------X-T-------BBBBBB-------------------------------------------------T------T----------------T-------------
---X-------------------------------------------------o-----------M----M--|-|--------M-X--XM---M-XX-|-------T------------------------------------------------------|------|----------------|-------------
---XX---------------------------------------------------------------T-M--|-|---TT----TXX-------XXX-|BBB----|--o---------------------------------------------------|------|-----?----------|-------------
---XXX----------------------------------T---------------T-----T-----|----|-|---||XT--|XXX-----XTXXX|XXT--BB|BB----------------------------------------------------|?-----|----------------|------------v
---XXXX---------------------------------|--------------o|?-T--|-----|-?-X|X|X--||X|?-|XXXX---XX|XXX|T-|----|---?------------------------------------------------X-|------|----------------|------------f
---XXXXX--------------------------------|---------------|XX|X-|-----|--XX|X|XX-||X|X-|XXXXX-XXX|XXX||-|X---|------B-----------------------------------------------|------|----------------|------------f
---XXXXXX-------------------------------|---------------|--|--|-----|-XXX|X|XXX||X|XX|XXXXXXXXX|TXX||o|XX--|------------------------------------------------------|------|----------------|------------f
---XXXXXXX------------------------------|---------------|XX|Xo|-X---|XXXX|X|XXX||X|XX|XXXXXXXXX||TX||X|XTX-|-----------B------------------------------------------|------|----------o-----|------------f
---XXXXXXXX-----------------------------|---------------|--|--|XT---|XXXX|X|XXX||X|XX|XXXXXXXTX|||X||X|X|XX|-X-----------------------------------------------B----|------|----------------|------------f
---XXXXXXXXX----------------------------|---------------|XX|X-|X|-XX|XXXX|X|XXT||X|XX|XXXXXXX|X|||X||X|X|XX|XX----------------------------------------------------|------|----X-----------|------------f
m--XXXXXXXXXX--E------------------------|---------------|E-|-X|X|XXX|XXXX|X|XX|||X|XX|XXXXXXX|X|||X||X|X|XX|XX-X???????------------------------------E---------EE-|------|-X--------------|----E-----E-X
XXXXXXXXXXXXXXXXXXXXXXXXXXXXXXXXXXXXXXXX|XXXX-------XXXX|XX|XX|X|XXX|XXXX|X|XX|||X|XX|XXXXXXX|X|||X||X|X|XX|XXXXXXX-----XXXXXXXXXXXXXXXXXXXXXXXXXXXXXXXXXXXXXXXX--|-----X|XXXX--XXX-----XX|XXXXXXXXXXXXX
