-----------------------------------------------X---------------------------M--------------------------------------------------------------------------------------------------------------------o-------
------------------------------------------X--------------------------------------------------------------------------o----------------------------------------------------------------------------X-----
----------------------------------------X--------------------------------------------------B--M----------------------------------------------------------------------------------------??B??------------
----------------------------------------------------------------------o------------------B-------------------------------------------------------------------------------------------T------------------
----------X-B-------------------------------------------------------------B---------XXXXX-------X------------------?-----------------------------------------------------------------|-------------X----
----------------------------------------------------------------------------------------B--------------------------------------------------------------------------------------------|------------------
----------------????????X-----------------------------------------------------------------B-----------B------------------------------------------------------------------------------|--------------o---
------------?---------------------------------------------------------------T--------------------------------------------------------------------------------------------------------|-----------------v
----------------------------------?--------------------------------------B--|----------------------------------------------------------------------------------------------------XXXX|XXX--------------f
-----------------------------------B----------------------------------------|Bo--------------------------------------B---------------------------------------------------------------|-----------------f
----------------B---------------??------------------------------------------|----------------BBBX------------------X-------------------------------------------------B---------------|-----------------f
----------------------X-----------------------------------------------------|------------XXXXXX--------------------------------------------------------------------X-----------------|-----------------f
----------B----------XX------X----------------------------------------------|--------?????-------------------------------------------------------------------------------------------|-----------------f
--------------------XXX-----------------------------------------------------|B-------------------B----------------------------------------------------------------------------------B|X----------------f
m-----------E------XXXX--E--------------------------------------------------|-----------E-B-------------------o----------------------------------------------------------------------|XX-----E---------X
XXXXXXXXXXXXXXXXXXXXXXX---------o--XXXXXXXXXXXXXXXXXXXXXXXXXXXXXXXXXXXXXXXXX|XXXXXXXXX-------?---BXX---XXXXXXXXXXXXXXXXXXXXXXXXXXXXXXXXXXXXXXXXXXXXXXXXXXXXXXXXXXXXXXXXXXXXXXXXXXXXXX|XXXXXXXXXXXXXXXXXX
