-----------------------------------------XX?--------------------------------XXXX-BB---------------------------------------------------------------------------------------------------------------------
------------------------------------X----XBBXXXBBBBBB-BBBB--------------------------------------------------------------B-------------------------------------------------------------------------------
---------------------------------BBBBBBBB----------------------------------BB---------------------------------------------------------------------------------------------------------------------------
--------------------------B-----------------???????--BBB--------XX---------------------------------????????---------------------------------------------------------------------------------------------
---------------------------BBBBBBB-----------------???----------------??--------------------------------------------------------------------------------------------------------------------------------
-----------------M------------------------------????????----------------------------------?--------------------------------------BBBB-------------------------------------------------------------------
---------------?????--------------------------X----XXXXXXX----------------------------------------------------------------------------------------------------------------------------------------------
--------------------------------BBBBBB--------------------------------------------------------B--------------------------------------------------------------------------------------------------------v
-------------M-----------------------------------------------------BBBBB------------------XXXXXXX------------------------------------------------------------------------------------------------------f
-----------------BBBBB---------------------------------------------------------------------------------------------------------------------------------------------------------------------------------f
-----------------------XXXX----------BBB-------------------BBBBBBB-------------------------------------------------------------------------------------------------------------------------------------f
-------o-------------B--XX---------------?B?????----------------------------T-----------------------o--------------------------------------------------------------------------------------------------f
-----------------------XXX----------------------------------------X---------|--------------------------------------------------------------------------------------------------------------------------f
-----------o----------XXXX---------------------------------------XX------??-|--------------------------------------------------------------------------------------------------------------------------f
m-----------------E--XXXXX-----------X--------------------------XXX------E--|--------------------------------------------------------------------------------------------------------------------------X
XXXXXXXXXXXXXXXXXXXXXXXXXXXXXXXXXXXXXXXXXXXXXXXXXXXXXXXXXXXXXXXXXXXXXXXXXXXX|XXXXXXXXXXXXXXXXXXXX------XXXXXXXXXXXXXXXXXXXXXXXXXXXXXXXXXXXXXXXXXXXXXXXXXXXXXXXXXXXXXXXXXXXXXXXXXXXXXXXXXXXXXXXXXXXXXXXXX
