----------------------------------------------------------------------------------------------------------------X------?B---------------------XXXXXXXXB--------B-------------?????---X---X--------------
---------------------------------------------------------------------------------------------------------o-----B-------------------------B--X----X--X---------B----B-o---X-X---------X--------XMXXXX----
--------------------------------------------------------------------------------------------------------------X-----------B------------------------------o--------o-------------------------------------
---o---------------------------------------------------------------------------------------------------------------------------------T-----X----------B-------XBBBBXB----X--------------------------B---
-------------------------------------------------------------------------------------------------------------------------------------|--BX----T------BXX-----X-------------B----XM-----------?--B-----X-
-------------------------------------------------------------------------------------------------------------------------------BBX---|-oB--M--|-----------X-XX--------------------------X-------o----XX-
----------------------------------------------------------------------B------------------------------------B------------X---T-XX-B---|--XXXXXX|X---?--B---XXXX-oM-----------B--B---X----------------XXX-
----------------------------------------------------------------------------------------------------------------------X-XXo-|--------|--------|------X-T-TXXXX?--------B-T---X---M-------------XXXXXXXXv
------------------------------------------------------------------------------------------M-----------------------B-----XXX-|B-------|-B---T--|T-------|-|XXXX--------?--|--XXX-----------X-----BoXXXXXf
-----------------------------------------------------------------------------------------------T-----------M------------XXXX|-----X--|-----|--||-T-----|X|XXXXX----B-----|-XXX--BB---B-X-XX---X--XXXXXXf
-----------------------------------------------------------------------------------------------|---X-------BB--T--------XXXX|--------|-----|-X||-|--X--|X|XXXXXX-------o-|XXXX---------XXXX--XX-XXTXXXXf
-----------------------------------------------------------------------------------------------|---T-----------|--T-----XXXX|X-X-----|-----|XX||-|--XXX|X|XXXXXXX--------|TXXX-X-M-----XXXX-XXXXXX|XXXXf
--------------------------------------------------------------------------------------------B--|---|-----------|--|-----XXXX|XXXB----|-?---|XX||-|--XXX|X|XXXXXTXX------X||XXXM-----B-XXXXXXXXXXXX|XXXXf
-----------------------------------------------------------------------------------------------|---|-----------|--|-----XXXX|XXX-----|----X|XX||-|--XXX|X|XXXTX|XXX----XX||XXX--XX---XXXXXXXXXXXXX|XXXXf
m----------------------------------------------------------------------------------------------|---|-E------E--|--|-----XXXX|XXXX-XEX|---XX|XX||E|-XXXX|X|XXX|X|XXXX--XXX||XXX--E-E-XXXXXXXXXXXXXX|XXXXX
XXXXXXXXXXXXXXXXXXXXXXXXXXXXXXXXXXXXXXXXXXXXXXXXXXXXXXXXXXXXXXXXXXXXXXXXXXXXXXX----BBBBBBBBXXXX|XXX|XXXXX--X---|XX|-----XXXX|XXXXXXX-|-BXXX|XX||-|XXXXX|X|XXX|X|XXXXXXXXX||XXXXoX--XXXXXXXXXXXXXXX|XXXXX
