-----------------------------------------------------------------------------------------------???????-----------------------------------------------------------BB-------------------------------------
------------------------------------------------------------------------------------------------BBBBB---------------------------------------------------------------------------------------------------
----------------------------------------------------------------------------------------------------------------------------------------??BBB---------BBBBBBBB------------------------------------------
---------------------------------------------------------------------------------------------------------X----o---------------o-------------------------------------------------------------------XXXX--
----BBBB--------------BBBB-------------------------------------------------------------------------------------------XXXXXX--------------------??-------------------------------------------------------
-----??????-------------------------------------?--------------------------------???----------------------------------------------------BB--------------------------------------------------------------
----------------------------------------------------------------------o-------------------------------------------o----------------------------------------------------------------------------------B--
---------------------------------------------------------------------------------------------B------------------------------------BBBBBBBB-------------------------------------------------------------v
-------------------------------------------------------------------------------------???????---------------------------------------------BB------------------------------BBB---------------------------f
-----------------------------------------------------------------------------------------------------------------------------------????------------------------o---------------------------------------f
--------------------------------------------------------------------------------------X--------XXXXXXXX------------------------------------------------------------------------------------------------f
-----------------------------------------------------BB-------------------------------X-----------------------------------------------------------------------T----------------------------------------f
--------------------------------------------------------------------------o-----------XX------------------------T------------------------?-X------------------|----------------------------------------f
--------------------------------------------------------------------------------XXXX--XXX------T-------B--------|-------------------------XX------------------|----------------------????????----------f
m---------------------------------------------X---------------------------------------XXXX-----|---------E------|---------XXX------------XXX------------------|------------------------BBB-------------X
XXXXXXXXXXXXXXXXXXXXXXXXXXXXXXXXXXXXXXXXXXXXXXXXXXXXXXXXXXXXXXXXXXXXXXXXXXXXXXXXXXXXXXXXXXXXXXX|XXXXX----XXXXXXX|XXXXXXXXXXXXX------XXXXXXXXXXXXo--XXXXXXXXXXX|XXXXXXXXXXXXXXXXXXXXXXXXXXXXXXXXXXXXXXXXX
