---------------------------------------------------------------------------------------------M------------X------XXX----------------??---M-----------------------------------M--------------------------
--------------------------------------------------------------------------------------???---------------------------o------BBBBBBBB------M------------------------------B-------------------------------
-------------------------------------------------------------------------------------------------o-------XoBBBBB--------------------M---???????------------------------------------o--------------------
--------------------------------------------------------------------------o---o--------------------------T--------BBBBBB---XXTX--------------------------------------T----------------------------------
---------------------------------------------------------------------------------------------------T---T-|-?-------oX--------|---------------------------------------|-------------------------?--------
------------------------------------------------------------------------------------X--------------|-X?|X|To-------XX--------|------T--------------------------------|----------------------------------
------------------------------------------------------------------------------------XT------------T|BXX|-||TX-X---XXX----M---|---X--|-------X------------------------|-----X----------------------------
------------------------------------------------------------------------------------X|X----------X||XXX|-|||XX---XXXX----o---|--XX--|-------XX-----------------------|-----XX--------------------------v
----------------------------------------------------------------------------------X-X|XX--------XX||TXX|X|||XXXXXXXXX--------|-XXX--|-----X-XXX----------------------|-----XXX-------------------------f
---XXXXX--------------------------------------------------------------------------XXX|XXX------XXX|||XX|X|||XXXXXXXXXo--X----|XXXX--|----XX-XXXX---------------------|-----XXXX------------------------f
------------------------------------------------------------------------------o-T-XXX|XXXX----XXXX|||XX|X|||XXXXXXXXXXXXXX---|XXXX--|---XXXoXXXXX--------------------|-----XXXXT-----------------------f
--------------------------------------------------------------------------------|-XXX|XXXXX--XXXXX|||XX|T|||XXXXXXXXXX--XXX-X|XXTX--|--XXXX-XXXXXX-????-------------X|-----XXXX|X----------------------f
--------------------------------------------------------------------------------|-XXX|XXXXXXXTXXXX|||XX|||||XXXXXXTXXX??XXXXX|XX|XX-|-XXXXX-XXXXXXX----------------XX|-----XXXX|XX---------------------f
--------------------------------------------------------------------------------|-XXX|XXXXXXX|XXXX|||XX|||||XXXXXX|XXX--XXXXX|XX|XXX|XXXXXX-XXXXXXXX----XXXXX-----XXX|-----XXXX|XXX--------T-----------f
m------------------------------------------------------------------------------E|XXXX|XXXXXXX|XXXX|||XX|||||XXXXXX|XXX??XXXXX|XX|XXX|XXXXXX-XXXXXXXXX------------XXXX|--E-EXXXX|XXXX-------|-----------X
XXXXXXXXXXXXXXXXXXXXXXXXXXXXXXXXXXXXXXXXXXXXXXXXXXXXXXXXXXXXXXXXXXXXXX-----XXXXo|XXXX|XXXXXXX|XXXX|||XX|||||XXXXXX|XXXXXXXXXX|XX|XXX|XXXXXX-XXXXXXXXXXXXXXXX----XXXXX|X-XXXXXXX|XXXXXXXXXXX|X----------X
