------B-B----o--o----------X-----o-----X-o-----------------------------------B--------------o--o----XB-----XB-------o----------B-------X-X---------------X------X--Bo---------o-------------o---------BB
-------------B-o---?---o------B--o---B-------o---------B-B-B--B--X-o-------X----X-----o-B-X---o------o-----B---o-----o----------B--o----o-o---------B-------B-------o------B-----o------Bo-E-Booo-------
----------------o-------B------B--------o-B---ooB-B---o----o-------------------o--------------------X--B-------------B----X------o---X------B--oB--B---------oo-----B----o---X-B----oo-B-----o--o---B---
---------B----o-X-------oB--B------o-----------------------B--o-B----o---------oB---o------------oo---BoB--------------o-----Bo---------o-X---o--X---B----B----------B----oT---B--o--------oXo----B----B
o------X-----B---o---------o---------o-------oB--B----X------o--------o------o---B-o-oB--oBX--o--------X-------o------B--X---------B--o---------BB-B---B------------BB--B--|--B----------BE--B------X-o-
-o----------------T-X------X---X------XooX--X------------BBo---o-o-o----X---------B--------o------o----o------------o-------B--B----------o--------B-o---------------o-----|---o---o-----T--------------
--o-XB-----T--o---|-o--------o------o---------oB----B-----B---X--X-------X--o----------o-------B----o--B----B---------B-B----X-------B-o---XBo---oo--B---------------o-B---|-----B-X----B|-oo-E-o-o---X-
o----o--E--|------|--XX-B-B-----o-B------B--B---------oo----X-----B----------E--------o-B--oX----E---o-o---o-B----oB----B--B-----o----------BX--B-B--------X--o---------o--|-------B-----|-------------v
-------BoE-|------|--T------X-------------Bo-oo-B------------B-o----T--------XoB--o--X----------o--B----?-----X-------X------o----oXB--------B-----------------------X---o-|-o--------o--|-------------f
-o-o-X--o--|----o-|--|----o----XXoo------------B-oo------X-E------o-|-BoB-o----X--o------------o--XT--B--o------o---o---X--X--o-B-----X-----B--oB------B--oE-----oo------oo|-------E-----|---o-o-------f
--o--o-----|-----B|-o|-X-----E---------B--o---B--BB----o--B--o-B----|--o--------------o---B-o--o---|-o-----Bo----Bo-?----X---------o--X----XB--E------------------o--X-o---|---XBoX---E-o|---B--Eo-----f
--X-----BB-|------|--|---------T---oB-o---------B---Boo-B----BB--B--|---oB--------o---o-B----B-----|-o----B-X----------X------o----B----o------B---------------B-o---o----?|----------T--|-------o-----f
o--------o-|--o-o-|--|--o----E-|-------------o-o------oo------------|------B--oX----o-----B-o------|------o-o--B-o-o---o-o---Bo--o---o---BX---BBB---------X-o-X-------o----|-o-BBoo--o|--|---B----oo---f
X----o---X-|------|--|-B-------|-oB---BB--oo-o---E--------o------X--|--oE-o------------------------|--Bo-o---------------o-----------oo-------o------o---------B----E---o--|-----o-o--|--|---Eo--------f
m-E--B----o|---o--|--|---Eo-E--|-EB-----Boo-o--o---E----------E-o-o-|--o--B--B---EXBB-Bo-----------|-----o---E-o---o---B-------------oEo-oE----o-----------E-?--oo---------|------oE--|--|---X----------
XXXXXXXXXXXXXXXXXXXXXXXXXXXXXXXXXXXXXXXXXXXXXXXXXXXXXXXXXXXXXXXXXXXXXXXXXXXXXXXXXXXXXXXXXXXXXXXXXXXXXXXXXXXXXXXXXXXXXXXXXXXXXXXXXXXXXXXXXXXXXXXXXXXXXXXXXXXXXXXXXXXXXXXXXXXXXXXXXXXXXXXXXXXXXXXXXXXXXXXX
