-----------o-------------o------------------B-----------oB----------------o-------o-----------------B-X------B------------------X------------------B------------------------------------B-B-------------
----o-------------------X-----X---o--B---------o--o------------o------o----X-oB-E----o-------oB-X-B-o--------------o--BB-----------------?------------X---------------o-----B-oo---X-----o-o---o--------
----------o------X-----o-B--B--o--o---B-B---o---o-B------o--o-------B----B--E-X-o-----------------o-B------o-o--X----B--------------------o------------o----o--------------BB-B--B------o---o--oB--o----
-----B------B-----------B---B--------o-B-------------o-o-o----B-Bo---------------o--X-B----X--o----------------------o----------X---------o----------X-----o--Bo-----X-----------B--o--o-------B--------
------o---o-------o-o---o-----o----o--------o------------------o----B------o-------o----o-------B----o-X--------B-oo----X---------o------------o-----------------------------o----o--Bo----o--------o---
----o---B--------B---------o-------o-----------X-------?------------o--oX-------B---B-o-o-------------------X--o---o-X--o---BX---o--------B----------X---------B-------------X-------o---------B--B-B--B
-----o---------o-----o----------------B---o--X-------B------X---------o-------B-----oo--------X---M-------o-----B-E---X-----------------------o---------o--o-----------------------o---B-------------X--
--X-E---o--o---o---o------------o-o-----Bo-o--------------------------o---BB--o---------------------------------B-----B----B--XB---X--B---o----------------oo-----------oo----E-----o--o--oo----o------v
----X--o--oo---o--------------------------B------B-------o---B----oo-------M---B-----o-----B------o--B-------o-----B-----B--------------------X----o---------B-----------B-B---------B-------X----o----f
-------oo-X------B-----B--B------------o------o-o--X--oB-----------------o----o-------E-o---B----------B----XB----------B---------B----Bo------------o-----B------------------X----o----oo-----o----o--f
------B------o-BB----------B-----------------o----------o---B-o-----o---------B--o-------B-----X------X-------------o-o-o-----o------o-o--------B---X---o----B-B------oo-------------------------------f
--Xo---X---o-X------o------o----B--BE-----XB-B---B--o----o---o--------------------oBo----------o--oo--------X------------B---------o--X-------B---BoX--o---------E--------B-o---B-----X-o-----X-----X--f
---o--o---X----------------------B---------B-----------------o---o---o--------o-----BB---------Bo----------------o-------------------o-o-----------------B-------o---------------o---------Bo--oX-----Bf
--o------o-------BB-------B--E--------X------o--o---BB-------------o--------M----------oXoXo---o-B-------B--X-XBX----o----------o---B--o--------------o?----o---o---BXo-----------oBo---B--------E-o---f
mB--B------------------o-oo---o---------o----o--Xo-------o-B-----------o-o-----o-----X---------------o--oE--o-----oo--o--B-------E----------B-o--------XB------B----------o-----------oX-B--B---o------X
XXXXXXXXXXXXXXXXXXXXXXXXXXXXXXXXXXXXXXXXXXXXXXXXXXXXXXXXXXXXXXXXXXXXXXXXXXXXXXXXXXXXXXXXXXXXXXXXXXXXXXXXXXXXXXXXXXXXXXXXXXXXXXXXXXXXXXXXXXXXXXXXXXXXXXXXXXXXXXXXXXXXXXXXXXXXXXXXXXXXXXXXXXXXXXXXXXXXXXXX
