----o------B--------------------------------------X---------------X------------------------------------------B--B------X-o---------------Bo---------o------B-------B--o-------------B--o----B-----------
---------o--------o----------------BB---------B-o-----BBo------------------o-----Bo----------------------------o---------E---------E-------------------------o------oX-o-----B--------------------------
-------E-----------B------BB----o-o---o-----oo--o------------------oB-o-------------B-B--o-----o--oX-B-----X--o----------B------------Bo---------X--------------BX-------------B-----------o--------Bo--
-------------o--------o----------------o-----X-------o--------oX-B-----------------o----o--B-----o-----B---o--B--------------o----------------o---B-B-------------o---o------------BBB-------------Bo---
--o-X---------B-----oo----E----B--B---?-------o---B-----XX---E--------B----o--------------o--------X-------------------o--o--E--B---------o-----E-----------o------------o-----o---o-----------------B--
----------B--B-----oo-?---o-------o----B-----B---------o------o-M--------o-B-o--------------B-------B------------B-------BooB------o--------oX-o----B-----------------o------------E---o---o---B---o----
-------------Xo---o--o---o----------X-----X--o-B--X-----------o---------------B-X------------------------B----o-----E---------o-Boo---E-----------------X--------o------o---o-E-o------oBB-X----o----B--
---o-----B------o-----------B-------o------------------------------B---B-o--E-o--B-------B-----o---o----------------B------------B--B-----------o--------B------o--o-----B-oB-B--------B-o-------o-----v
----B-------------------o---Bo-----------o-o--------------o--B----X-Bo---X--X--------------o------B-----------------------B----------------o------------XX--------------------X----B--o--Xo--------o---f
------B-------B--o-----B------o--------o----------------o---o---o----o---o-----o---------B--------o----o---------Bo--?o---------X--------o----o---Bo------Eo------o---------o----X--o------------------f
-------o---------------X---o-------B---oo-o--o---B-----------------------Bo--o--o-----------Bo-o---o--o------o---o-X---------B-----o---o---o----B---------o-----B--B---------------X----o-B-----B------f
--o-----o----B--oB-------o--o---------o--o----------o--o------oB----oX-B--------------------o?-----B-------B-X-X--o-----B-o-----------------oB------------B------------B-X-----------------------------f
---o--------------------------o-------B--o--------------------------------B-----------------------------------B-----------------o--oBX------------B-oB--o----------B------o-----o----------o-----------f
---o----o---o-------B------o-o----------o-------o--oX-B-o---B-X-Bo--o---o--o---oXB-B------------B--------Eo--------o--o------------------------X--o--------BX-oBB----B-o----B---B---o---BB--B-o------o-f
mo-o--EE----o--X---o-E-----BE------------E----Eo-E-E------EBE-----E------oo---X-------------o-B-E-EB-X--------B---------------B--B-BE------------------XB------o------EXoB-E-------E--E-------E------X--
XXXXXXXXXXXXXXXXXXXXXXXXXXXXXXXXXXXXXXXXXXXXXXXXXXXXXXXXXXXXXXXXXXXXXXXXXXXXXXXXXXXXXXXXXXXXXXXXXXXXXXXXXXXXXXXXXXXXXXXXXXXXXXXXXXXXXXXXXXXXXXXXXXXXXXXXXXXXXXXXXXXXXXXXXXXXXXXXXXXXXXXXXXXXXXXXXXXXXXXX
