-----o--------------oB------------------------------------Xo----------------------------B----o----B------X--o?--B----------------------------------B---------------o----------------o-------------------
----B-B----------B--o--o--------B-----o----o-o-o---B----B---------B--X-oB----B---------B-------B-o------o--------------o-------------X-----o--o--oB-B-B-------------Bo-o----------B---B-o----X---------o
----------------------------------------------------B----E----XE--------B------o-o-X---B--o-----------------------B--------------------B----B--B--------B---------------o------------o----E-----------Bo
------o---o---o-X-o------B----B---------B-B----B-------------o-BM--------o----------o----X--------------------o---X-o------------o--------B------X------B----------------------oBoo----X----BX--------X-
---o--o---o-----B----------B-----------B-o-B--B------o---------o--X-XB-o-----B-------o---oo----B------o-o---------B--o--oX-------X--------B-----o-----o-o-B---------o--o--B-----------------------------
---o--------B-------o-----B--X-------X--X-----------------o------------o-------------B--B-EoX--Xo-o--X----E--------B----------X--B---B----o-----B-----o---B--X------------------------o--B-B--------o---
--o---o----X---E-----X-------o------------Bo-?---------o-----o----oX--o-X----o-----B------o------B-----oo-----o----------------o-------o----------o---------o-BX-X----B-oo------?---------o-B-X------o--
----o--E-E-----BB-------------o---B---o----------X-------o--B---B------o----------------------o--o--B-----------------o---------------------B------B-----B--o-B---------B-----------B-----E-XX---------v
-----o--------o--E--------B-B---B---o-----------------o-o------B-----o-o---X--oo---------X-----o-----E---o-XEo----B-o-o---o-o-----------------------o--------oB----o-B---o---------B-oXo------------B-of
----B--------B-----B-o---------Bo---B------------B-----------B-------B-------------------------------o------B------E--------o-o--BB-----------------------------oB-B----X-------------B--------B------Bf
------o-B--------o-o------------X-B---------------?--------oBo---Xo-------------oB-oB-oB-----XB---------------------B-o---------B-----------o-oo-----o-----------------o-----o-------o-o---B-----B----of
----------o-------B---B-B---------------------------B---o---------BB-o-----------oX--X-------------o--------------X--oo---o----B---------------o----------o-oB-o-------o------------X------------------f
---o-----------o------o------------X--------o---X---o---o---------o-B-o--Xo-------------------o----o-------o---o-----------B--------------o--B-------o----------B----B----------o-o----------X---------f
-----------o-B--------X------o--o-----------------?------o---B-------o--o---o-----X--B---B---oo--o-o----------o------o-----B-------o-----------------o---o----B--o--------------------------X------B---f
m----E---XoB----o-oX------X-------o-o---o-----o-----o-B------------------B---------------------------X---o--X----o---------B-o--B--oo-----E------------X------o-B-----------------o--X----BX-----------o
XXXXXXXXXXXXXXXXXXXXXXXXXXXXXXXXXXXXXXXXXXXXXXXXXXXXXXXXXXXXXXXXXXXXXXXXXXXXXXXXXXXXXXXXXXXXXXXXXXXXXXXXXXXXXXXXXXXXXXXXXXXXXXXXXXXXXXXXXXXXXXXXXXXXXXXXXXXXXXXXXXXXXXXXXXXXXXXXXXXXXXXXXXXXXXXXXXXXXXXX
