----------------------------------------X---------------------------------X-----------------------------------------------------------------------------------------------------------------------------
----------------------------------------------------------------------------X-----------------------------------------------------------------------------------------M---------------------------------
--------------------------------------------------------------------------------------------------------------------------X------B----------------------------------------------------------------------
--------------------------------------------------------------------------------------------------------------------------------------------------------------------------------------------------------
-----------------------------------------------------X---------------------------------------------------------o-------B----------------------------------------------------------?---------------------
-----------------------------------------------------------------------------------------------------X--------------------------------------------------------------------------------------------------
-------X------------------------------------------------------------------------------------------------------------------------------------------------------------------------------------------------
------------------------------------------------------------------------------------M------------------------------------------------------------------------------------------------------------------v
-----------------------------------------------------------------X-------------------------------------------------------------------------------------------------------------------------------------f
-----------------------------------------------o-----------------------------------------------------X-----------------------------------------------------------------------------B-------------------f
-----------------------------------------------------X---------------B-----------------------------X------------------------------------------X-----------------------------------------X--------------f
---------------------------B-----------------------T---------------------------------------------------------------------X-------------------XX----------------------------------------XX--------------f
---------------------------------------------------|------------------------X-------------------------------------------XX------------------XXX---------------------------------------XXX--------------f
---------------------------------------------------|X-----------------------------------------T------------------------XXX--T--------------XXXX--------------------------------------XXXX--------------f
m--------------------------------------------------|XX-----B----------------------------E-----|-----------------------XXXX--|-------------XXXXX-------------------------------------XXXXX--------------X
XXXXXXXXXXXXXXXXXXXXXXXXXXXXXXXXXXXXXXXXXXXXXXXXXXX|XXXXXXXXXXXXXXXXXXXXXXXXXXXXXXXXXXXXXXXXXX|XXXXXXXXXXXXXXXXXXXXXXXXXXXXX|XXXXXXXXXXXXXXXXXXXXXXXXXXXXXXXXXXXXXXXXXXXXXXXXXXXXXXXXXXXXXXXXXXXXXXXXXXX
