-----------------------B----BBB--------------------------------------------------------X--------------------BXo---B--?-B???X--------B---------------------------------------------B--------B------------
----------------------------------------------------------------------------------------X--------B---------M----------X---X--B------------------------------------------------------------------X-------
----------------------------------------------------------------------------------------------------------M----X---XB--B--???----B---B-----------------------------------------------B-----------?------
------------------------------------------------------------------------------------------------B-----BX-X-B----BT-XX-B-X-TX-B-T-oo---------------------------------------------X-----T--X-----X--B---B-
-------------------?-----------------------------------------------------------------------------X-XB------XB---B|--X--BXB|XBBX|o---------------------------------------------------?-|-----Xo----X---X-
-------------------o-------------------------------------------------B-----XB------T----X-X-------XX-----o-B--BXX|-XX--BXB|-B--|XXTX?X------------------------------------------------|----X-------X--X-
-----------------------------------------------------------------------------------|------XX----MXXXB------o-X-X-|XXX-X---|X--B|XX|---------------------------------------------------|----XXXXTXXXX-XX-
------------------------------------------------------------X-B--------------------|----X-XXX-B-XXXX-----XB-----B|XXXX----|----|XX|--X------------------------------------------------|----XXX-|-XXXXXXv
---T-------------------------------------------B-----------XX-----------------M---?|????-TXXXX-XXXXX--X---B-----X|XXXXX-X-|XTBB|XX|XX-T-----------------------------------------------|----XXXX|XXXXXXXf
---|-----------------------------------------------T------XXX------X--------T------|----X|XXXXXXXXXXX-BBBBX?--XXX|XXXXTX-T|X|-M|XX|XX-|-----------------------------------------------|----XXXX|XXXXXXXf
---|-----------------------------------------------|-----XXXX------XX-------|------|X--XX|XXXXXXXXXXT-T--XX-B-XTX|XXXX|XX||X|--|XX|XXX|-----------------------------------------------|XXXXXXXX|XXXXXXXf
---|-----------------------------------------------|B---XXXXX------XXX------|------|-----|XXXXXXXXXX|-|-XXX-XXX|X|XXXX|XX||X|XX|XX|XXX|-----------------------------------------------|----XXXX|XXXXXXXf
---|------------T----------------------------------|---XXXXXX------XXXT-----|------|---BB|XXXXXXXXXX|-|XXXX-XXX|X|XXXX|XX||X|XX|XX|XXX|X----------------------------------------------|----XXXX|XXXXXXXf
---|------------|----------------------------------|--XXXXXXX------XXX|X----|-X----|-----|XXXXXXXXXX|-|XXXXXXXX|X|XXTX|XT||X|XX|XX|XXX|XX------------------------------------------T--|----XXXX|XXXXXXXf
m--|------------|----------------------------------|-XXXXXXXX------XXX|XX---|X-----|B--E-|XXXXXXXXXX|X|XXXXXXXX|X|XX|X|X|||X|XX|XX|XXX|XXX-----------------------------------------|--|---XXXXX|XXXXXXXX
XXX|XXXXXXXXXXXX|XXXXXXXXXXXXXXXXXXXXXXXXXXXXXXXXXX|XXXXXXXXXX----XXXX|XXXXX|XXXXXX|B---X|XXXXXXXXXX|X|XXXXXXXX|X|XX|X|X|||X|XX|XX|XXX|XXXX-XXXXXXXXXXXXXXXXXXXXXXXXXXXXXXXXXXXXXXX|XX|XXXXXXXX|XXXXXXXX
