-------X---------------------------------------B------------------B-------B-------???????-------------M-----------------?--------------o-BBBB-------------B---------B-----------------------------------
--B-------------------------------------------B-?--------------------------------M--------------------X--X---XXXX------------B-----M---BoB--X-------o---------------------------X-----------BBBBBBBB----
-----------------------------------------------------------------------------------------o--B---------------X--M--XXXX----B-------X----XB-----???-------XX--BBBBBX---------------------B---XXXo---------
-------B---------------------------------------?------------------------------B---T------------------XXoXB---X--B----M-----X-------X----BX------------o---???-------------XB---------------------B------
-----B-------------------------------------X-------------------------------B--X---|---------------X---------TX----TX-----------ToBB------B-----T---------------????X---------------------T--------------
------------------------------------X----------T-------B-------------o-------?-T--|------------o----X----B--|--T--|-XXXXXX-B---|o----X--B-X--X-|-------------B--X-XX------T--------------|--------------
-------------------------------------X-M-------|------------------------o---B--|--|------------X--XB--B----B|XT|X-|--XX------T?|o??M-----XX--XX|B-B------B-?-----XXX------|---X-X------B-|--------------
------------------------------------XX---------|----------------------?-X---X--|--|------B------T-XX-B------|X||--|----M-----|-|--B----oXXX--XX|-M--T--TB-------XXXX------|--------------|-------------v
-----------------------------------XXX------X--|----------------X---------oXXB-|BB|BBBBB---X----|-XXX---X---|-||-B|-------XX-|-|X---BXBXXXX--XX|X-XX|XX|XX-----XXXXX------|--B------B---X|-------------f
----------------------------------XXXX-----T---|---------------XX-------??XXX--|--|---T--XXXXXX-|-XXXX-----T|-||--|---BBBB?BB|-|XX--X-XXXXX-TXX|XX--|--|---B--XXXXXX------|---------B----|-------------f
---------------------------------XXXXX-----|---|--------------XXX----B---XXXX--|--|---|--X---BB-|MXXXXX----||X||--|----X--B--|-|TXX-XXXXXXT-|XX|XXX-|--|-X---XXXXXXX------|--------------|-------------f
--------------------------------XXXXXX-----|---|-------------XXXX---B---XXXXX--|X-|---|---------|-XXXXXX--X||-||X-|----B-----|B||XXXXXXXTX|-|XX|XXXX|-X|----XXXXXXXX-X----|----M---------|----T--------f
-------------------------------XXXXXXX-----|---|--------?---XXXXX------XXXXXX--|--|---|X--------|-XXTXXXXB-||-||--|----B--B--|X||XXXXXXX|X|-|XX|XXXX|-B|---XXXXXXXXXXX----|--------B-----|----|--------f
------------------------------XXXXXXXX-----|--T|-----------XXXXXX-----XXXXXXX--|--|X-X|XX---o---|BXX|XXXXX-||B||-X|-----B----|X||XXXXXXX|X|-|XX|TXXX|X-|-XXXXXXXXXXXXXT---|---------X----|----|--------f
m--E-------------------------XXXXXXXXX-----|--||--E-------XXXXXXX-X--XXXXXXXX--|--|EXX|XXX--XE--|?XX|XXXXXX||-||-X|B-EEXEXXEX|X||XXXXXXX|X|E|XX||XXX|XX|-XXXXXXXXXXXXX|E--|--------------|---E|----X--XX
XXXXXXXXXXXXXXXXXXXXXXXXXXXXXXXXXXXXXXXXXXX|--||XXXXXXXXXXXXXXXXXXXXXXXXXXXXXXX|XX|XXX|XXXX?????|XXX|XXXXXX||X||XX|-X--XXX-XX|X||XXXXXXX|X|-|XX||XXX|XX|XXXXXXXXXXXXXX|---|-------M--XXXX|----|BXXXXXXXX
