--------------------------------------------------------------------------------------------------------------------------------------BBBB--------------------------------------------------------------
------------------------------------------------------------------------------------------------------------------XX------------------------------------------------------------------------------------
---------------------------------------------------------------------------------------------------------BBBBBBBB---------------------------------------------------------------------------------------
----------------------------------------------------------------------------------------------------------------X---------------------------------------------------------------------------------------
-----------------------------------------------------BBBBBBBB-------------------------------------------------------------------------------------------------------------------------------------------
--------------------------------------------------------------------------------------------------------------------------------------------------------------------------------------------------------
--------------------------------------------------------------------------------------------------------------------------------------------------------------------------------------------------------
-------------------------------------------------------------------BBBBBB---------------------------------------------------------------------------------X--------------------------------------------v
----------------------------------------------B----------------------------------------------X------------------------------------------------XXX------------------------------------------------------f
-------------------------------------------------------------------------------------------------------------------------------------------------------------------------------------------------------f
-------------------------------------------------------------------------------o-------------------------------------------------------------------------------------------------------------X---------f
--XXXXXX----------------------------BBB-----------------------------o----------------------------------XX-----------------------------------------------------------------------------------XX---------f
------------------------------------------------?????--------------X-------T---------------------------------------------------T-------------------------T-----------------------X---------XXX---------f
------------------------------------------------X-----------------XX-------|---------------------------------------------------|-------------------------|----T------------------XX-------XXXX---------f
m----------------------------------------------XX---------------EXXX-------|---------------------------------------------------|--------X----------------|----|------------------XXX-----XXXXX---------X
XXXXXXXXXXXXXXXXXXXXXXXXXXXXXXXXXXXXXXXXXXXXXXXXXXXXXXXXXXXXXXXXXXXXXXXXXXX|XXXXXXXXXXXXXXXXXXXXXXXXXXXXXXXXXXXXXXXXXXXXXXXXXXX|XXXXXXXXXXXXXXXXXXXXXXXXX|XXXX|XXXXXXXXXXXXXXXXXXXXXXXXXXXXXXXXXXXXXXXXX
