-------------o-----o-------------B---oBB-o--o----------X----o---------o--o---B-o----o------o------Bo-o--------B------------o--------X------o---o--Xo--B---------------X-------------o--o--B--oo---B-B---
-X--Bo-oo-----------oo--------o-XX---B--------o-----o-------------o--oB---o--------B-------------BB---o-BB----oB--B--o-----B------------------------oB---------B--oX--o---------o-B------o-------------o
---o-------------------X-----------o---Bo--T----------o--------oB-----o--oB------------Bo---B-------o-Bo-o----X-B-------------------B-B---------B------X----B--------B---X--Bo---------o--X---B-o-------
-----oB-o----------o-------o-o-o--o--------|----------o----------o--------XB--------X-X----o--o----o-oo----M------B--o------------------B---B---BBB-----------X---------o-----------E---oo-------o---X--
-o----------o-o----o--------B---o------B-X-|----o----B----o--------BB----------o-----X----oo-o-------Bo---oXo-B-B--------------------------oB----Bo---o-oo------------o--------B---------------o-B-X----
?o--X----o---X-o-B---B----------------BX---|--B--------X--------B---o-----BB--oo-----o------B--o-------E----------------o---X----------------o-B------B---Xo--T-oooo---o--------X------B--?-------o--B--
---------X----X-----o--X-------------o----B|------o---------o------------B-o-------XX---oo--------------X-X-----B--o-Bo---oX----B--E----o---BX--------o-------|------B----------------B-o--o------------
o--oo------o-B---X------------------oB---X-|--------------------------------------------------?-o----o----E--------o-------Xo-M-o--X------B-X-------------o-o-|---o----B--B-o-----X----B---o----o------v
-------B--X-o----?o--X-o------E------------|--B-------oXX---B--B---o-------o--B-----E----------------------o--------o-------o--------X-------------oo----B---o|--oBBB-o-----B------------oX-------B---Xf
---o---o------oo---o------o--Bo---oB-----B-|--------BX--XXX----------o-XB--o-Bo----X-ooXX---B---------Bo-----B-B--B----------B---o-X---o--------------------o-|----B---------EE----o--o--o---oo-----o--f
o-------------o------BB----T--o--B----oB--B|-B-----o----B----o-o-BB----B----------o--oo---BBo-B-------B------B-------BXo---X-----o--X-B--B---B---ooo--ooo-E---|-X-------------B------------------X---B-f
---o------oX------B---o----|-B-T-----E----X|--B-o---B--o-----------X---------------X-------o-------o--o-oo---o---o---------B----o-------Bo----Booo-o--B----Bo-|-B--------B----oo------------X--X----X--f
-----o----X-X-------o------|-o-|--oo-X-----|-------B-B-B---o-B-oX--o-X-----------o--Bo------o-----------oo--o-B--Xo---B--B-------o-o-----o----oo------XoB--o--|------------o--X---B-B-X--o--B------X---f
-Xo----B------o-----------o|---|-o---------|--o------Bo---o---o-X-------o------o--------------BB-----XB----B---o-B----B-------B-oo--------o--B---BXXo-oE-B----|---o--o----B-----B-B--B--B------B---o--of
m---oB----B--o-X-o--E--o---|---|-oX-o--oo--|-----X--E------------E---E-o---X-B--o----BX--Eo---------------B---B-oo--oXo---B----o----------oX-B--------oX-o----|--o---------ooB----Eoo----B---BE--Bo-----
XXXXXXXXXXXXXXXXXXXXXXXXXXXXXXXXXXXXXXXXXXXXXXXXXXXXXXXXXXXXXXXXXXXXXXXXXXXXXXXXXXXXXXXXXXXXXXXXXXXXXXXXXXXXXXXXXXXXXXXXXXXXXXXXXXXXXXXXXXXXXXXXXXXXXXXXXXXXXXXXXXXXXXXXXXXXXXXXXXXXXXXXXXXXXXXXXXXXXXXX
