----?--------------------------------------------------------------------------------------------------------o----------------------------------------------------o-------------------------------------
-----------------------------------------------------------------------------------------------------------------------------------------------------------------------------------o--------------------
----------------------------------------------------------------------------------------------------------------------------------------------------------------------M---------------------------------
--------------------------------------------------------------------------------------------------------------------------------------------------------------------------------------------------------
--------------------------------------------------------------------------------------------------------------------------------------------------------------------------------------------------------
--------------------------------------------------------------------------------------------------------------------------------------------------------------------------------------------------------
---------------------------------------------??????--------------------------------X------------------------------------------------------------------------o------------B------------------------------
-------------------------------------------------------------------------------------------------------------------------------------------------------------------------------------------------------v
----------------------------------------------------------------------------------------------------------------------------------------------------------------------------------------------------o--f
-------------------------------------------------------------------------------------------------------------------------------------------------------------------------------------------------------f
------------------X------------------------------------------------------------------------------------------------------------------------------T-------------------------------------------X---------f
-------------------------------------------------------------------------------------------------------------------------------------------------|------------------------------------------XX---------f
---------------------X---------------------------------------------------------------------------------------------------------------------------|X----------------------------------------XXX---------f
--------------------------------T----------------------------------------------------------------------------------------------------------------|X---------------------------------------XXXX---------f
m----X--------------------------|-------------------------------------------------------------------------E----------E--------------------------X|X--------------------------------------XXXXX---------X
XXXXXXXXXXXXXXXXXXXXXXXXXXXXXXXX|XXXXXXXXXXXXXXXXXXXXXXXXXXXXXXXXXXXXXXXXXXXXXXXXXXXXXXX----XXXXXXXXXXXXXXXXXXXXXXXXXXXXXXXXXXXXXXXXXXXXXXXXXXXXX|XXXXXXXXXXXXXXXXXXXXXXXXXXXXXXXXXXXXXXXXXXXXXXXXXXXXXX
