--o------------------------o------B-X-------------------------o--------------B-o-------B----------------------o--------o---------X-----------------o---B--------X-Xo---o--------------------------------
-----B---------o------o----B----------------B-X---------o----X-o----B-----------B----o---o------o---B-----------------o----------------------------------B-o-------------------o-----B--X-o-------oX----
------B-----------X----------------B---BB---Xo--B-----o-B--------B-X------E----o--o-------B----X-o-------B--E------X-oo-----o----------------o---X-------E--EX---o----------------------o-----BB?-------
-----------------B--o-o-----X--o-----------------X-----o------oo----------o----o--o--oB--B----oo-B------oo-------o-----------------------------B-B---o-B---------------o---oX------B--------o----o---B-o
---X-B-o----o----------o--B------B------X-Bo-------------Bo---------------XX--o----Xo--X--B------------X--B--o---o----------E-------B-o-Xo-------------B------X-E-------B-X--Bo----------o---B-B--------
---BB------X------------X----------BB-----------B-----o--E----oo-----X-----oo--------------------E------X-oo--o----o---------------B-------------B-----B--o------Bo-----X-B-----o--XX--o--B---------oo--
-----B-------------oo----o--B--o----o---B------oo--o-----X----B-o-o------B-----o-----o--o-----o--------?-----o---------------o-o-E------------B-XB--o-o------X?----B--X-----------o---ooo-----------X--o
---o---B-o--o-B-o---------B-------B--oo----------------Bo---X-------------------X-----B-o----X--o-B---?----------o--------oB------o---B--------------------------B------X-----o-B---------B-o----------v
--B-o------------X----------o-o----X------X----------B-----B-----B-------E-----EB-oo---B-X-X------B-X--o------------X-----Bo---------BX-----o-----------------X---o-----------------B-B-o--o---B---o---f
--o-o---X----Xo-------o-o----------BBBB----o--------------o-o----X--------o-o-------------o-B-------BB--o------B----o-o----------o---------X-----B-o--------X--B-------o-o---oB-o--------XB-o--oX-o-o--f
---o-o----o-----B--Bo------B----o-----o-o--Bo-------------B---------------------o------------o-----o------o-----B-------o--B---------BB-o-------------o--------B-----oo--X-------X------X----X---o---Bof
-o---X----B-------B-o-------o-----B--oB------B-------------oo-----------------------------o---------------Bo-----B---o-------o-----------------X--------o-----------o-------------------------oo-B---B-f
--o---------o-----E---o-B------Bo------XBoo-----B----B-------o---------o----Xo---------B---------Xo--------o---------o---------o--------o-oo--------oB---B-----X-------X--------B-----XX------------o--f
--X-----------------------o-----------------B---o---o------B-------o--B-o---Bo-------B-XXX-o--o------------------B--------------B--------o---------B-----B---------o------o-o--o----E---o--------o-----f
mX---------B---------oo--Bo---o----B-o------o--------oo------------oB---o---oB--------------o-X---B-----o-------o--------oo-------B--o----X-oo-o------B----------E--o------o---------Xo--o----------B---
XXXXXXXXXXXXXXXXXXXXXXXXXXXXXXXXXXXXXXXXXXXXXXXXXXXXXXXXXXXXXXXXXXXXXXXXXXXXXXXXXXXXXXXXXXXXXXXXXXXXXXXXXXXXXXXXXXXXXXXXXXXXXXXXXXXXXXXXXXXXXXXXXXXXXXXXXXXXXXXXXXXXXXXXXXXXXXXXXXXXXXXXXXXXXXXXXXXXXXXX
