-----------------------------B-B--BBBBXXXXX-------------B-------B-------------------------------------------------X--B-M------------------------------------------------B-B------------------------X----
------------------------M----------o------XXXXX-----------B---------------o-------------B----B-B--------------------------------------B---X------------------------o--------X--X------------------------
--------------X----------------------B--------------------------BB----X---------------------------------------------B-X---------------oB--------o-----B----X-------------B----------X--------------B----
-------------------------------------B-X----------oX-X----T------------------------o--------------------B--X--o--TBBXBT--B----oM----B------M-X-------------------------M------------X-------------------
---------------------B---------?------------------M-------|-----------B-----T---???????-----------------X------B-|----|-------------X----------X-------------------B-----------X------------------------
--M----------------------------------X--X-----------T-----|-?---------------|--X----------------B-------X-------X|----|--B--T---X--XX----------------X--------------------T---------B------B------------
----------------------?----B-------------M----------|-----|------------X----|------------------------BX----X-----|o---|-----|--B--XXX-----------------------X----BB-------|X------------------T-X-------
-----------------------------------------------M----|-B---|------------oX---|--------------X----------XX--X------|----|-----|----XXXX---------------X---------------------|--------T-?--X-----|--------v
------------------------B-------------T--X---B---XXX|-----|----T------------|---M----------------X----XXX-T--X---|----|B-X--|--?XXXXX------o--------------B--X---B-------X|-B------|------B---|--------f
--------------------------------------|---B-----BBB-|-----|----|------------|-------------------------XXXX|------|----|-----|--XXXXXXX----------------------o-------------|------BT|----------|--------f
------------------------------X-------|-------------|-BX-X|--B-|???????-----|-----------------T-------XXXX|------|--X-|-----|-XXXXXXX--------------B------------------B---|X------||--X-------|------X-f
--XXXXXXXX-------T--------------------|-------------|--X--|----|-XXXXXXX---X|-X---------------|-------XXXX|X-BX--|----|-----|XXXXXXXX-------------------------------------|-------||---X------|-T------f
---XX------------|-----------------X--|-----T-------|----X|----|---X------XX|---------------B-|-------XXXX|XX-XXX|----|XXXXX|XXXXXXXX-----B-----X-------------------------|-------||----------|-|------f
---XXX-----------|----------X---------|---X-|----X--|-----|----|---XX----XXX|--X-------------X|-------XXXX|XXXXXX|----|--XXX|XXXXXXXX-X--B----MXX--------------------?----|-------||----------|-|--B---f
m--XXXX----------|---E-X-B---------E--|----E|E-----B|-E---|----|--EXXX--XXXX|-E--------EB-----|-------XXXX|XXXXXX|----|-XXXX|XXXXXXXX---E-----XXX------------EM--------BBB|BBB---X||----------|-|--E---X
XX-XXXXX-XXXXXXXX|XXXXXXXXX-----X-XXXX|XXXXX|----XXX|-----|----|XXXXXXXXXXXX|??--XXXXXX-------|XXXXXXXXXXX|XXXXXX|X---|XXXXX|XXXXXXXX----XXXXXXXX--XXBBBBBBBXXXXXXXX------|-XXXXXX||?X?-XXXXXX|X|XXXXXXX
