----------------------------------------------------------------------------------------------------------------------------B---------------------------------------------------------------------------
-------------------------M------------------------------------------------------------------------------------?-----------------------------------------------------------------------------------------
--------------------------------------------------------------------------------------------------------------------------------------------------------------------------------------------------------
---------------------------------------------------------------------------------------------------o-------------------------------------------------------------------------o--------------------------
--------------------------------------------------------------------------------------------------------------------------------------------------------------------------------------------------------
--------------------------------------------------------------------------------------------------------------------------------------------------------------------------------------------------------
-----------------------------------------------------------------------B--------------------------------------------------------------------------------------------------------------------------------
------------------------------------------XXXXX--------------------------------------------------------------------------------------------------------------------------------------------------------v
----------------------------------------------------------------------------------------?--------------------------------------------------------------------------------------------------------------f
----------------------------------------------------------------------------------------------------------------?--------------------------------------------------------------------------------------f
-------------------------------------------------------------------------------------------------------------------------------------------------------------------------------------------------------f
-------------------------------------------------------------------------------------------------------------------------------------------------------------------------------------------------------f
------------------------------------------------------------------T------------------------------------------------------------------------------------------------------------------------------------f
------------------------------------------------------------------|------------------------------------------------------------------------------------------------------------------------------------f
m-----------------------E-----------------------------------------|-------------E-------------------------------------------E--------------------------------------------------------------------------X
XXXXXXXXXXXXXXXXXXXXXXXXXXXXXXXXXXXXXXXXXXXXXXXXXXXXXXXXXXXXXXXXXX|XXXXXXXXXXXXXXXXXXXXXXXXXXXXXXXXX----XXXXXXXXXXXXXXXXXXXXXXXXXXXXXXXXXXXXXXXXXXXXXXXXXXXXXXXXXXXXXXXXXXXXXXXXXXXXXXXXXXXXXXXXXXXXXXXX
