--------------------------------------------------------------------------------------------------------------------------------------------------------------------------------------------------?????-
-----------------------------------------------------------------------------??-------------------------------------------------------------------------------------------------------------------------
---------------------------------------------------------------------------------------------o----------------------------------------------------------------------------------------------------------
-----------------------------------------------------------------------------------------????X????------------------------------------------------------------------------------------------------------
----------------------------------------------------------------------------------------XXBBBBBB--------------------------------------------------------------------------------------------------------
---------------------------------------------------------XXXXXX-----------------------------------------------------------------------------------------------------------------------------------------
---------------------------------------------------------------------------------o----------------------------------------------------------------------------------------------------------------------
--------------------------------------------------------------??????-----------------------------------????????----------------------------------------------------------------------------------------v
-------------------------------------------------------------------------------------??????---------------------------X-------------------o------------------------------------------------------------f
--------------------------------------XXXXXXX------------------X-------------------------------------------XXXXXXXX------------------------------------------------------------------------------------f
----------------------------------------------------------B?--XX---------------------------------------------------------------------------------------------------------------------------------------f
-------------------------------X-----------------------------XXX------------------------------------------------------X--------------------------------------------------------------------------------f
---------------------------------------------------------XXXXXXX--------------------XXBBBBBB-------------------------XX--------------------------------------------------------------------------------f
-----------------------------------------------T-----------XXXXX----------------------------------------------------XXX--------------------------------------------------------------?-----------------f
m----------------------------------------------|----------XXXXXX----------------------------------E----------------XXXX--------------------------------------------------------------------------------X
XXXXXXXXXXXXXXXXXXXXXXXXXXXXXXXXXXXXXXXXXXXXXXX|XXXXXXXXXXXXXXXXXXXXXXXXXXXXXXXXXXXXoXXXXXXXXXXXXXXXXXXXXX----XXXXXXXXXXXXXXXXXXXXXXXXXXXXXXXXXXXXXXXXXXXXXXXXXXXXXXXXXXXXXXXXXXXXXXXXXXXXXXXXXXXXXXXXXX
