-----------------------------------------------------------------------------------------------------MBBBB------X------------------------------------------------------------------------X-B------------
------------------------------------------------------------------------------------------------------------------------------------------------------------------B--o---------------X-----------X------
---------------B-------------------------------------------------------------------------------------------------------------------------------------------------------------------------B--------------
----?---------------------------------------------------------------------------------------------------XXXX--------B----------------------------------------------X------------------------------------
----------------------------------------------------------------------------------------------------------------B----------------------------------------------------------------M-------o------B-----X-
---------------------------------------------------------------------------------------------------------------B-----B------------X-------B---------------------------------o---X-------X------------XX-
---------------------------------------------------------------------------------------------------------------------------------XX--------------------------------------------XX-------------------XXX-
-------------------------------------------------------------------------------------------------------------------X--X---------XXX--------------------------------X----------XXXX-X---o--oXXXXXX--XXXXv
--------------------------------------------------------------------------------------------------------X---------B------------XXXX----------------------------X------?------XXXXXX---B----------oXXXXXf
-------------------------------------------------------------------------------------------------------X----------------------XXXXX-----------------------------------------XXXXXXXX-B-X------B--XXXXXXf
------------------------------------------------------------------------------------------------------B--------T-----------T-XXXXXX----------------------------------------XXXXXXXXXX-----------XXTXXXXf
-------------------------------------------------------------------------------------------------------X------B|-----------|XXXXXXX---------------------------------------XXXXXXXXXXXX-------B-XXX|XXXXf
---------------------------------------------------------------------------------------------------------X-----|-----------|XXXXXXX-------------------------B------------XXXXXXXXXXXXXX-------XXXX|XXXXf
----B------------------------------------------------------------------------------------------------XXXXXXXXT-|----------X|XXXXXXX-------------------------------------XXXXXXXXXXXXXXXX-BBBBXXXXX|XXXXf
m----------------------------------------------------------------------------------------------------------E-|E|--------MXX|XXXXXXX------------------------------------XXXXXXXXXXXXXXXXXX--EXXXXXX|XXXXX
XXXXXXXXXXXXXXXXXXXXXXXXXXXXXXXXXXXXXXXXXXXXXXXXXXXXXXXXXXXXXXXXXXXXXXXXXXXXXXXXXXXXXXXXXXXXXXXXXXBBBBBXXXXXX|-|-XXXXXXXXXX|XXXXXXXXXXXXXXXXXXXXXXXXXXXXXXXXXXXXXXXXXXXXXXXXXXXXXXXXXXXXXXXXXXXXXX|XXXXX
