------------oB--o--------------o-o--------o--Bo-------------o--------X--------------o-o---------------------------------------------o--------B---X----------------------X-----------oB--------X---------
---------------B-------------X-B-----------o---o-o-------------------X-oo---------ooB-------------B-------------o------------------------o----------------o------o---------------------B-o---X----------
----------X-------oX----o-----X--B----o---B---------o----o-------X---B--------B-----o------X-------------------------B-----Bo---------------------B----B----B-------------X----------Xo----B-o----------
-----X---------ooBB-o------B-Bo-----o---oB------BE-----------o-oX---oo----oB-----X-X----------B---------B----o---X-------------------X----B-----B------oBX----X-o------o----o--oo--o------o-------------
-------E-------------------o--o------o--------B----------o--oo---X----Booo-o--------o--------XB---------o-o-------B--------o-----X-------------------Xo-o-----o--B-o-o-------X----B-----o------X-----oB-
------B-------o---B-----?---o------o----X----E---o--X--------oB------o--------B-----------X-----------o--o--XB-------o-------B------------------------o------o---o-o------E-X---oo?--------X------------
-------------------------------------------B--------oo----o-o---------------B-----o-o-B--------X---------B---o-------------E-B----------------------o---B----X------------B----o----o-----o---oo------oX
------------B-------o-o--B----------o--o--------X---B------B----Bo----B------oBo--o----------------o---X--------------------------B--oX--------?---o-Xo--B------o---------------X---o----------------B-v
------------o-----------------------BB---------------B----B----oo-----o-------------oEo---------EX--B-------B---B------------B--------oo---B-------o--------------------o-o-----------B----o-X-B---o---f
-----------o------o----X---oo-o--o--o----------o--B-E-oo----o-BB-----o-------------B--B---------Eo-----BBX----B--X--B-o--B-------B------o---o--oo-------X----------------------------o---X--o--X-o--o--f
---------o----o----------o----B--------o------o-------o-B-------------------o---------o--------------o----o-------------Bo-------o-----ooo-X-----o--X-BB--------X---o-o--------XX--------------oXo-o--Xf
-------X-------------------Bo-------X-----------oo-----------o----X---o-----Eo-----------B---------oo---------o---------------------o-o------X------------oB-ooo----o-XB---------o-----oB----o------X--f
-------------o---oo-o-----oB---------o--o------B----o-------B------X---------o--o----------------------BB------------------o--------o-----B---o-----B----------B---------------------------BX--oB------f
----o--o----o--o--------------o---o-----o-------------o-----------------B------o-----------------------------------------o-------------o---o---------o-------------o------------B-o-----------------o--f
m-----oo-Xo--------------o----oo---E--------------E-----X---B---------------------o--X-o----------B-----------B-------------oX--------B-o-o-oX-------E------E---BE--X-------B---o---o-o----------E-o---X
XXXXXXXXXXXXXXXXXXXXXXXXXXXXXXXXXXXXXXXXXXXXXXXXXXXXXXXXXXXXXXXXXXXXXXXXXXXXXXXXXXXXXXXXXXXXXXXXXXXXXXXXXXXXXXXXXXXXXXXXXXXXXXXXXXXXXXXXXXXXXXXXXXXXXXXXXXXXXXXXXXXXXXXXXXXXXXXXXXXXXXXXXXXXXXXXXXXXXXXX
