--------------------------------------------------------------------------------------------------------------------------------------------------------------------------------------------------------
------------------------------------------------------------------------------X--B-----------BBBBB----------------------------------?????---------------------------------------------------------------
--------o-----------------------------------------------------------------------------------------------------------------------------------------------------------------------------------------------
-----------------------------------------------------------------BBB---------------------------???????--------------------------------------------------------------------------------------------------
--?----------------------------------------------------------------???----------------?-----------------------------------------------------------------------------------------------------------------
-------------------XX-----------------------------------------------o-------------B----XXXBBBBX---------------------------------------------------------------------------------------------------------
-----------------------------------------------------------????BBBB-------------------------------------------------------------------------------------------------------------------------------------
----------------------------------------------------------------------B---------------------------------------------------------------------------------------------------------------------------BBBBBv
--------------X-------------------------------------------------------------XXXX???????XXXXX-----------------------------------------------------------------------------------------------------------f
---------------------------------------------------------?????-----------------------------------------------------------------------------------------------------------------------------------------f
------------------------------------------------------------------------X------------------------------------------------------------------------------------------------------------------XXXXXXXX----f
------------------------------------------------------------------------XXXXXXXXX----------------------------------------------------------------------------------------------------------------------f
-????-XXXXXXXX---------------------------------------------------??????X?----------????????--X------------------------------------------------------------------------------------------------?--------f
---------------XXX--------------------------------------------------------XXX----------------XX------------T---------------------------------------------------------------?????-----------------------f
m---E-----------------------------------------------------------------------E??o????----E----XXX----------X|-------------------------------------------------------------------------------------------X
XXXXX---XX---XXXXXXXXXXXXXXXXXXXXXXXXXXXXXXXXXXXXXXXXXXXXXXXXXXXXXXXXXXXXXXXXXXXXXXXXXXXXXXXXXXXXXXXXXXXXXX|XXXXXXXXXXXXXXXXXXXXXXXXXXXXXXXXXXXXXXXXXXXXXXXXXXXXXXXXXXXXXXXXXXXXXXXXXXXXXXXXXXXXXXXXXXXX
