--?----oo-------------o---Xoo-----X---B--------B-Bo------------o-Bo-----X--------o--------X------B-o------o--o--o-----X-----B-----------------o--------o------oooB--o---B-o-ooB-----------o-B--X----oB-B
---o------o----o----------o-B---ooo-----o----------------oB--------------o----o--------B-BB---X-BBoo?------------o------o-------oB--o-------B----B---o---------Bo-B-?oo-XX--o---o-----------------?-----
-E--------X-----------B----B-------Eo---Bo-X---oo----------------o-----oo-------B-----------X------T--------oB-o--o-ooB-B---X------B-?--X-------X-B-oB-B-oo--o--------o--X---B--o----Xo-o---------------
-X------oXB--B---X----E---o--------BBB--o--T---------?----Bo-----------o---o--B---BX----B--o-------|----------o---B----o--------B---B-o--oB-----X----o----------o----oB------------X-------oo---o-----BB
--B--oo-oB--o-------o-B-o----oo------------|------------o------o-oXT--o----BB------o---------X----o|--o-----------X-o-X----o--X-o-X------B-----E-o---Xo-------oX--------B-----o-----Bo-----o-oo---oo----
-----o---B---------Bo--oX---XX------------B|-o-B-------------------|------BooB---X-Xo--B----X-----B|---o-B---B----?---B-----ooB---oo---o-------X-o---XX--BB-----------X-------o-------X-Xo-o--------o---
-Bo---B-B-------BB----B-----------o--------|------------o--X-Bo-B--|------B---?----o----o--------XX|----X---B------o------o--------B-B-------o------------oB--o-----o---o------B-----------o---X---BB--B
B-B--------------B------oo------------B----|-------------B--B----B-|------------------B-o--------o-|-Xo-------oo------o---------o---BBB--B---X-----------B--oo---B--------B-------------BoB----B----B--v
----BB--o-------------o--ooo-------oB---o--|--o-----Bo--o--o----o--|---o------o-------o--------o---|-B---o----------o-B-----o-----X---o--o-o--------o----------oXoo-------------B------o----o--o---ooo-f
B-T----o------------X---o-B-----------B----|----o----------------o-|----o----B-----B-B--------o----|-----------Bo-B---------------o-------------------B-----E--------T---------o---X------------T-X--o-f
o-|--o-oX-o------E----o--o-o---------o----o|-B-X--X--o-E--BooBT----|----------------------B--------|----B--X-B-o------X--o-----o-B-o-B--o-----o-----X----o--B-XB---o-|-B------oo----B-----------|------f
B-|-oX--B-------oB----o-------------oo-----|-?-Bo------B------|--E-|--------------o-----BB------B--|-----------o----------o-------B----B----B-------o--------o------X|-oo--o---X----------o----o|--o---f
?-|---------oo-----o-ooX-B---------B-------|------ooo---o-----|--B-|----X-B-B------B--o-----o------|-o--o---------o----------------o-o----------------o-o---BB--o----|-----B--X--------B-oBo---o|----o-f
--|-----B------o---XX--BX-B-----X--o-------|------?---o-----o-|----|-----B---E-o----oo---------BB-B|----X-----B--------o--B---o--o----o------o---o---o--B---X---B----|----------oB--o-----o-----|------f
m-|-----oE-------Boo---E--X----E-o---------|-------o---Eo--o--|--B-|---E-B--EB-----------o-o---oB-B|-------------XB--X------------------EBo-o-o-EB------o------E-E---|--------o---------------T-|------X
XXXXXXXXXXXXXXXXXXXXXXXXXXXXXXXXXXXXXXXXXXXXXXXXXXXXXXXXXXXXXXXXXXXXXXXXXXXXXXXXXXXXXXXXXXXXXXXXXXXXXXXXXXXXXXXXXXXXXXXXXXXXXXXXXXXXXXXXXXXXXXXXXXXXXXXXXXXXXXXXXXXXXXXXXXXXXXXXXXXXXXXXXXXXXXXXXXXXXXXX
