-----------------------------------------------------------------------------------------------------------------------------------------------o-------------------------------X------------------------
--------------------------------------------------------------------------------------------------------------------------------------------------B--------------------X--------------------------------
---------------------------o------------------------------------------------------------------------------------------------------------------------------------------B---o-----B-B---------------------
-------------------------------------------------------------------------------------------------------------------------------------------------------------------------------------------------X------
--------------------------------------------------------------------------------------------------------------------------------------------B--X-X-----------------X----------X---TX--------------------
-------------------------------------------------------------------------------------------------------------------------------------------------------oBBB------------------M-B--|---------------------
-------------------------------------------------------X-------------------------------------------------------------------------------------------------------------------B-----o|---------?-----------
-----------------------------------------------------------------------------------------------------------------------------------------------------------X----X-o---X----X-X----|--------------------v
-------------------------------------------------------------------------------------------------------------------------------------------------------o---------------B----------|X----B--------------f
-------------------------------------------------------------------------------------------------------------------------------------------------------------------------------???|XXBBBBX-------------f
--------------------------------------------------------------------------------------------------------------------------------------------------X---B---------------o---B-------|XXX-------B---------f
-------------------------------------------------------------------------------------------------------------------------------------------X-----XX-----B--------B-------------B--|XXXX----------------f
------------------------------------------------------------------------------------------------------------------------------------------------XXX-------T-BX----X-----o--------M|XXXXX---B-----------f
-----------------------------------------------------------------------------------------------------------------------------------------------XXXX-------|-------XX-o----B-------|XXXXXX--------------f
m-----------------E------------E-----------------------------------------------------------------------------------------------------E--------XXXXX-------|E------XXX-EX---------E|XXXXXXXXE----BBBBBB-X
XXXXXXXXXXXXXXXX--------XXXXXXXXXXXXXXXXXXXXXXXXXXXXXXXXXXXXXXXXXXXXXXXXXXXXXXXXXXXXXXXXXXXXXXXXXXXXXXXXXXXXXXXXXXXXXXXXXXXXXXXXXXXXXXXXBXXXXXXXXXXXXXXXXX|B--XXXXXXXX------------|XXXXXXXXXX---XXXXXXXX
