------o------------X-------------B----BB-o--o--------X-X----------X-oB------BB--X---------oo---o-----o--o-----B--B------------------X-------B--o--X-B-B---------------X-------------o--o--B--oo---B-----
-------oX-----------o--Xo-------X----------oX-o--------o----oo-------X-------------B-------o------oBo-o-B-----o-o----o-o---o-o--------ooE-------B-B-XB---------B-----------------------------------B----
-----------X-----oBo---o---o---o---X-o-o---T--B-------o----B------------Bo------------------o------B---o--B-----B-----o--------o------X-X------XB---X-XB-------------B--------o--B--------------------X-
-------o------o------------o-B----o--------|------------------?-----------X--o-----B-----------------o--X--X-B---BB-o-----------X-------ooo----------------------------o------B---------------o--o--BB--
-------BX----B----o-B-----E--B--o--------o-|-------B------oo-------oB--o------------------Bo--------o--o--o-o-B----B-X----------o-----o-----------------oX---B----E---o---Eo-B----B---B-X------o--------
--o-X-o-B-o-o-o------B----X-o----B-B-----Bo|--B-o--o----------------o-B--------oB--o----B---o--B-------o---oo-----B-o--X--B----------B---o--o--o---B----------T---X-----o-----------o-----o--------o--B-
-------o--oo--X---X------------o---X-X---X-|--------E---------------o---B-------o----oo-------o---X-----oBX----o-E-oo-------------------oX-------------B--o---|--------B-oE-------X-o-------o-B-----o-BX
---o--------o-------o-B--------------B----X|-----o----B--------X---o--X-o-----o---o----------------?-------------B-B-------o--Xo---X----B-B---oX------o---o-o-|---o--------oo--o-B-----o---o-o---------v
------------B-B-o?---o-o-----------B-o--BEB|--B------oo-----BBB---B--B-o--oo-oB--------------B---------BB-X----o---B-------o---o------o---B-----o--o---------o|--oB-o--X----B------------XXo----o-B----f
BB-B-o-------------o--o------o--o---o---BB-|--o--X---o----X--o---B---o---------------o-----o---------X-oo----o---------------------X-o-B----o---o-----o------B|---BB--------------B------B---oo-----o--f
---------B-X------X--BB--o-T-B------------B|-B---B--o---B-----Bo-B--------B----B----o----E-B--B-------B--------------B-----B--oo------------------------o-----|-X----B-oX-------o-----o--------X-------f
-------------X-B-----o-----|---T---o-o--oX-|--B----------o-o---------------o-------X-----X-o--------B---o---B--------B----------------o-B-----X-Bo---o------o-|--------------------------o---X-----E---f
-------o---------------B---|-o-|--oo-oX----|-X----------o------B---B-----------o----B-o--B--o----------o-o--o----X------X----o-----o-----------Bo--o-o--------|---Bo-----BX--X-B----B--B---------X-----f
------------o--------------|---|---o----o-B|--B-------------X---X-ooo--o-----E--------o-X-o------B----B---oB------------------B-o---X--X--o----B--B---o-------|--o-----X----------BB---------o--o-----of
m-o-------B--o-B-X---------|---|--X-o------|-----X-------o-B---o-------X-----E----------o-BoXo--E---------oEo-B--o-----o--B-----oX-o-E-----XoE-----B-oE-o-----|--o--o--------B-X-------------B-----X----
XXXXXXXXXXXXXXXXXXXXXXXXXXXXXXXXXXXXXXXXXXXXXXXXXXXXXXXXXXXXXXXXXXXXXXXXXXXXXXXXXXXXXXXXXXXXXXXXXXXXXXXXXXXXXXXXXXXXXXXXXXXXXXXXXXXXXXXXXXXXXXXXXXXXXXXXXXXXXXXXXXXXXXXXXXXXXXXXXXXXXXXXXXXXXXXXXXXXXXXX
