--------------------------------------------------------------------------------------------------------------------------------------------------------------------------------------------------------
-----------------------------X---------------------------------------------o----------------------------------------------------------------------------------------------------------------------------
--------------------------------------o--------------------------------------------------------------------------------------------------------------XXXXX-------o-------------------------------X------
--------------------------------------------------------------------------------------------------------------------------------------------------------------------------------------------------------
--------BBB-?--------------------------------------------------------------------------------------------------B---------------------------------------------------------------------------BBB----------
----------o-------------------------------------------------------------------------------------------X---------------------BB--------------------------------------------------------------------------
--------------------------------------------------------------------------------------------------------------------------------------------------------------------------------------------------------
------------------------------------X----------o-----------B---------------------------------------------XX-------B------------------------------------------------------------------------------------v
---BB-------???????------------------B-----------------------------------------------------------------------------------------------------------------------------------------------------------------f
-----------------X-------------------------------------------------------------------------------------------BB--------------------------------------------------------------------------------?-------f
-----XXXXXXXX---XX-------X-----o--X----------------------------------------------------XXXXXX----------------------------------------------------------------------------------------------------------f
--????---B-----XXX------XX-?---X--------------------X-----------------B------------------------------------T-----T--------------------------------------------------------------------------X----------f
-------BBBBB--XXXX-----XXXBB-------------------------------------------------------------------------------|-----|-----------------------------------------------------o--------------------XX---------f
----------T--XXXXX----XXXX---------------------------------------------------------------B-----------------|-----|---------------------------------------------------------------------X----XXX--------f
m---------|-XXXXXX---XXXXX---------------E----------------------------------------------E----BB------------|-----|---------------------------------------------------------------------XX---XXXXEE-----X
XXXXXXXXXX|XXXXXXXXXXXXXXX---XXXXXXXXXXXXXXXXXXXXXXXXXXXXXXXXXXXXXXXXXXXXXXXXXXXXXXXXXXXXXXXXXXXXXXXXXXXXX-|--XXX|XXXXXXXXXXXXXXXXXXXXXXXXXXXXXXXXXXXXXXXXXXXXXXXXXXXXXXXXXXXXXXXXXXXXXXXXX-XXXXXXXXXXXX
