----------------------------BBB--------------------------------------------------------X--------------------------B--?-B???X-------XBoXXBXX------------------------------------------X-----B-----B------
----------------------------------------------------------------------------------------X------------------M----------X---B--B----------B-B--------------------------------------------B--X-----X-------
----------------------------------------------------------------------------------------------------------M----X-o--B-----???----B--XB-M----X----------------------------------------------------?B--?--
------------------------------------------------------------------------------------------------B---B-BX--------BT-XX-B-X-MX-B-T-ooB--BBBB-----------------------------------------------X-X---X--------
-------------------?-----------------------------------------------------------------------------X-XB------X----B|--Xo-BXBXXBBX|----B-XX-T--------------------------------------------o--XXBMBBB------X-
-------------------o-------------------------------------------------B-----XB-M----T----X---------XX-----o-B--BXB|-XX--BXBX-B--|XXT-?X---|-?---------XX------------------------------------X-o----BX--X-
-----------------------------------------------------------------------------------|------------MXXX-----------X-|XXX-X---B---B|XX|--T--X|----------XXX-------------------------------MX--XXXXXTXXXX-XX-
------------------------------------------------------------X-B--------------------|----X-----B-XXXX------B------|XXXX----B----|XX|--|oBB|------X--XXXX----------------------------------XXXXX-|-XXXXXXv
---T-------------------------------------------B-----------XX-----------------M---?|????-T-----XXXXX--X---B-----X|XXXXX-T--X-X-|XX|XB|TBT|------XXXXXXX-------------------------------B-XXXXXXX|XXXXXXXf
---|--------------B--------------------------------T------XXX------X--------T------|----X|----XXXXXXX-BBBBX?--XXX|XXXXTX|T-X-XX|XX|XX||-||-----XXXXXXXX--------------------------------XXXXTXXX|XXXXXXXf
---|-----------------------------------------------|-----XXXX------XX-------|------|X--XX|---XXXXXXXT-T--XX-B-XXX|XXXX|X||-XXXX|XX|XX||-||XBBBXXXXXXXXX-------------------------------XXXXX|XXX|XXXXXXXf
---|-----------------------------------------------|B---XXXXX------XXX------|------|-----|X-XXXXXXXX|-|-XXX-XXXXX|XXXX|X||-XXXX|XX|XX||-||XX-XXXXXXXXXX------------------------------XXXXXX|XXX|XXXXXXXf
---|------------T----------------------------------|---XXXXXX------XXXT-----|------|-----|XXTXXXXXXX|-|XXXX-XXXXX|XXXX|X||XXXXX|XX|XX||X||XXXXXXXXXXXXX-----------------------------XXXXXXX|XXX|XXXXXXXf
---|------------|----------------------------------|--XXXXXXX------XXX|X----|-X----|-----|XX|XXXXXXX|-|XXXXXXXXXX|XXXX|X||XXXXX|XX|XX||X||XXXXXXXXXXXXX----------------------------XXXXXXXX|XXX|XXTXXXXf
m--|------------|----------------------------------|-XXXXXXXX------XXX|XX---|X-----|B-EE-|XX|XXXXXXX|X|XXXXXXXXXX|XXXX|X||XXXXX|XX|XX||X||XXXXXXXXXXXXXX--------------------------XXXXXXXXX|XXX|XX|XXXXX
XXX|XXXXXXXXXXXX|XXXXXXXXXXXXXXXXXXXXXXXXXXXXXXXXXX|XXXXXXXXXX----XXXX|XXXXX|XXXXXX|B---X|XX|XXXXXXX|X|XXXXXXXXXX|XXXX|X||XXXXX|XX|XX||X||XXXXXXXXXXXXXXXXXXXXXXXXXXXXXXXXXXXXXXXXXXXXXXXXX|XXX|XX|XXXXX
