------B-------o--o-X------o---o-oB----BB-o--o--------X-X-----o-----X-B---o---B--XB-----B--oo--oo--B--o--o---o-B----o------B---------X-------B--o--X-o-BB--------B---o-X-o------------o-o--B--oo---B---E-
-X--Bo-oo--------------ooo--BB----------B------------X-------o-B-------------BB-----------o--B----B---oXB--B-BBB-XB----o-------------o----------------X-----------o----------o--o--------o-----X--B---B-
------B------------Bo-----------o-----BoB--T-XB-------o-o-------------o-Bo------o------Bo---------oo------B---------o----o-X----------X-X-------B--B----o--------------o-X-Bo---oB----X--------oo-----X-
------o-o---------o-oB-----o-----oo-----o--|--B----B-----E-B---o----------Xo---------------oE-oE-----B----B--X---------o-------------o-oooo-----B----oX-o-----X--------o-----------oB------X---o-----B--
------------------XB---------B--oooB-------|--o------B-----B--------B---X--B-----X----E---B---------o---XXooo------------o-----o------o-----------------o-B-----------o-------o----E----Xo-----o----BB--
?------BBo-----------B--------o--o---------|-BBB--o----X-o------B--B--B------oo-E-----------?-------------------o-BB-----Xo-o----------o-------o-X------------T---o------oX-----XX-----B--------BBoo-?-B
-oo------oo---X-E---------B-----o--X-----XB|--o-o---o-B-------------o----oBo----B-------B---------X-------o-X-----o---X---BoX-------o--o-X-----o--------o---o-|-----oB-B---------o----oX-X-o------------
o--o-------BBo------E-BX----X--oB-o--B-----|-----o-----B---------B-B----o-----o------------------------------------B?------XBo-o-o-X---o--B---o---------o---o-|--BoX-------o---o-ooB-o-------o----o-o--v
----o-------B----?-----o-----B--------X--BB|--Bo-----oo--o--B----o----X---Bo--B-------X----------oo-o----ooo--o--B------------Eoo---oo-o---B-o---------------o|-----o--?B---B-o--B--X----B-oo---B-B-B--f
---B-o----X---o----o------o-----o-B-o----B-|-------------oX--------o-o--------o----X---X----B--------o-X-----B------o-----------------------oo----o--o--oB----|-----o-------------o---------------o-o--f
o--B------Xo-o-------BB----T----oB--o------|----------E-B-B----o-oB--oB---o--B----o-o-------o----B--o--o--B-----------X----X------o------------o----o-B-------|-X------oX-------o-----o---o----X--B----f
-----------X-------oo-o----|-X-T----------X|--------BB-o----B-X---BB-------o-------X----o------------o---o---o--B------o-o----B-oo--oXo-B---o-BB-----o--------|--------B---------------------B--------Xf
--B-------o----X---o---B---|-oB|--oo-X-o---|-----BB-o--o-B-o-B-----------B-o--oooo-B-oo-----B--B------o-oB--B-B--X---o---------o---B---o-o-----o---oo---------|-o--------o--B---------B----B-----------f
-X----------o---X--B--o----|---|---oX---B-B|----?----B--o-----o--o-oXB-o-----E-------o--X-o-----------B----B---X------------B-B----------Bo------B-ooo-B------|--o-B-o-o--o---o-B--B--B---X---X-----ooof
m-------B------------------|---|--X-o-Eo---|-B----o-B--o----o--------EoX-----B-EooEo-o---Eooo-------B-------o------X-X---XB---o-E--o-------E---------B---o-B-E|-o------B-X-o---X---------B---o----oX-X--
XXXXXXXXXXXXXXXXXXXXXXXXXXXXXXXXXXXXXXXXXXXXXXXXXXXXXXXXXXXXXXXXXXXXXXXXXXXXXXXXXXXXXXXXXXXXXXXXXXXXXXXXXXXXXXXXXXXXXXXXXXXXXXXXXXXXXXXXXXXXXXXXXXXXXXXXXXXXXXXXXXXXXXXXXXXXXXXXXXXXXXXXXXXXXXXXXXXXXXXX
