----------------B--------------------------------------------------------------------------------------------B------------------------------------------------------------------------------------------
----------------------------X-----------------B---------------------------------------------------------------------------------------------------------------------------------------------------------
------------------------------------------------------------------------------------------------------------------------------------------------------------------------------------------------------o-
----------------------------------------------------------X--------------------------------------------------X-------------------------------B----------------------------------------------------------
------------------------------?----------------o----X--------------------------------------------------------X--------------------------------------------------------------------B---------------------
-----------T----------------------------------X---M-----------B-------------------------------------X--------------------------------------------------------------------------------------------X------
-----------|---T---------------------X-------XX-M----------------X------X-----------------------------B----------------------???????-----------------------------------------------M--------------X---X-
-----------|---|--------------------XX------XXX-?-------------BBB------XX-------X---------------------------------------------------------X------------------------------------------------------XX--XXv
-----?-----|---|---?????-----------XXX----MXXXX---------------T-------XXX-------------------------------------------------------X---------------------------------------------------------------XXX-XXXf
-----------|M--|------------------XXXX----XXXXX---------------|------XXXX------------------------------------X---------B--------XX--X----------------------------------------------------------XXXXXXXXf
-----------|---|-----------------XXXXX---XXXXXXBXBBB----------|-----XXXXX-----------------------------------XX------------------XXX-XX--------------------------------------------------------XXXXXXXXXf
-----------|---|----------------XXXXXX--XXXXXXX--------------X|----XXXXXX------------X---------------------XXX------------------XXXXXXX------------------------------------------------------XXXXXXXXXXf
--?-------T|---|---------------XXXXXXX-XXXXXXXX--------X--BBBB|BB-XXXXXXX----------------------X----------XXXX------------------XXXXXXXX--------------B----------------------------X--------XXXXXXXXXXXf
---------X||---|-----------B--XXXXXXXXXXXXXXXXT--------XX-----|--XXXXXXXX---------------------XX---------XXXXX------------------XXXXXXXXX-----X--------------------------------------------XXXXXXXXXXXXf
m---------||---|-----------B-XXXXXXXXXXXXXXXXX|o-------XXX----|-XXXXXXXXX----------------E---XXX--------XXXXXX----------E-------XXXXXXXXXX------------------------------------------------XXXXXXXXXXXXXX
XXXXXXXXXX||XXX|XXXXXXXXXXXXXXXXXXXXXXXXXXXXXX|--------XXXX---|XXXXXXXXXXXXXXXXXXXXXXXXXXXXXXXXXXXXXXXXXXXXXXXXXXXXXXXXXXXXXXXXXXXXXXXXXXXXXXXXXXXXXXXXXXXXXXXXXXXXXXXXXXXXXX----XXXXXXXXXXXXXXXXXXXXXXX
