-------------------------------------------?????-----------------------------------------------------------------------------------------------------------------X--------------------------------------
----------------??---------------------------------------------------------------------X--------------------------------------------------------------------------------------------------------????----
--------------------------------------------------------------------------------------------------------------------------BBB-----------o---------------------------------------------------------------
------------------------------------------------------------------------------------------------------------------------B------------BB-----------------------------------------------------------------
---??----------------------------------------------------------------------------------------------------------------?---o----------------------------------------------------------------------BBBB----
---------------------------------------------------------------------------------------------------------------------?----------X-------?----------------------X-------M--------------------------------
------BB-----------------------------------------????--------------------------------------------------------------XXX----------BB---------------------------------o---------------B--------------??BBB-
---------------------------------------------------------------------------------------------------------------------------------XXXXXXXX-----------------------------------------??????---------------v
-----------XXXX-------------------------------------------------------------------------------------------X--------B-----------------------------------------------------XXXXX------XX-----------------f
-----------------------------------------------------------------------------------------------B-------------------------------------------------------------------------------------------------------f
------------X-------------------------------------------------------------------------------------BBBBBXoB---------XXXXXXXX-----------------------------XXXXXXX----------------------------------------f
------------XX-------------------------------------------------------------XXX------------------------------T---------------------o--------------------------------------------------------------------f
------------XXX----------------------------????????------XX-------------------------------------------------|-------????--?????------------------------------------------B----T------------------------f
----BBBBBBB-XXXX----------------------------------T---------------------------------------------------------|--????---------------------????????------------------------------|------------------------f
m?---E------XXXXX-----------------------X---------|----------------------------------------------E----------|--------E-----B---------------------------E----------------------|------------------------X
XXXXXXXXXXXXXXXXXXXXXXXXXXXXXXXXXXXXXXXXXXXXXXXXXX|XXXXXXXXXXXXXXXXXXXXXXXXXXXXXXXXXoXXXXXXXXXXXXXXXXXX---XX|XXXXXXXXXXXXXXXXXXXXXXXXXXXXXXXXXXXXXXXXXXXXXXXXXXXXXXXXXXXXXXXXX|XXXXXXXXXXXXXXXXXXXXXXXXX
