----------------------------------------------------------------------------------------------------------------------------X--M--X---B----B--------------M-B---??o?BB??M-B-X---B-B---------------------
--------------------------------------------------------------------------X----------------------------B--------B------------X--XBXXX---------X--X-----B?----BB---X--B---XX---M---X-----------------X---
-------------------------------------------------------------------------------------------------------B--------------------------BB--B--X--o-BB---B---XM---X--B--------B--BBBBBBBB-------------B-------
----------------------------------------------------------------------------------------------------------------X-----------------------???X--T------------XX-BBBBX--Bo-XB--B--BX-X-------------------X-
-X---------------------------------------------------------------------------------------------------------XB---------------B---B-???BBBBBBBBB|---X-----X--TBTBXB-o?X????--T-X--B-MX---X----X-X--XX---X-
-----------------------------------------------------------------------------------------------------------------BB----------X-B---MXB---X---o|-----X---BB-|-|BoB-BT------?|XX-----X-XXXX--XXX----?-B-X-
--------------------------------------------------------------------------------------------------------------X---B-----------B----------B-B--|-B-----o--X-|X|-BooB|--T--T-|XXX--?-BoXXX--XXXXXB-Xo--XX-
---------------------------------------------------------------------------------------------------B--------------------------XX--BB--BX--X---|---XT-X-----|-|-BBBX|--|MB|X|XX?XB---XXXX-XXXXXXXXXXXX-Xv
------------------------------XXXX-----------------------------------------------------------------------B-----------------T---X-----o-XX-XX-T|----|-XoX-B-|X|X-B--|X-|T-|X|XX-XB--XXXXXXXXXXXXXXB--XXXf
------------------------------------------------------------------------------B------------------T----------------XXXX-----|---B-------XXXXXX||----|BMXXX--|X|--X-X|-T||X|X|XXoB??XXXXXXXXXXXXXXXX--XXXf
---X---------------------------------------------------------------?-----------------------------|-------------------------|---?B------XXXXXX||----|-XXXXX-|X|X?---|X|||X|X|XXX--XXXXXXXXXXXXXXXTXX-XXXf
------------------------------------------------------------------------------------------------B|-----X---------B-X-------|---------TXXXXXXX||BXXB|-XXXXXT|X|XXTBB|B|||X|X|TTXTXXXXXXXXXXXXXXXX|XXXXXXf
-------------------------------------------------------------------------------------------------|-------------------------|-XBB-B---|-XXXXXX||XXX-|BXXXXX||X|XX|--|B|||X|X|||X|XXTXXXXXXXXXXXXX|XXXXXXf
-------------------------------------------------------B-----------------------------------------|-------------------------|---------|BXTXXXX||XXXX|-XXXXX||X|XX|XT|X|||X|X|||X|XX|XXXXXXXXXXXXX|XXXXXXf
m------------------------------------------------------------------------------E----------E------|-----?----------E-------E|-X--B-EXE|XX|XXXX||XXXX|BXXXXX||X|XX|X||X|||X|X|||X|XX|XXXXXXXXXXXXX|XXXXXXX
XXXXXXXXXXXXXXXXXXXXXXXXXXXXXXXXXXXXXXXXXXXXXXXXXXXXXXXXXXXXXXXXXXXXXXXXXXXXXXXXXXXXXXXXXXXXXXXXX|XXXXXXXXXXXXXXXXXXX-XXXXX|XXXXXXB-B|-X|XXXX||XXXX|XXXXXX||X|XX|X||X|||X|X|||X|XX|XXXXXXXXXXXXX|XXXXXXX
