---o-X---B-o----o----oB-----------------------B----------B---o--------o-------------o--B----------B-------------B----o-----------B--B--------B-----------B---o-o---o-----o-B---o-------o-------------o--
-o-------o------------o-Xo------o---B-X---------------X-----B-----------------o--------BE-----o----E---Xo--oXB-------o----oo-o---o------o--oo-----B-B----o--B---------o--B-------B---o-------o----------
--------o---B-----o-----o--o------oB--BBo-----B-------------------X--o--------o-----------B--BB--B---------B---oo--------Eo---------B------------------------B----ooB--o--B--------X--B---------o---E---
------o-B---E--o---------o---------o-B-B---o--o----?----B-oB----B-oB-o----------------Xo-XX----Bo-----o---------X-------B-------o-------o------Eo-o------B--B----------------B---o--------------Boo----X
--X-------BX--B---o-B----o---------Eo--------B-o--X--B---XX----B-----------o-------o------oX-o--o------X-----------o--B-o--o-X-o----o---o--o---------B-----o--------------X---o--o--ooX-B------X--------
B---------------o-------B----X------?---o-----o--o----o----B---------B---B-----o-o------B-----B----E-B------o-X-Bo-B-----------o------X--o------------oB------B-----BB-----E-----o---BX--E----------oXEB
---------X---------------------B-B-X--------Bo------B-o-o----------------X---o---?---X--------o-----B----Xo---o-----------TB--o--Xo---B---------o-B------X---o-o-------o---o--o-----oo----BB---o----B--o
-X--X-------o----------------o--X-B---------o-------------X-XX------ooo---o--Bo----Xo---XB---BX--B--------------o---B-----|-o---o----o-B-----------o--o-----o----------X---o--------B----o----X--------v
-----oBX----oo-------------------------E---o---oX-------B-EB----o--B--------o----B--------B---B------------------o---o-o--|-----B-----------B-------oo----BX----E-----X-BXo--------o-------B-o-X---o-o-f
B------------o----------oB--------------oX-----o--oB----o-oB--B---oo-o-------Boo-----B-------------X-----------B----------|------B------oo-----X-------------------B-EB-------------E---oX---X-------B-f
---T---B----------------------B-Bo--------o---T--B---------------o-----BB--o--oB------X-----B-o------------o--Bo----X-----|---o------------------B---o-o-------B--------o---------------X--------X-----f
--B|--B--------B--o----X------o-o-o-----X---o-|---------X-----oo----oX-Bo-----B---o-o----------X----------X--------o-o---o|--oB--B-------B----o-----B---------------------B--o-o-o---------------------f
-BB|-X--------B------o-o-----------o-X---o---o|-------------o---------o--o-----------B----oo--------X-------------------XE|------B-B---BB---B--------------B--B-----------o?-------B-o-o---o---------oXf
---|-o--B------o---o-oo----B--o--X-------o----|-o-B-B-o--------o--o-o---------E--X----------------XT-ooo-----BX--B----B---|--B-o---?-------Bo---o--X---X--------o-E-oE---B-----Xo-------o--o-----------f
m--|------Eo--B-o--o----o---------------------|-------------------XB-----oEE-B---o-B-----o--B-ooXo-|----------EoB---B--o-B|-o--oo-------o---BE-------o--oo----o---o--X--X-o------X-----E--------X-E---o-
XXXXXXXXXXXXXXXXXXXXXXXXXXXXXXXXXXXXXXXXXXXXXXXXXXXXXXXXXXXXXXXXXXXXXXXXXXXXXXXXXXXXXXXXXXXXXXXXXXXXXXXXXXXXXXXXXXXXXXXXXXXXXXXXXXXXXXXXXXXXXXXXXXXXXXXXXXXXXXXXXXXXXXXXXXXXXXXXXXXXXXXXXXXXXXXXXXXXXXXX
