-----------o-----o-o---------o----------------------------------o-------------X--X-----o-o--------B----------------o----B--------------------B----o--B-------o----o-oo-------------------X-----o---B----
-------B---------o-X---X-X-----------B--o---------oo--B---X-----X------------B-------oo---------------------o------o----------X-------B--o-------------------o-X---o--o----------------------B---o------
--X---o------------o-XB------o----E------oo------o------o--------------------------ooE-o------------B----B-o--------B--------------------o----------------B---B-B----o----------------B-----X----------o
----B--o------X--------------o-----o---------------B-----------------o-----B----o-------o-B-------o------B----------------B----B------------B---B--------o---B----B--B-o-------------------Bo---B-------
----------o-------X------o--o--B----------oo---------o--X--B--o----------o---X---------Bo---------------------B----Bo---oX--------BB---------o-----------o-B-X---B--o------ooB---o--o---X--Bo---X----o--
-------------------------B------o---o--o-----o-----o--------------B--------BooX---oBB------B--o----B-oo-----B---------o--------o--o-----B---o---X---o-X-----X--B------B-------------------o-------------
------------o---o----------X---B----o--------------------------B------B-o-----o-----------------------o----oB-ooE------------o--o-B---o---------------B-----X---------B------B-o----o---oXoB-----o------
------B--B------B-----o-----X----B-------Bo---o----B--------X--------B---o----------oX--------X------E--B-B----oX----o-o----E--B-o-o-oo-----oo----------E---------------------E---------o--------o-----v
------o--X-----------------------X-----X--------------o----o--------------o------oB----X---B----o----------------B---------oo-X-------------------o-----------B------------o---Boo-----B---?---o----o--f
--------------B-o--o------o--------o-X-o-o-o---------------X-----o-----------------B---------------B----------B-----------o---B--o-------------------Xo--X-----------o-------------o----E--------------f
------B---X------X-----------------o--------BB--B---B----o--------B----o-------BB------------BB------B----------------------o--------XX----------X-----------B-----o--o-----B-B-B----XB---o------o--E--f
--------oo---X-----o----o-o--BB-B------Bo-----X--E---X-X---o------X-----o---oB-----------B-B----B-------------------------E--------B-------oB-B-------XB-Xo----oX-------------B-----BoB--B-Bo---X-X-BXof
-----X-------------X--o--B-------o--X-B-B------X---o------------BX--E---------BBBo----------o--------------o-o-B----------o-----B-o----------------o-----oo-o-X-o---o--BoX--o-----X--B---o----B--o-o---f
----o-----o---o-------o----o------------B----B---o-o------X-----oX------o---XXB----------------X---o--X-----X---BB---o------o------------B--o----o-----o-----B--X---B------------B-E----oo-----o-------f
m---------------o-X--------X---o---BE---o------X------------Bo---B-------E-o------o--------E--oo-------------------o---XX----------B-------B-----B---B--o-----X-Bo----X------X------o---Bo-o-----------X
XXXXXXXXXXXXXXXXXXXXXXXXXXXXXXXXXXXXXXXXXXXXXXXXXXXXXXXXXXXXXXXXXXXXXXXXXXXXXXXXXXXXXXXXXXXXXXXXXXXXXXXXXXXXXXXXXXXXXXXXXXXXXXXXXXXXXXXXXXXXXXXXXXXXXXXXXXXXXXXXXXXXXXXXXXXXXXXXXXXXXXXXXXXXXXXXXXXXXXXX
