---------------------------------------------------------------------------------------------------B--------------------------------------------------BB?????---XB--M-----X---o--------?-----------X----
-------------------------------------------------------------------------------------------------------------------------------------------------------X--------B---B-M-----------------?XXXXXX--X------
---------------------------------------------------------------------------------------------------------------------------------------------------M---------?------B------B-------X-------BBBB---------
-----------------------------------------------------------------------------------------------------------XXXXXXX------------------------------------------------------------X---o--B--X---------------
------------------------------------------------------------------------------------------------------------------------------------B-----X---X--------B-------------T----X----------XB-------------XoX-
-----------------------------------------------------------------------------------------------------------------------------B----X------XX--X------B---B---B--------|-------X-M-------M-----------MX-X-
---------------------------------------------------------------------------------------------------------X---------------------BXBBBBB--XXXX----------------------BX-|----------X-X-?------------BBX--X-
--------------------------------------------------------------------------------------------------B--------------------------X---X-----XXXX---------T--------BB------|--------X---XX--X-B-----X----B--Xv
---B----------------------------------------------------------------------------------------------------------------------------------XXXXXX--------|XXXXXX----XX---X|---------o--XXX-----B---??X???B?Xf
-----------------------------------------------------------------------------------------------------------------------------------B-XXXXXXXX-------|B----------X---X|--T---B--TXBXXXX--X-XB----XX----Xf
------------------------------------------------------------------------------------------------------------------------------------XXXXXXXXXX------|X-?------------X|X-|------|-TXXXXX--XX-----XXXB-BXf
-----------------------------------------------------------------------------------------------------------------------------------XXXXXXXXXXXX-----|XX------X---X--X|XX|----BB|-|XXXXXXXTX-----XXXXXXXf
----------------------------------------------------------------------------------------------------------------------------------XXXXXXXXXXXXXX----|XXX------------X|XX|------|-|XXXXXXX|X-----XXXXXXXf
-----------------------------------------------------------------------------------------------------------------------B---------XXXXXXXXXXXXXXXX--X|XXXX--B---X----X|XX|X-----|T|XXXXXXX|X--B--XXXXXXXf
m-B-----------------------------------------------------------------------------------------------------------------------------XXXXXXXXXXXXXXXXXX--|XXXXX----E-----X|XX|XX-o-E|||XXXXXXX|XB-B--XXXXXXXX
XXXXXXXXXXXXXXXXXXXXXXXXXXXXXXXXXXXXXXXXXXXXXXXXXXXXXXXXXXXXXXXXXXXXXXXXXXXXXXXXXXXXXXXXXXXXXXXXXXXXXXXXXXXXXXXXXXXXXXXXXXXXXXXXXXXXXXXXXXXXXXXXXXXX|XXXXXXXX-----XXX|XX|XXX---|||XXXXXXX|XX--?XXXXXXXXX
