-------------------------------------------------------------------------------------------------------------------------------------------------------------XXXXXXX---------------------------------o--
--------------------------------------------------------------------------------------------------------------------------------------------------------------------o------------------X---------o------
--------------------------------------------------------------------------------------------------------------------------------------------------------------------------------X-----------------------
--X-----------------------------------------------------------------------------------------------------------------------------------------------------------------------------------------------------
-----------------------------------------------------------------------------------------------------------------------------------------------------------------------T--------------------------------
-----------------------------------------------------------------------------------------------------------------------------------------------------------------B-----|----T---B--------------X--------
---------------------------------------------------------------------------------------------------------------------------------------------------------------------X-|-oXB|-----------oBB----??X------
--------------------------------------------------------------------------------------------------------------------------------------------------------------------XX-|-XX?|???----------B------------v
-------------------------------------------------------------------------------------------------------------------------------------------------------------------XXX-|XXX-|------??------X-----------f
------------------------------------------------------------------------------------------------------------------------------------------------------------------XXXX-|XXX-|------------------B-----XXf
-----------------------------------------------------------------------------------------------------------------------------------------------------------------XXXXXX|XXX-|--------------------X-----f
----------------------------------------------------------------------------------------------------------------------------------------------------------------XXXXXXX|XXX-|------M------------XXXX---f
----------------------------------------------------------------------------------------------------------------------------------------------------------BBBBBXXXXXXXX|XXX-|---------------T--XXX-B---f
--B-----------------------------------------------------------------------------------------------------------------------------------------------------------XXXXXXXXX|XXX-|---------------|-XXXX-----f
m------------------------------------------------------------------------------------------------------------------------------------------------------------XXXXXXXXXX|XXXX|Eo-------EE--E-|XXXXX-EE--X
XXXXXXXXXXXXXXXXXXXXXXXXXXXXXXXXXXXXXXXXXXXXXXXXXXXXXXXXXXXXXXXXXXXXXXXXXXXXXXXXXXXXXXXXXXXXXXXXXXXXXXXXXXXXXXXXXXXXXXXXXXXXXXXXXXXXXXXXXXXXXXXXXXXXXXXXXXXXXXXXXXXXXXX|XXX-|X--XXXXXXXXXXXX|XXXXX--X--X
