-----------------------------------B-----X--------------------------------------------------------------------------------------X-----XXXXX-------------???M?-----------------X--------??B??------------
-------------------------------------------------------------------------------------------------------------M-B-----------M----X---------?------X---------X---------------BBBXBBBX---------------------
----------------------------------------------------------------------------------------------------------------------------B--------X----o------------B---------X----?--BX----------B------------------
--------------------B-----X--------------------------X--------------M---------------------------------B-------------------T---XB-----------------------------------T------------------------------------
------B-------------X--------------------X---------------------------------B------X--------------------------X----------X-|--BB-----XT----o------------------B-----|--------T---B--X-------B------------
-----M--------------------T--?---------------X---X-------------X-B---------------X--------------------------XX---------XX-|--T-------|---------------------XXX-----|--------|---------------------------
----------------------B---|T----o------B-o---------------------XX-B---------------oB--T----B---------------XXX--------XXX-|--|--T----|---------BB--X-B----T--------|XBBB-X--|------------------------XB-
------------------------B-||----B--------------B---B-X---------XXX---------X----------|??????---X---------XXXX-?----XXXXT-|--|--|-X-?|--B-X----XBBBXBBX---|--------|-?---XX-|------------------X-------v
--------------------------||-X----B-?---------------------B---BXXXX--------XX---------|---B------B-B-----XXXXXo-----XXXX|-|--|--|---o|-------BXX----------|X--T----|-----XXX|-B------------------------f
-------------------------X||-XXT--------------------X-BBXBB----XXXXX-------XXX----B---|-----B-----------XXXXXX---B-XXXXX|B|--|--|----|X------XXX---X--T---|--B|----|-----XXX|-----???X????-X---o------Bf
------------------------XX||-XX|------------------X--X-B---B---XXXXXX------XXXX---????|???------X------TXXTXXX----XXXXXX|-|--|--|---M|XB----TXXX-T-XX-|--X|---|----|-----XXX|X-------------------------f
-----------------------XXX||BXX|X----------------X-----------o-XXXXXXX-----XXXXXT-----|--X----------BXX|XX|XXXX?-XXXXXXX|-|--|--|----|X----X|XXXX|-XXX|X--|-B-|X---|-----XXX|XX----------------BB--BBBBf
------------------X---XXXX||-XX|XX-----B--------XXX-----B---X--XXXXXXXX----XXXXX|----B|--------------XX|XX|XXXXXXXXXXXXX|-|-X|--|---B|XX-XXX|TXXX|-XXX|X-X|XX-|XX--|---XBXXX|XXX---------B----------X--f
-----------------X---XXXXX||XXX|XXXo----T------X-XXX----X--XX--XXXXXXXXX---XXXXX|X-o--|-----Xo--o---XXX|XX|XXXXXXXXXXXXX|-|X-|-X|----|XXXXXX||XXX|-XXX|X--|-XX|XXX-|-----XXX|XXXX----------------------f
m----E--------------XXXXXX||-XX|XXXXE---|-EE-E-E-XXXX----BXXX-BXXXXXXXXXX?-XXXXX|XX---|------------XXXX|XX|XXXXXXXXXXXXX|-|--|-X|----|XXXXXX||XXX|XXXX|XX-|-XX|XXXX|-----XXX|XXXXX-------E------------EX
XXXXXXXX----XXXX---XXXXXXX||XXX|XXXXX-XX|XXXXXXXXXXXXXXXXXXXX--XXXXXXXXXXXXXXXXX|XXXXX|XXXXXXXXBXXXXXXX|XX|XXXXXXXXXXXXX|-|XX|XX|XXXB|XXXXXX||XXX|XXXX|XXX|-XX|XXXX|XXXXoXXX|XXXXXXXXXXXXBB--------XXX-X
