-----------------------------------------BBBBB--------------------------------------------------------------------------------------------------------------------------------------------------------M-
--------------------------------------------------------------------------------------------------------------------------------------------------------------------------------------------------?--M--
--------------------------------------------------------------------------------------------------------------------------------------------------------------------------------------XXoo---X----------
----T-------------------------------------------------------------------------------------------------------------------------------------------------------------------------------------------B-T-----
----|---------------------------------------------------------------------------------------------------------------------------------------------------------------------------------o----X-M---M|---B-
----|-------------------------------------------------------------------------------------------------X-----------------------------------------------------------------------------------X----B--|-TT?-
----|-------------------------------------------------------------------------------------------------XX----------------------------------------------------------------------------o---o-TXX---oX|X||--
----|--------------------------------------------------------------T--------BB------------------------XXX---------------------------------------------------------------------------T----X|XXX--XT|X||Xv
----|--------------------------------------------------------------|-------------------------o--------XXXX--------------------------------------------------------------------------|-----|XXXXXX||X||Xf
----|--------------------------------------------------------------|-------------------B--------------XXXXX---------------------------------------------------------------M---------|-----|XXXXXX||X||Xf
----|---------------------?----------------------------------------|------------------------X---------XXXXXX----------------------------------------------------------------------o-|---X-|XXTXXX||X||Xf
----|--------------------------------------------------------------|------------------------XX---T----XXXXXXX---------------------------------------------------------------------??|?T?o?|XX|XXX||X||Xf
----|----------------------------T---------B-----------------------|------------------------XXX--|----XXXXXXXX----------------------------------------------------------------------|-|-oX|XX|XXX||X||Xf
----|----------------------------|---------------------------------|------------------------XXXX-|----XXXXXXXXX-------------------------------------------------------------------T-|-|-XX|XX|XXX||X||Xf
m---|----------------------------|---------------------------------|-------------------E----XXXXX|----XXXXXXXXXX------------------------------------------------------------------|-|E|XXX|XX|XXX||X||XX
XXX-|------XXXXXXXXXXXXXXXXXXXXXX|XXXXXXXXXXXXXXXXXXXX--------XXXXX|XXXXXXXXXXXXXXXXXXXXXXXXXXXXX|XoXXXXXXXXXXXXXXXXXXXXXXXXXXXXXXXXXXXXXXXXXXXXXXXXXXXXXXXXXXXXXXXXXXXXXXXXXXXXXX|-|X|XXX|XX|XXX||X||XX
