------o--XB--------------B----o-----------------------o----------------Boo-o----------o---X--------o---XB----B-------o-B------------------X----------X--Bo------XB------------B---------------X------B--
-------------------B--B----X-B--------o--o--B------o--B---------------------------o--------B----o-----o----o-----o--------------------o-o---------------o----o-X--oo--oo-------o-o---X---o----o---------
-X-----o-------o--X-----X---------B---X-B-------------B---------------------o--X--------B-oB-----?--------B------B--------B--E--X-------B---o-X-XB--B--B-oo--------o-------o---BBo--------------X---B---
----BB---o---------o--------------Xo----------E----B-o-------Xo-----o-------B-----BX-------?--oo---B-----X-o--X-------------------------B---B------------X-------X---B--o-XB----X---------------B-------
--------------------------------B-----o-----B------X--o-B--o---------------------o-----------o---B-----oX---B--o-B-----oB---o--B--E-o----X-------X---B-X-------E----o-----B-----X-B---------------------
---B-B-oB-------o-ooo----------X--B---o-----------------------o--------B------------B-------B-------------BE--B-----------X-o---o----X-------------o----o----------X------------B---B--------o-------B--
------X---X------o--X-o----------o-X--o-----o--o-----------B---------o--X----o--------------------o-------o------B---B-o--E---o-o--ooE-------------------------------o-------------------o----XB----X---
-----------------------oX---B----E-----XX-B------o-B----oo---------B-----B--o---------------B-------------------o-----Boo------------o---X--------------B-o------B-o--B----------B-------BBo--oB-------v
--B--o--------------B-E-----o-------o--X--o--o--------o---B-o-o-----------oo------o--o----------------o------o--o-Bo------B----------X---------------------------------BB----------B--o--------B-o-B---f
-------------------------X-o--------X------o------E----o-o----o------o---B-------------o--E-----B-----------o--------Xo----o--------------o--XX-------BX-------o----oo------oB--B--B---X-o---o-------o-f
------o---B--X---B-----o----o-----o------B-E---o-------Bo------o------o-----E--------?------o---------o----o-B-------o---o----------------B---o---B-------oo--oB---o-----o---o---------o------?------oof
----------------X------o-----B-B-----B--E---------o------------o-------Eo--o-oo-------------------------------------B-B------oBo-------------B---------------o--------o------X---o-o--B------o----B----f
-------o------o--o---o------------o----X-B--------------------oo-----------o---o--o---------o-----------------o---o-B----------o--B------B--B------B-B------B----------o--B----B---o--------o--X----X--f
---------o--o---Bo--B-B------o-----------------X---o----------B-----B-------X---------o------E--B--o----X----------X-------o----oo--B---B-E-B------o-----oX------o-------------B---oo--o----XX-------oXf
m------o----------X-----oo-----X------------------B------------------o--XB------------------o-B----ooB--X-o----------E--oo--------E-B-o---B-------B--B---------BoX--oX-----o------oB-Bo----o--E---B-o---
XXXXXXXXXXXXXXXXXXXXXXXXXXXXXXXXXXXXXXXXXXXXXXXXXXXXXXXXXXXXXXXXXXXXXXXXXXXXXXXXXXXXXXXXXXXXXXXXXXXXXXXXXXXXXXXXXXXXXXXXXXXXXXXXXXXXXXXXXXXXXXXXXXXXXXXXXXXXXXXXXXXXXXXXXXXXXXXXXXXXXXXXXXXXXXXXXXXXXXXX
