-XXXXXX-------------------------------------------------------------------------------------------------------------------------------------------------------------------------------------------?????-
--------------------------------------------------------------------------------------------------------------------------------------------------------------------------------------------------------
------BBBBBB-------------------------------------------------------------------------------------------------------------------------------------------------------------------------------------X------
--------------------------------------------------------------------------------------------------------------------------------------------------------------------------------------------------------
-------------------------------------------------------------------------------------------------------------------------------------------------------------------------------------------BBB----------
--------------------------------------------------------------------------------------------------------------------------------------------------------------------------------------------------------
---------------------------------------------------------------------------------o----------------------------XXXX--------------------------------------------------------------------------------------
-----XXXXX----------------------------------------------------??????---------------------------------------------------------------------------------------------------------------------------------??v
-----------------------------------------------------------------------------------------------------------------------------------------------------------------------------????????------------------f
-----------------------------------------------------------------------------------------------------------------------------------------------------------------------------------------------?-------f
----------BB-------------------------------------------------------------------------------------------------------------------------------------------------------------------------------------------f
---XBXXXX-----------------------------------------------------------------------------------------------------------------------------------------------------------------BBB--X--T---------X----------f
-----------------------------------------------------------------------------------------------------------T----X-----------------------------------------------------------------|-???????-XX---------f
-------------------------------------------------------------------------------T---------------------------|---XX-----------------------------------------------------------------|----X----XXX--------f
m---------------------------------------------------------------------------E--|---------------------------|--XXX---------------------------------------------------E-------------|----XX---XXXX-E---o-X
XXXXXXXXXXXXXXXXXXXXXXXXXXXXXXXXXXXXXXXXXXXXXXXXXXMXXXXXXXXXXXXXXXXXXXXXXXXXXXX|XXXXoXXXXXXXXXXXXXXXXXXXXXX|XXXXXXXXXXXXXXXXXXXXXXXXXXXXXXXXXXXXXXXXXXXXXXXXXXXXXXXXXXXXXXXXXXXXXX|XXXXXXXX-XXXXXXXXXXXX
