---------------------------------------------------------------------------------------------------------------------------------------------------------------------------B---------------o------------
-----------------------------------------------------------------------------------------------------------------------------------------------------------------------------------B--------B-------B---
-----------------------------------------------------------------------------------------------------------------------------------------------------B--------------------o-----B-B----------B----------
-------------------------------------------------------------------------------------------------------------------------------------------------------X------------------------------------------------
---------------------------------------------------------------------------------------------------------------------------------------------------------T------------X------?????----------------B-----
--X------------------------------------------------------------------------------------------------------------------------------------------------------|-----------XX-------------------------------X-
---------------------------------------------------------------------------------------------------------------------------------------------------------|???-------XXX------------X----------------X-X-
---------------------------------------------------------------------------------------------------------------------------------------------------X-----|---------XXXX----X---?---XX---------------X-Xv
---------------------------------------------------------------------------------------------------------------------------------------------------XX----|------X-XXXXX------------XXX--------------T-Xf
---------------------------------------------------------------------------------------------------------------------------------------------------XXX---|-X-----XXXXXX------------XXXX----------X--|-Xf
--------------------------------------------------------------------------------------------------------------------------------------------------XXXXX--|------XXXXXXX--T---------XXXXX-----B------|-Xf
-------------------------------------------------------------------------------------------------------------------------------------------------XXXXXXX-|-----XXXXXXXX--|T----B---XXXXXX-----------|-Xf
------------------------------------------------------------------------------------------------------------------------------------------------XXXXXXXXX|---XXXXXXXXXX--||---B----XXXXXXX---------T|-Xf
-----------------------------------------------------------------------------------------------------------------------------------------------XXXXXXXXXX|---XXXXXXXXXX?-||--------XXXXXXXX--------||-Xf
m---------------------------------------------------------------------------------------------------------------------------------------------XXXXXXXXXXX|X-XXXXXXXXXXX--||--------XXXXXXXXX??-EE--||-XX
XXXXXXXXXXXXXXXXXXXXXXXXXXXXXXXXXXXXXXXXXXXXXXXXXXXXXXXXXXXXXXXXXXXXXXXXXXXXXXXXXXXXXXXXXXXXXXXXXXXXXXXXXXXXXXXXXXXXXXXXXXXXXXXXXXXXXXXXXXXXXXXXXXXXXXXXX|XXXXXXXXXXXXXXX||XXXXXXXXXXXXXXXXXX-----X||XXX
