--------------------------------------------------------------------------------------------------------------------------------------------------------------------------------------------------------
-----------------------------------------------B--------------------------------------------------------------------------------------------------------------------------------------------------------
--B--------------------------------------------------------------------------------------------------------------------------------------X--------------------------------------------------------------
--------------------------------------------------------------------------------------------------------------------------------------------------------------------------------------------------------
--------------------------------------------------------------------------------------------------------------------------------------------------------------------------------------------------------
--------------------------------------------------------------------------------------------------------------------------------------------------------------------------------------------------------
-------------------------------------------------------BBBBBBBB----------------------------------------------------------------------------------------------------------------BBBBB--------------------
------------------------------------------------------------------------------------------------------------------------------------------------------------------------------------------X------------v
-----------------------------------------------------------X-------------------------------------------------------------------------------------------------------------------------------------------f
----------------------------------------o----------------------------------------------------------------------------------------------------------------------------BBB-------------------------------f
--------------------------------------------------------------------o-------------------------------------------------------------------------------------------------------X--------------------------f
-----------------------------------------------------------------------------------------------------------------------------------------------------------------B----------o---------X----------------f
------------------------------------X--------------T---X---------------------------------------------X-------------------------------------------------------------------------------XX----------------f
---------------------------------------------T-----|--XX-----------------------B---------------------XX-----------------------------------------------------------------------------XXX----------------f
m-------E------------------------------------|-----|-XXX-----E---------------------------------------XXX---------------------------------------------------------------B-----------XXXX----------------X
XXXXXXXXXXX------XXXXXXXXXXXXXXXXXXXXXXXXXXXX|XXXXX|XXXXXXXXXXXXXXXXXXXXXXXXXXXXXXXXXXXXXXXXXXXXXXXXXXXXXXXXXXXXXXXXXXXXXXXXXXXXXXXXXXXXXXXXXXXXXXXXXXXXXXXXXXXXXXXXXXXXXXXXXXXXXXXXXXXXXXXXXXXXXXXXXXXX
