-------B---oX----B-------B-------B-o-B---------B---o------X--------o--X--------oo-----o-o-------X-o--B--X--o---X------------B---B-------------oB--------o----B-X------------o---B----XXo---B------X-----
-----o-------B-oo----------o----------X-o----------BoX-------------X-o------------B--------------oBB-oo---o----------o--Xo--o------o----B-----o-oo------o--Bo--B---------Bo--BBBB-Boo------------o---o-o
----------------X------------oX----o-o-------B--------ooo-------o-XB--B-T-----o-------oB------------B-----------o------EB----X-------B-----B--------------------X-----------------o-----o-o----o--o---o-
-------oo------------B---o-Eo------o-E--X---o--o---B----Bo---o---B----Bo|------------o---------oX---B------X------o----X-----oo-------------------------o-----o-------o---o----o--------o-o--B---B-----o
B--B------------B---------XX--o--T---B-------o----------Xoo---BX------oB|-o-----o-X-----o-----------------oBo-oT----B?--------o--o-----------------BB------------X--o--------X---o----X-------o-------B-
------------E-o------------------|--------o---------oB---o--------------|---B-BX-T------o--B---B-X----BB-------|-------B-----X--o--B-B----------B----o----o----X-o--------o-------B-B-------------------
---o-B-o----B-X---o--Bo---B------|-o-BE---o-o---------------X--B--------|-B-o-o-B|-o-XB-------o-----------T----|----B--B--------o---o--B-E----E-E---BBX-o----B--o----B-o---B--o-----o-XX-----B---B-oX-B-
--------oo-Boo-------B----o------|----Bo-----Xo-------o-B-o-B-o--B----B-|---o--o-|-o----------------------|----|-------------o-----o-B---BoX--?-B-------------o---B-B----o--B--------E---------B---X---v
-o---o-X--o--------------BB------|--B------------------oo--------B---o--|--oB---o|----------X----X-oXo----|----|---------------------B-----?-B-----X----------B-BB-------o-----------XB---------B------f
---E---B---B-B---o---------------|-----B-o---------------B-------o------|---o--Bo|-------------------o----|---B|-o---B----E--X-o------------B----o--o--------o----------B-----B------o-o-o---------o---f
---B------o-o-----X-----------o--|-----B--B------B-o------------------B-|---E----|-------------------T----|-E--|-X--X-----X--o-o-----B-----X-T---------oX---X--o----o----X-o------o---------XX---o-o--Bf
--T--------------------B--B--EB--|---------o----oo----o--X-o--o--X-----B|---B---B|-B-------------X--o|--o-|-B--|-------o----B-B--------------|------o---------o----------o-oB-o-X----------B-----------f
-o|------o-----------------o-?---|----XE-E----B-oo----o--B------B-------|-------o|---B-o---o-----B---|----|----|----------o-B----o--------oX-|--T--------o--BX---------------o--------------o----o-----f
--|----------------------B-X-----|-----B-B-------XX---B--o-o-----o-B----|---B----|-----?-------------|----|----|-B------B--B------------B-oX-|--|---B-B------B------oo------------B--B--------o----oo--f
m-|--B---o---B-------BX--B-------|------o------o-o--E-B--------BBB-----E|----o---|--------oEo-o---Bo-|----|----|---------XB--o---B----------E|--|-o--EX--o----------EX--oBB---E--B----E-X--------------X
XXXXXXXXXXXXXXXXXXXXXXXXXXXXXXXXXXXXXXXXXXXXXXXXXXXXXXXXXXXXXXXXXXXXXXXXXXXXXXXXXXXXXXXXXXXXXXXXXXXXXXXXXXXXXXXXXXXXXXXXXXXXXXXXXXXXXXXXXXXXXXXXXXXXXXXXXXXXXXXXXXXXXXXXXXXXXXXXXXXXXXXXXXXXXXXXXXXXXXXX
