------------------BB------------------------------------------------------------------------------------------------------------------------------------------------------------------------------------
-------------------------------------------------------------------------------------------------------------------------------------------------------------------------XXXXX-XXXX---------------------
---------------------------------------------------------------------------------------------------------------------------------------------------------------------------------------M----------------
-----------------o------------------------------XXXXBBBBBB----------------------------------------------------------------------------------------------------------------????????----------------------
----------------------XXXXXXXX-BBBBB--------------------------------------------------------------------------------------------------------------------------------------------------------------------
--------------XXXXXXX---------------------------------------------------------------------------------------------------------------------------------------------????-----------------o----------------
------------------------?????-----------------------B---------------------------------------------------------------------------------------------------------------------------------------------------
------------????BBBBBB--------------------------------XXXXXXXX-----------------------------------------------------------------------------------------------------------------------------------------v
---------------------------------------------?-------------------------------------------------------------------------------------------------------M-------------------------------------------------f
------------------?------------------------------------------------------------------------------------------------------------------------------------------------------------------------------------f
-------------------------------------------------------------------------------------------------------------------------------------------------------------------------------------------------------f
---------------------------------------------------------------------------------------------------------------------------------------------------------------------------------T--T------------------f
---------------------------------------------------------------------------------------------------------------------------------------------------------------------------------|--|------------------f
------------------------------------------------------------------------------------------------------------------------------------------------BBBBBBBB-------------------------|--|------------------f
m-------------------------------BBBBBB-------------------------------------------------------------------------------------------------------------------------------------------|--|----------BBBBBBBBX
XXXXXXXXXXXXXXXXXXXXXXXXXXXXXXXXXXXXXXXXXXXXXXXXXXXXXXXXXXXXXXXXXXXXXXXXXXXXXXXXXXXXXXXXXXXXXXXXXXXXXXXXXXXXXXXXXXXXXXXXXXXXXXXXXXXXXXXXXXXXXXXXXXXXXXXXXXXXXXXXXXXXXXXXXXXXXXXXX|XX|XXXXXXXXXXXXXXXXX-X
