----------------------------------------X------------------------------------X--------------------------------------------------------------------------------------------------------------------------
------------------------------------------------------------B--------------------------------------------------------------------------------------------------------------B----B-------o---????????----
-----------------------------------------------------B------------------------------------------B-----------------------------------------------------------------?-------------------------------------
-------------------------------------------M---------------------------------------X---------------------------------------------------------------------------------------T----------------------------
------------------------------------------------------------------------------------------------------------------------------------------------------------------------T--|-----------------------B----
----------------------------------------------------------------------------------X--------------------XXXXXX-----------------------------------------------------------|--|-------------X--------------
-----------------------------------------------X----------------------------------------------------------------------------------------------------------------------B-|--|----------------------------
-----------------------------------------------------------------------------X------------------------------------------------------------------------------------------|--|---------------------------v
-------------------------------------------------------------------------------------------------------------------------------------------------------------??????-----|--|-----o---X-----------------f
------------------------------T--------------------------------------------------------M--------------------------------------------------------------------------------|--|-------TXX-----------------f
------------------------------|---T------------------------------------------------------------------------------------------------------------------------------X-----X|--|---oT--|XXM----------------f
------------------------------|---|--------------------------------------------------------------------------------------------------------------------------X--BXX-----|-X|----|-X|XX------X----------f
------------------------------|---|------------------------------------------------------------------------------------------------------------------------------XXX----|--|-X--|XX|XX-----------------f
------------------------------|---|---------------------------------------------------------------XXXXXXX--------------------------------------------------------XXXX---|--|XX--|XX|XX-----------------f
m------------E----------------|--X|-----------------------------------------------------------X---------------------------------------------------------E--------XXXXX--|--|XX-X|XX|XX-----------------X
XXXXXXXXXXXX----XXXXXXXXXXXXXX|XXX|XXXXXXXXXXXXXXXXXXXXXXXXXXXXXXXXXXXXXXXXXXXXXXXXXXXXXXXXXXXXXXXXBXXXXXXXXXXXXXXXXXXXXXXXXXXXXXXXXXXXXXXXXXXXXXXXXXXXXXXXXXXXXXXXXXXXX|XX|XXXX|XX|XXXXXXXXXXXoXXXXXXXX
