--------------------------------------------------------------------------------------------------------------------------------------------------------------------------------------------------------
--------------------------------------------------------------------------------------------------------------------------------------------------------------------------------------------------------
--------------------------------------------------------------------------------------------------------------------------------------------------------------------------------------------------------
--------------------------------------------------------------------------------------------------------------------------------------------------------------------------------------------------------
-----------------------------------------X--------------------------------------------------------------------------------------------------------------------------------------------------------------
----------------------------------------XX--------------------------------------------------------------------------------------------------------------------------------------------------------------
---------------------------------------XXX--------------------------------????--------------------------------------------------------------------------------------------------------------------------
--------------------------------------XXXX-------------------------------------------------------------------------------------------------------------------------------------------------------------v
----------------?--------------------XXXXX-------------------------------------------------------------------------------------------------------------------------------------------------------------f
------------------------------------XXXXXX-------------------------------------------------------X-----------------------------------------------------------------------------------------------------f
-----------------------------------XXXXXXX-------------------------------------------------------XX----------------------------------------------------------------------------------------------------f
----------------------------------XXXXXXXX-------------------------------------------------------XXX---------------------------------------------------------------------------------------------------f
---------------------------------XXXXXXXXX------------------------------------------------------XXXXX--------------------------------------------------------------------------------------------------f
--------------------------------XXXXXXXXXX-----------------------------------------------------XXXXXXX-------------------------------------------------------------------------------------------------f
mE------------E----------------XXXXXXXXXXX--------------E-------------------------------------XXXXXXXXX------M-----------------------------------------------------------------------------------------X
XXXXXXXXXXXXXXXXXXXXXXXXXXXXXXXXXXXXXXXXXXXXXXXXXXXXXXXXXXXXXXXXXXXX-----XXXXXXXXXXX-----XXXXXXXXXXXXXXXXXXXXXXXXXXXXXXXXXXXXXXXXXXXXXXXXXXXXXXXXXXXXXXXXXXXXXXXXXXXXXXXXXXXXXXXXXXXXXXXXXXXXXXXXXXXXXXX
