-B-------o-o-o-----------------B------o------Bo-----------X------o-----------o-----B---B-------------------B-oo-------B---B----B----------oB-B-o---------------o---o--X------o---------------------B--B-
ooo-o--o--B---o-X---o-ooX---o-o----------------X--X-----X---B-X-------------o---BX---o--B------------o--------------o-o----------X-B---o------B--oB-------o-B---------Boo---------------X--------X--o---
-----B-B----B---------------B------Bo--------------------B------B---------o-X---------o------BB--E----X----------------o-------------o------B---o-----B-----------o--------BoB----X-X--o------o-------B-
-o----oo----o------o--BBooB--Bo---oX-oB--o--X------o-X-o-o----------o---o------------X--o--B-----X-------B-B-o-----B---B-----o--------o----o---Eo------B-B--------o-----B--o--------------oX-o---B--X---
--o---------X----o--------------------------Xo---oB-----X---------B-B--oo---X----BX--o-B-----B-----------o-X----------o---oX--o---X-o-----------------oo-o--BXB--o-Boo-B--E--o-XB-B--EB----X--oX---BB---
--------B---B---Bo--o-B-o----BX---------B---o-oX-X---o--B--B--------------------o----X-----oo-B--Eo----E----------------X-----o-----o----o--BB---Xo----------oB----------------Bo--o-B-o-----o----B---o-
------o-o--------E--------o-Eo---o-B--o-o----o-----B----B---o--------X-BBo-----B-----B-Bo-o-----B----o-----Xoo---o--------T-----B----------Bo--------E-----X------o----o----B--------o-X-o----B----B-o--
---B---------oo-------------------o--oX--B-------BB---B-------o----o-o---B---------o-----B-E-B------o---?---o-B-o---------|----o---B-----------------------EBo---------B-----oo-------B------E---B-----v
o---B---------oBo-----E--oX------o-----------o-------------X--------o---------X--------oB--B------Bo--------o-------------|-------------B------------o---------o-o----o---B-----------------o-o------o-f
--------o-----B-------X-B-X--oo-----------------------B------X--o-----XXo--------X--B-----o-------XoBXo----o-------B-E--B-|-------B-------------o----o-----X---ooo-o-B--X-------oo-Bo-o----B-B--o---o-Bf
-B-T---o--o----B-oo-E---------X----oB---------T----------B-----o-o--o----X-------o-----------B-X---o-o-Bo--o---BB---------|-----B----o---------X-------oB---------oB-----o--------o--?----BoB--------o-f
-E-|----E---B----------o---------------------B|--Bo------------o-o--o--X--B--X---o-----B--------X----------X-------------o|----ooX--o-B------------X-----B--o------XB-----B---------B------------o-B---f
-Bo|----B----o-------ooB-oo-------E--o--E-----|-------oB---o-Bo-----o--B-------?-B------X----E------X------BX------------o|-----Xoo-------------XX-----------XB---o-------B?-X--ooBB---X------ooX------f
---|------------X-o-------o-------o---EX-----o|---oE--B--X----------B---oBo---------------?--------B-B-o--B---B---X----o--|---o--o--oB---o--oB---o--------BB-E----E---------------B-----Xo--------o----f
m--|-o-----------E-B--o-X--------oB--------oE-|----------B-XB---X----X-EBB---EoB----oo-------------o--------EX----o-o-----|---Xo--B-----X--E---B----o------X--------o--o------o---o--o-EBXB--Xo-B-----X-
XXXXXXXXXXXXXXXXXXXXXXXXXXXXXXXXXXXXXXXXXXXXXXXXXXXXXXXXXXXXXXXXXXXXXXXXXXXXXXXXXXXXXXXXXXXXXXXXXXXXXXXXXXXXXXXXXXXXXXXXXXXXXXXXXXXXXXXXXXXXXXXXXXXXXXXXXXXXXXXXXXXXXXXXXXXXXXXXXXXXXXXXXXXXXXXXXXXXXXXX
