--?--------?-----------------M-----------BBBBB-------------------------------------------------------------????----------o?-----?--------X---X-------------------------------------B-----------X------o-
---------------------------------------------------------o-----------------------------------------------------------B---B---------------------------------------------------------------------------X--
-------------------------------------------------------------------------------------------------------o-------XXXXXXX---o-o?------o----------------------------------------------------------B---------
-----o-----------------------------------------------o------------------------------------------------------------o--o------T----T----o---------------------------------------------------T-------------
----------------------------------------------------------------------------------------------------------------------T-----|----|--?o?????---X--T----------------------------------------|-------------
---------------------------------------------------------------------------------------------------T-------X------o---|X-T--|---X|---X-------XX--|----------------------------------------|-o-----------
-------o-------------------B-----------------------------------------X------------------------o----|------XT--M------T|XX|-X|----|XBXXBBBB-XXXXBB|BBBBB-----------------------------------|----------XX-
---------------------------------------------------------------------XX----------------------X-----|--XXXXX|------???||XX|-X|----|XXXX-----XXXXXX|----------------------------------------|-???????---Xv
-----X---X-----------------------------------------------------------XXXX------------------------X-|--XBXXX|------XXX||XX|XT|X---|XXXX----XXXXXXX|----------------------------------------|-----------Xf
-----XX--XX----------------------------------------------------------XXXXX----------------X----o-XX|-XXXXXX|B-----XX-||XX|X||XX--|XTXX--XXXXXXXXX|------------------------------o---------|T--------B-Xf
-----XXX-XXX------------------------------------------B--------------XXXXXX--------------------B-XX|XXXXXXX|------XXX||TX|X||XXTX|X|TXXXXXXXXXXXT|----------------------------------------||--o-------Xf
-----XXXXXXXX--------------------------------------------------------XXXXXXX---------------------XX|XXXTXXX|-X---?XXX|||X|X||XX|X|X||XXXXXXXXXXX||----------------------------------------||----------Xf
--o--XXXXXXXXX-------------------T-----------------------------------XXXXXXXX------------o-------XX|XXX|XXX|-XX---XXX|||X|X||XX|X|X||XXXXXXXXXXX||--------------------------------------o-||------BBBBXf
-----XXXXXXTXXX------------------|-----------------------------------XXXXXXXXX-------------------XX|XXX|XXX|-XXXoTTXX|||X|X||XX|X|X||TXXXXXXXXXX||----------------------------------------||--------XXXf
m----XXXXXX|XXXX-EE-------------E|-----------------------------------XXXXXXXXXX-----------------XXX|XXX|XXX|-XXXX||XX|||X|X||XX|X|X|||XXXXXXXXXX||-E-------------------------------------E||------B--XXX
XXXX-XXXXXX|XXXXXXXXXXX-----XXXXX|XXXXXXXXXXXXXXXXXXXXXXXXXXXXXXXXXXXXXXXXXXXXXXXXXX---XXXXXXXXXXXX|XXX|XXX|-XXXX||XX|||X|X||XX|X|X|||XXXXXXXXXX||XXXXXXXXXXXXXXXXXXXXXXXXXXXXXXXXXXXXXXXX||X-------XXXX
