------------------------------------------------------------------------------------------------------B----B----B---------B------?-------X-X-o--------------------B-X--X-------------------o------------
-----------------------------------------------------------------------------------------------------X---X------------------X--------------------------------X------o-X------------------------B--------
---------------X---------------------------------------------------------B-------------------------------------o--------------------------X-----?B??--------X------o--X-----X----XBBBMB-----------------
-----------------------------------------------------------------------------------------------BBBB-----------BB----------------B------------T----------BBBBB-------------XX-----X-----T----------X-----
------------------------------------------------------------------------------------------------B------------------------o---B-M-X-----------|------o----X----o------X-T------B---X----|-------oX-------
------------------------?----------------------------------------------------------------------X------------X----------------------T------??X|o-X---------XXXXMX-M-----|------B-B------|----------------
-----------------------------------------------------------------------------------------------------------XX-----?----------------|---T----X|-B-----M-B-----XXX--XXXXX|--XB-------?---|o-------X-------
----------------------------------------------------------------------------------------B-----------------XXX------M---------------|---|---XX|X---X---------oXXX----XX-|XXX?-----o-X---|-X-------------v
----------------------------------------------------------------------------------------------------B----XXXX----------------------|---|---XX|XXBX----------XXXX---XXX-|XXXo-B--X------|XX-------------f
--------------------------------------------------------------------------------------------------B-----XXXXX--M-------------X-BBBB|?--|---XX|XXX-X--------XXXXX--XXXX-|XXXXXXXTXXX-XXX|XXXX---B----X--f
-------------------------------------------------------------------------------------------------------XXXXXX----------------T--X-B|-XT|---XX|XXTX---XB---XXXXXX-XXXXXX|XXX---X|------X|XX-------X-----f
----------------------------------------------------------------------------------------------BBTBBX--XXXTXXX----------------|---T-|MX||--XXX|XX|XXX-----XXXTXXXXXXXXXX|XXX---X|X----XX|XX------XX-----f
----------------------------------------------------B-----------------------------M-------T-----|--XXXXXX|XXX-----------X----|---|-|-X||--BXX|XX|XXX----XTXX|XXXXXXXXXX|XXX---X|XXo-XXX|XX-XT--XXX-----f
-----------------------------------------------------------------------------------------X|-----|--XXXXXX|XXX----------------|---|-|-X||XX-XX|XX|XXXX--XX|XX|XXXXXXXXXX|XTX---X|XXTXXXX|XX--|-XXXX-X---f
m---------------------------------------------------------------------------------------XX|-----|--XXXXXX|XXX-----E-E----E---|-EE|-|-X||XXXXX|XX|XXXXXXXX|XX|XXXXXXXXXX|X|X-E-X|XX|XXXX|XXE-|XXXXXXX---X
XXXXXXXXXXXXXXXXXXXXXXXXXXXXXXXXXXXXXXXXXXXXXXXXXXXXXXXXXXXXXXXXXXXXXXXXXXXXXXXXX------XXX|XXXXX|XXXXXXXX|XXXXXX-XXXX--M-----|--X|X|-X||XXXXX|XX|XXXXXXXX|XX|XXXXXXXXXX|X|X---X|XX|XXXX|XX--|XXXXXXXX-XX
