-------------------XXXXXXX------------------------------------------------------------------------------------------------------------------------------------------------------------------------------
--------------BBBB----------XXXX-------XXXX--------------------------------------------------------------------------M----------------------------------------------------------------------------------
--------------------????????----------------------------------------------------------------------------------------------------------------------------------------------------------------------------
---------------------------------------------------------------------------------------------------????????--------------------------------??----------------------------------------???????------------
---------------------------------------------------------------------------------------------------------------------------------------??????-----------------------------------------------------------
--------------------------------------------------------------------------------------------------------------------------------------BBBBB-------------------------------------------------------------
-------------------------------------------------------------------------------------------------------------------BBBBBBB-XXXX----B-----------------BBBBB-------------BB-------------------------------
----------------------------------------------------------------------------------------------------XX------o------------------------------------------------------------------------------------------v
-o------------------------------------------------------------------------------------------------------XX---------------------------------------------------------------------------------------------f
----------------------------------------------------------------------------------------------------------------------------------X--------------------------------------------------------------------f
---------------------------------------------------------------------------------------------------------------------------XXXXXX-XX-------------------------------------------------------------------f
-------------------------------------------------------------------------------------------------------------------------------T--XXX--X------------------XXXXXXXXT------------------------------------f
---------------------------------X----------------------------------------------------------------------------------------X----|--XXXX---------------T---???????--|------------------------------------f
--------------------------------XX----------------------------------------------------------------------------------------XX---|--XXXXX---o------X---|------------|------------------------------------f
m------------------------------XXX----------------------------------------------------------E-------------------BBEBBBB---XXX--|--XXXXXX-------BEXXEB|------------|------------------------------------X
XXXXXXXXXXXXXXXXXXXXXXXXXXXXXXXXXXXXXXXXXXXXXXXXXXXXXXXXXXXXXXXXXXXXXXXXXXXXX-----XXXXXXXXXXXXXXXXXXXXXXXXXXXXXXXXXXXXXXMXXXXXX|XXXXXXXXXXXX--XXXXXXo|XXXXXXXXXXXX|XXXXXXXXXXXXXXXXXXXXXXXXXXXXXXXXXXXXX
