--------------------------------------------------------------------------------B-----------X---------------------------XXXXXX--------------------------------------------------------------------------
----------------------------------------------------------------------------------X--------B-------BX-------?-----X----------------X--------------------------------------------------------------------
-------------------------------------------------------------------------------------------------------------------------------------X------------------------------------------------------------------
-------------------------------------------------------------------------B-------------------------X-------X--------------------------------------------------------------------------------------------
--------------------------------------------------------------------------------------B------------X----------X--X--B---------T-------------------------------------------------------------------------
----------------------------------------------------------------------------?-----------oo-----------X---T--------------------|-------------------------------------------------------------------------
-------------------------------------------------------------------o---------------X------X-------------B|--X-B-------T-X-B---|-------------------------------------------------------------------------
-----------------------------------------------------------------------------XX-----------------?--------|-----Xo--XXX|BX----X|------------------------------------------------------------------------v
-------------------------------------------------------------------------------------------------X-M-----|-----XX---??|XX---?-|--------------------------------------------------------X---------------f
----------------------------------------------------------------------------------o-------X--X---XX------|----XXXX----|-X-----|------------------------------------------------------------------------f
--------------------------------------------------------------------------------------o---XX-----XXX-----|-----XXXX---|-------|------------------------------------------------------------------------f
------------------------------------------------------------------------------T------T----XXX----XXXX----|---X-XXXXX--|?????--|B--o----------------------X------------X--X-----------------------------f
------------------------------------------------------------------------------|------|----XXXX---XXXXXX--|---XXXXXXXX-|-------|------------------------------------------------------------------------f
------------------------------------------------------------------------------|------|----XXXXX--XXXXXX--|-B-XXXXXXXXX|X------|------------------------------------------------------------------------f
m-----------------------------------------------------------------------------|------|---EXXXXXX-XXXXXXX-|EEXXXXXXXXXX|EE-----|E------------------------E----------------------------------------------X
XXXXXXXXXXXXXXXXXXXXXXXXXXXXXXXXXXXXXXXXXXXXXXXXXXXXXXXXXXXXXXXXXXXXXXXXXXXXXX|XXXXXX|XXXXXXXXXXXXXXXXXXX|X--XXXXXXXXX|X--XXXX|---XXXXXXXXXXXXXXXXXXX--------XXXXXXXXXXXXXXXXXXXXXXXXXXXXXXXXXXXXXXXXXXX
