----------------------------BBB--------------------------------------------------------X-X------------------B-----B----B???X------B-Bo--------------------------------------X---X-B--BB-XB-B-----B?-----
----------------------------------------------------------------------------------------X--------B---------M--------------X--B------------------------------------------------?--oBo-X-B--X-----X-----?-
---------------------------------------------------------------------------------------------------------XM----X-------B--???--------B------------------------------------X--o-B-X?X?B?XXXXXXX---?------
-----------------------------------------------------------------------------------------------BX-----BX---------TT-----X-M--B---o----------------------------------------------XB???-TB-X-X---X-XBB----
-------------------?------------------------------------------------------------------------M----X-XB------X----B||-X---XBBXBBXBo----------------------------------------B---B-B--B-?-|--XXBMBBB-oXB--X-
-------------------o----------------------------------------------------------M----T----X-X-------XX-------B--XXB||XX---XB------XX-X?---------------------------------B------MX----X-X|-X-XX-o----oX-TX-
-----------------------------------------------------------------------------------|------XX----MXXXB------o-X-X-||XX-X-------B-XX---T-------------------------------------X--BX--X-XX|X--XXXXXTXXXX-|X-
-----------------------------------------------------------------------------------|--B-X-XXX-B-XXXX-----XB------||XX-----------XXX--|XXX---------------------------------------T-oXXX|XXXXXXXX|-XXXX|Xv
---T-------------------------------------------B----------------------------------?|????--XXXX-XXXXX--X---B-----X||XX-X-X-------XXXX-|----------------------------------------X-|XXXXX|XXXXXXXX|XXXXX|Xf
---|-------------------------------------------------------------------------------|----X-XXXXXXXXXX-XBBBBX?--XXX||XXXT-------MoXXXXX|-----------------------------------X?X?B??|XXXXX|XXXXTXXX|XXXXX|Xf
---|-------------------------------------------------------------------------------|X--XX-XXXXXXXXXXTXT--XX-B-XTX||XXX|-o----X-XXXXXX|-------------------------------------XX-B-|XXXXX|XXXX|XXX|XXXXX|Xf
---|------------------------------------------------B-----------------------B------|-B----XXXXXXXXXX|X|XXXX--XX|X||XXX|------XXXXXXXX|X----------------------------------X-XXX-X|XXXXX|XXXX|XXT|XXXXX|Xf
---|------------T-----------------------------------------------------T------------|---BBBXXXXXXXXXX|X|XXXX-XXX|X||XXX|X-----XXXXXXXX|XX---------------------------------XXXXXXT|XXXXX|XXXX|XX||XXXXX|Xf
---|------------|-----------------------------------------------------|------------|------XXXXXXXXXX|X|XXXXXXXX|X||XXX|XTX--XXXTXXXXX|XXX--------------------------------XXXXXX||XXTXX|XXXX|XX||XXTXX|Xf
m--|------------|-----------------------------------------------------|------X-----|B-EE-XXXXXXXXXXX|X|XXXXXXXX|X||XXX|X|--XXXX|XXXXX|XXXX-------------------------------XXXXXX||XX|XX|XXXX|XX||XX|XX|XX
XXX|XXXXXXXXXXXX|XXXXXXXXXXXXXXXXXXXXXXXXXXXXXXXXXXXXXXXXXXXXX----X---|XXXXXXXXXXXX|B-XXXXXXXXXXXXXX|X|XXXXXXXX|X||XXX|X|XXXXXX|XXXXX|XXXXXXXXXXXXXXXXXXXXXXXXXXXXXXXXXXBXXXXXX||XX|XX|XXXX|XX||XX|XX|XX
