----------------------------------------------------------------------------------------------------------------------------------------------------------------------------------B---------------------
---------????---------------------------------------------------------------------------------------------------------------------------B---------------------------------------------------------------
--------------------------B-------------------------------------------------------------------------------------------------------------------------------------------------------XXXX------------------
------------B-----------X-------------------------------------------------------------------------------------------------------------------------------------------------------------------------------
---------------------B-------------------------------------------------------------------------------------------------X----------X-------------o----------------------X--------------------------------
--------------------------------------------------------------------------------------------------------------------------------------------------------------------------------------------------------
--------------------------------B-------------------------------------------------------------------------------------------------------------------------------------------------------------BBBB------
-------------------X-------------------------------------------------------------------------------------------------------------------------------B---------------------------------------------------v
-------------------------------------------------------------------------------------------------------------------------X-----------------------------------------------------------------o-----------f
-----------------------B-------------------------------------------------------------------------------------------------------------------------------------------------------------------------------f
-------------------------------------------------------------------------------------------------------------------------------------------------------------------------------------------????????----f
----------------T------------------------------------------------------------------------------------------------------------------------B-----------------------------------------------XB------------f
----------------|--------------------------------------------------------------------------------------------------------------------------------------------T-------------------------XXX-----------M-f
---------------X|XXXX-----------------------------------------------------------------------------------------------------------------------BBBBBBB----------|--T-T--------B------B---XXXX---o---------f
m--------------E|-----E-----------------------------------------------------------------------------------------------------------------------E-----E--------|EE|X|------E---------E-XXXXX-E-E---------X
XXXXXX-------XXX|XXXXXXXXXXXXXXXXXXXXXXXXXXXXXXXXXXXXXXXXXXXXXXXXXXXXXXXXXXXXXXXXXXXXXXXXXXXXXXXXXXXXXXXXXXXXXXXXXXXXXXXXXXXXXXXXXXXXXXXXXXXXXXXXXXXXXXXXXXXX|XX|X|XXXXXXXXoXXXXXXXXXXXXXXXXXXXXXXXXXXXX
