--------------------------------------------------------------------------------------------------------------------------------------------------------------------------------------------------------
-----------------------------------------------------------------------------------------------------------------------------------------------------------------------------------------------------X--
--------------------------------------------------------------------------------------------------------------------------------------------------------------------------------------------------------
--------------------------------------------------------------------------------------------------------------------------------------------------------------------------------------------------------
-?BB----------------------------X--------------------------------------------------------------------------------------B---------------------------------------------------------------------X----------
---------------------------------------------------------------------------------------------------B--------------------------------------------------M-----------------------------------------------B-
---------o----------------------------------------------------------------------------------------------------------------------------------------------------------------------------------------------
--------------------------------------------------------------------------------------B----------------------------------------------------------------------------------------------------------------v
-------------------------------------------------------------------------------------------------------------------------------------------------------------------------------------------------------f
-------X--------------------------------o--------------------------------------------------------------------------------------------------------------------------------------------------------------f
------------------------------------------------------------------------------------------------------------------------------------------------------------------------------------------X------------f
-----------------------------------------------------------------------------------------------------------------------------------------------------------------------------------------------B-------f
-------------------------------------------------------------------------------------------------------------------------------------------------------------------------------------------------------f
--------------------------------------------------------------------------------------------------------------------------------------------------------------------------------------------T----------f
m-E------------------------------E---------------------------------------------------------------------------------------------------------------------------------------------------E------|----------X
XXBXXXXXXXXXXXXXXXXXXXXXXXXXXXXXXXXXXXXXXXXXXXXXXXXXXXXXXXXXXXXXXXXXXXXXXXXXXXXXXXXXXXXXXXXXoXXXXXXXXXXXXXXXXXXXXXXXXXXXXXXXXXXXXXXXXXXXXXXXX-----XXXXXXXX?XXXXXXXXXXXXXXXXXXXXXXXXXXXXXXXXX|XXXXXXXXXXX
