-----B----------X---------X-------------B--o----X------------o-----o----B--------X------------B----------------o---X------------o--------------------------oX-o-X--B--o--o-----------------B-----B--BB--
---B---E--o--------o-BB-------oo--XB----------B-o-----------B----XB-o----------o----------o-o--------------------oo----X-------XB--------B---o------B-----o------------E-B-----------------------o------
---B--o---Boo-------------B--B-----o--------o--o---oB----o----------------Eoo----------BX---o-B-----o-----o-o-o--o--------------X-------B----X?-B-------o-----B--B--------------------------------------
----BBo--------o-------------X-E-o-------------o----o---------------B------------B---o-o-----------------B------X----------X-----------X-----X----------------B--X-------Bo---o-oXB------B-------B----XB
---------B--B---B------B-------oo-X------o--o-B---------B--o--------o-------o-X---------o----o----o---------o-B-----o----------------------------------------------------B-------B--X--oX---------------
---o-----o--X---o-B----------XB--B---o---o--------X---------------------o-------------------B---o---B---------------o----B-o----o--o-X-o----------o---B-----o-----X-B----o-o--o------o--------X--------B
------oo-----E-------o-------------------X------o-------o------------------o----o-------o--B-----------------oo-------o------o----------o-------X-o----B--oo----o-B-Eo--o-----------o---B----B-B--------
--o------------------B--o---------o---------B-o----B-------o-----X-B--------o-----E-X------E---XoB----------------------------B-X--------------o--------B---B-B--o-------o------o-----o--XB-BX---o--o-ov
---------o--------X----------------------------o--------------B-----o-----o-Xo--Xo----B----oo--------X--oo------oo----E--Bo--------------E--------o--------B--oB----B-o-o-------B---o------o-----o-----f
----------o-------B------------Xo---X---oB--X------B-X--------o--oB--------------o---B--o--o------------------------------X---o--------oX----------X-o--B-------BoB------X----X------o-----------------f
-------oo----------o-----------B----B-o------B--------------o---oo-o-------o-------o-o-B-------BX----------------------B-----B-X-----B--------------B-------o-o----------o------X----------B----------of
-----B------Boo-B----------o-o----------------o-----oX------o-o----oB-B--B---o---------o--------------o------o------------B-o------------------B-o--B-----Eo-------BE-------o-o--------------oBB-B-----f
----------o--o-------X---o-------X----Bo----Bo------------o-------------E--------X----o----------o-o----------B-o--------B------------E---o---B-----o-o-o----B-----o-B-----------o-X--------o--B--Bo---f
-------------------------oB--B-------B----------------o-------BEB--------o---oo--E----------------BB---o----------E---o---o-B-----o-B------o-------B--B----------o-----o-------------------B--------X--f
mo---B--X-X------------------o-------------o--o--o----Bo----------B------X---B-----------------------------o---------B----------B--B-----------o-------------B-----X-oB-----B-X------B---------oX----E--
XXXXXXXXXXXXXXXXXXXXXXXXXXXXXXXXXXXXXXXXXXXXXXXXXXXXXXXXXXXXXXXXXXXXXXXXXXXXXXXXXXXXXXXXXXXXXXXXXXXXXXXXXXXXXXXXXXXXXXXXXXXXXXXXXXXXXXXXXXXXXXXXXXXXXXXXXXXXXXXXXXXXXXXXXXXXXXXXXXXXXXXXXXXXXXXXXXXXXXXX
