------------------------B-------B-------------o---XXXX-------------X----B------------------------B------------------------------------------------------------------------------------------------------
-----------------------XX-----X---B----------------X------------------------------------------------X-------------X----------------X----------------------X--------------------X------------------------
------------------------------X-----X------------X----------------------------------------------------------------------------------------------M-------------------X-----------------------------------
---------------------------TT--B---B----------------T-------------------------------------------X------------------------------------------------------T------------------------T-----------------------
------------------------B--||--B-X---------X-------X|---------??????X?---B-------------------------o---------------------------------------------------|-----------------B------|------------X----B--X--
--------------------TB-----||---XX-B---B--XX--??--XX|------------------------------------------------------------------------X-----B-------------------|--BBBBBBBB-M------B-----|------BBXBBBB----------
--------------------|------||--XXXXB-X-BBXXX-----XXX|----X--T--------------------------------------------------------------------------------??--------|--X---------------------|-----------------------
--------------------|M-----||-TXXXX-XX--XXXX--o-XXXX|---XX--|---------------------------------------------------------------------M------------------B-|B-----------------------|----------------------v
-------------------B|------||X|XXXXXXX-XXXXX-B-XXXXX|-BXXX--|---X------------------------B----?-----------------------------??----------------B--------|-------------X----------|-T---X-T--------------f
--------------------|X---TT||X|XXXXXXXXXXXXX--XXXXXX|-XXXX--|-------B---X--------------------X---------------------------------------------------------|------------XXX------XTX|X|XX---|--------------f
--------------------|--B-||||X|XXXXXXXXXXXXX-XXXXXXX|XXXXX--|-B-------T-------------------------X--------------------------------------X-----------B---|--------X----XXX------|-|-|-----|--------------f
--------------------|X---||||X|XXXXXXXXXXXXXXXXXXXXX|XXXXX--|---------|--------------------------------------------------------------X-----------------|-------------XXXX-----|-|-|-----|--------------f
-------------------T|?M??||||X|XXXXXXXXXXXXXXXXXXXXX|XXXXX--|---------|--------------B-----------------------------------------------------------------|-------o-----XXXXX----|-|-|-----|--------------f
----------XXXXBX--T||---X||||X|XXXXXXXXXXXXXXXXXXXXX|XXXXXXB|---------|-----------------------------------------M---------------------T---------------B|-------------XXXXXXB--|-|-|-----|---------T----f
m----------E----E-|||--XX||||X|XXXXXXXXXXXXXXXXXXXXX|XXXXXX-|--E----B-|Xo---------------------------E------------------------------B--|X-E-B-----------|------B--B---XXXXXXX--|-|X|-----|---------|----X
XXXXXXXXXXXXXXXXXX|||-XXX||||X|XXXXXXXXXXXXXXXXXXXXX|XXXXXXB|------XXX|XXXXXXXXXXXXX--------XXXXXXXXXXXXXXXXXXXXXXXXXXXXXXXXXXXXXXXXXX|XXX-----XXXXXXX-|----X------XXXXXXXXXXX|X|X|XXXXX|XXXXXXXXX|----X
