--------B--------------B------------------------BBB------------------------------------X-X-----------------XBXo------?-B???X------oX?oXXBoBB-XXXXXB--XBMB--X---?-oB-------------------------------------
--------------------------------------------------------------------------------------B-------o--B-----o---M----------X---X--B----B-----BBB-B-X-oo-BB---M----B?MB---B-----------------------------------
---------------------------------------------------------------------------------------------------------X-----X----B--B--???----B--XB-M-B--X-B---BXoXB?--B--XXXX---------------------------------------
----o------------------------------------------------------------------------------X------------B---B-BX-X------BT-XX-B---TX-B-T-ooBo-BBBB-B-?-ToT-???X???BXBBBBBBB-----??------------------------------
--------------------------------------------------------------------------------------------M------XB---T--TB---B|B----BXB|XBBX|o---B-XX-T--X--|-|T-ToT-------?-?--XM-X-o----B--------------------------
------------T------o-------------------------------------------------------XB---------X-XX--------XX----|o-|---XB|--B--BXB|-B--|XXTXTXTo-|-MM-T|-||?|X|-BTB??T???-XX-BB---------------------------------
------------|----------------------------------------------------------------------------XX-B---MXXXB---|--|---X-|--X-X---|XB-B|XX|-|T|-X|--T-||X||?|X|?-|B-B|XX-XXXXBBXo-X---B-------------------------
------------|-----------------------------------------------X-B-----------------------B-XXXX----XXXX----|-B|-----|-XXX----|----|XX|-|||TB|X-|B||X||X|T|XX|X??|XXXXXXX?---------------------X-----------v
---T------B-|----------------------------------------------XX-----------------M----------TXXX--XXXXX----|--|----B|XXXXX-X-|XTXB|XX|X||||T|-B|-||X||X|||XX|XXT|XXXTXXX------X---------------------------f
---|--------|-----B---------------------------------------XXX------X--------T-----------X|XXXXXXXXXXX-BB|BB|-XXX-|XXXXTX-T|X|XX|XX|X||||||XT|-||X||X|||XX|XX||XXX|XXXB-B--XX---------------------------f
---|-----X--|--------------------------------------------XXXX------XX-------|--B----X--XX|XXXXXXXXXXXXT-|BX|B-XTX|XXXX|XX||X|XX|XX|X||||||X||X||X||X|||XX|XX||XXT|XXX-X--XXX---------------------------f
---|--------|-------------------------------------------XXXXX------XXX------|------------|XXXXXXXXXXXX|-|X-|XBX|X|XXXX|XX||X|XX|XX|T||||||T||X||X||X|||XX|XX||XX||XXX-X-XXXX---------------------------f
---|--------|------------------------------------------XXXXXX------XXXT-----|----------BB|XXXXXXXXXXXX|X|X-|--X|X|XXXX|XX||X|XX|XX|||||||||||X||T||X|||TX|XX||XX||XXXXoXXXXXBBB------B-----------------f
---|--------|-----------------------------------------XXXXXXX------XXX|X----|---------X--|XXXXXXXXXXXX|X|X-|-XX|X|XXXX|XT||X|XX|XX|||||||||||X|||||X||||X|XT||XX||XXXXXXXXXX---------------------------f
m--|-------E|----------------------------------------XXXXXXXX------XXX|XX---|----E-----E-|XXXXXXXXXXXX|X|XX|XXX|X|XXXX|X|||X|XX|XX|||||||||||X|||||X||||X|X|||XX||XXXXXXXXXX------E--------------------X
XXX|XoXXXXXX|XXXXXXXXXXXXXXXXXXXXXXXXXXXXXXXXXXXXXXXXXXXXXXXXXXXXXXXXX|XXXXX|XXXXXXX----X|XXXXXXXXXXXX|X|XX|XXX|X|XXXX|X|||X|XX|XX|||||||||||X|||||X||||X|X|||XX||XXXXXXXXXXX-XXXXXXXXXXXXXXXXXXXXXXXXXX
