--------------------------------------------------------------------------------------------------------------------------------------------------------------------------------------------------------
----o----????????-------------------------------------------------------------------------------------------------------------XXXXXXXX------------------------------------------------------------------
----------------------------------------------------------------------------------------------------------------------------XXX-------------------------------------------------------------------------
------------------?------------------------??------------------------------------------------------------------------------------------------------------------------------------------------------XXXX-
------BB-----------------------------------------------------------------------------------------------------------------BBB---------B-----XXX-------------------------------XXXXXX-----------B---------
--------------------------------------------------------------------------------------------------------------------------------------------------------------------------------------------------BBBBB-
---------XXXX----------------------------------------------?----------------o-----------------------------------------------?????-----------------------------------------------------------------------
-----XXXXXXX-------------------------------------------------------------------------------------------????----------------------------------------------------------------------------------BBBBBBB---v
----------------------------------------------------------------------------------------------------------------------------------------------X--------------------------------------------------------f
-------------------X-----------------------------------------------------------------------------------------------------XXXXX-----------X-------------------X---------------XXXXXXX---????????--------f
-------X------B--------------------------------------------------------------------------------------------------------------------------XX-----------------XX---------------------XXXXXXXX------------f
------T-BBBBBBBB---------------------------------------------------------------------BBBBBB-------------------------------------XXXX-----XXX---------------XXX-------------------XXXXXXBBBB------------f
------|------------------------------------------------------------------------??-------------------------T------------------------------XXXX-------------XXXX--------------X--------------------------f
-----B|--------XXX-----------------------------------------------------------------------------------X----|------------------o-----------XXXTX???--------XXXXX------------????-------------------------f
mE----|E---------------------------------------------------------------------------------------------XX---|------????????-------?X???----XXX|XX---------XXXXXXX-------------?--------------------------X
XXXXXX|XXXXXXXXXXXXXXXXXXXXXXXXXXXXXXXXXXXXXXXXXXXXXXXXXXXXXXXXXXXXXXXXXXXXXXXXXXXXXXXXXXXXXXXXXXXXX-XXXXX|XXXXXXXXXXXXXXXXXXXXXXXXXXXXXXXXX|XXXoXXX-XXXXXXXXXXXXXXXXXXXXXXXXXXXXXXXXXXXXXXXXXXXX-XXXXXX
