---oX---B------------B---B-----B-----Bo------------------o----B------o-o-----o-----B-o-------o-----------o------B--------------B-B-----------Bo--B----o----B---o------o-----o-------------o---B--------o
-o-o-------oo-----------Bo------o---------o----B--Bo----Bo--B-----------------X----Bo-o-XoX--------------B-o-----o-----------o---o---B--o---o------o--o--o-Bo---o------o----------------Xo--oX-B------o-
-----BB--o--B---------o--X--X---o--B------E-----------o--------o-oB----X--------o-o-------o--B---B------B-----o-o---------o-B------------------B----o----X-B--B--B-----B--B-----------------B--------o--
--o-----o---------oB---------------------------B---?---B-o--------E----------------o--X---X--B-B-----Xo----o-----B----E-------------B---o-------B---BBo--o---XX---o---o----o---B----B---o---o------o----
-------------------o------------o-o------------------B-o---------oB---------BX------------o-----o-----M---------o-----o----X-------Eo----B----------B---B--o-------B--o-B-X--B---------------------o----
---X-----o--------------BE-o-------------o---B------------oB---------X-----E-BB--------X-o---Bo--o-B-------B-----o--------o-o-----BB--------------------X---------------o--------o----B-o-----BX-----B--
o--o--X----o-B-o------------X-o--B----------Bo-----oB-Mo----o----X--o----o----o------Xo-E---Bo-oo-------o-------o-------B-T-------o-----o-------oo--oo--------------X---------------o------B--?---------
o--B--oE----------------o------B-B---o------o----------o------?--------------oBoB--Xo----------o-X-------o----------------|------B-------------o------B----X-oB------B-------Bo---BB--------B--o---o---v
--B-B---X-o-----------B-B----o----X----o----------B----------------o-B--o---B----o-B-------o--B---------o--E-----X-B-----o|------------------B--Bo----o------E--Bo-----B--------oBo----------o---------f
---------BX--BB---oo--------------------oX-----o-------M---B----------o-o----o-oo-B---o----B---B----BE---o------o--oB----o|---E--B-o------------o---o--------X------Bo---B------------o------E--X----X-f
---T--B--Bo------BoB------------o------------BT-B----X---o------------------o-------------B---o--o----o----o--BX-o--------|-------o-----------------------B-----o--o----X----o----------o---o--o-o-B-o-f
--B|-------B-----------X-Bo-o--X--B-----X----E|--o---o---------------------o-?-o--o-o-----------------oo--X--B------B-X---|----o--o--Bo---oB---B---------X------B----o------B-X--X--------XBo----------f
B--|---B---o-E-----o-----------X--oo----o--B-B|-----B----o----o----------------o----oo-B-----o---oo--o--o----X-------B----|-----------o-B---B--------------B--------B------?--oo-----XE----------------f
oo-|--Bo---------B--------B------o--oo------B-|-------o--------o----o-----B-o-B-----oo-----E----o--T--o-----------------o-|---Boo-o--o--oo------------o-B----o-----------X------------B--B---Eo--X----Bf
mB-|--o--Bo---B--B-o---o------------------X---|--o-------B-B---B-o-B--X---------o---------BoB-----B|-------oo-----Eo---B--|-E------------Xo----E---o-E---------o-------BB-o------X-----B--------X-------
XXXXXXXXXXXXXXXXXXXXXXXXXXXXXXXXXXXXXXXXXXXXXXXXXXXXXXXXXXXXXXXXXXXXXXXXXXXXXXXXXXXXXXXXXXXXXXXXXXXXXXXXXXXXXXXXXXXXXXXXXXXXXXXXXXXXXXXXXXXXXXXXXXXXXXXXXXXXXXXXXXXXXXXXXXXXXXXXXXXXXXXXXXXXXXXXXXXXXXXX
