-------------------------------------------------------------------------------------X-------------------B--------------------------------------------------------------B-------o-----------------------
----------------------------------------------------------------------------------------------X----------------------------------------------------------------------------B-------X--------??M?B???-BB-
-----------------------------------------------------------------------------------?--B-----------------------------------------------------------------------------------?-------------X-X--X-----BBoB-
-----------------------------------------------------------------------------------------X-X------------------BX--------------------------------------------------------?----XXXXXXBB--X------X---B-----
--------------------------------------------------------------------------------------------------------------------T------------------------------------------------X--T------------------M-?XXXXX--B--
--------------------------------------------------------------------------------------------XB----------------------|---------------------------------------B-------XX--|---------------T--B----T--X--X-
----------------------------------------------------------------------------------------BBBBBB--X---------B---------|---------------------------------B---o--------XXX??|?-------X------|---T--T|-XXX-X-
----------------------------------------------------------------------------------------------------------------X-X-|?????X?--------------------------------------XXXX--|-T---------XT--|--X|--||-----Xv
--------------------------------------------------------------------------------------------X----------X-------o--?-|----------------------------------------X---XXXXT--|-|---------X|--|---|--||-----Xf
------------------------------------------------------------------------------------B-----X----?????--------X-------|-------------------------------------T-XX--XXXXT|--|o|------??TX|XB|---|?-||X----Xf
-----------------------------------------------------------------------------------------------XXXX-----------------|----------------------------------X--|XXX-XXXXX||--|-|B-------|X|XX|---|--||-----Xf
--------------------------------------------------------------------------------------X----------X--B------------B--|-------o--------------------------o--|XXXXXXXXX||X-|X|XXXB---X|X|XX|X--|-o||-----Xf
--------------------------------------------------------------------------------------------------B---------X-------|---------?--------------------------X|XXXXXXXXX||XX|-|--X-B-XX|X|XX|XB-|--||-----Xf
---------------------------------------------------------------------------------X------------o-----------------BBBB|----------------------------X------XX|XXXXXXXXX||XX|-|-XX--XXX|X|XT|XX-|--||B----Xf
m--------------------------------------------------------------------------------X-----E------------------B--E------|B----X----------------------------XXX|XXXXXXXXX||XX|X|XXX-XXXX|X|X||XXX|E?||X----XX
XXXXXXXXXXXXXXXXXXXXXXXXXXXXXXXXXXXXXXXXXXXXXXXXXXXXXXXXXXXXXXXXXXXXXXXXXXXXXXXX--------XXXXXXXXXXXX-XXXXXXXXXXXXXXX|XXXXXXXXXXXXXXXXXXXXXXXXXXXXXXXXXXXXX|XXXXXXXXX||XX|X|XXXXXXXX|X|X||XXX|-B||XXXX-XX
