X---o-----BB--B---o--------o-X---BBo----------B-----o---o--X------------BB-o----B----------X------------o--------BB---B----o---B-----B---B----------------XB---------------X-------------B--T---oo------
------oXo--------o----o--------EoB----o-------o---------------------------B-oXXo---X--oo---B---B--------o---------o--B-B-----o-------X---B---o------B--X--B----B-o------o---X----oB--------B|---o---o---
------------------X-B---X----o-o-o---B---------B--o---------o-----o------oB----oXX-------oB--B----------------------X----B------o----o--------X----------o---X-----oo--------o----X-B--XB-o-|----X----X-
X-----Bo------Xo-o---o--o-Xo--------oB--o---------------E-B-------o--------oBo-----BB---Boo------o-o-----------------B------o-o-o--X------------B--B----X------B---E-X-----------o-----oX---|--B-------o
-X-------------o-o--oX---B--o----oo------B---B------------------------B-----o-------B--B----B-------o----o---o---X-----o---B--o---B-----o-BXo----Bo----oo------o-o-BB-X-X-----------B----o--|-----------
-T------B---o----o------------?oB-------B----o----BoX-o-X------o----B--X------o-B-------B-------o-------------X--B-o---BB-------Bo-o-------BB----X----------Eo------X-B----o------X---B-----|---T------B
B|-X------o---B---o--o---------X---X----B---B-o------X----BB--o---B-oo-------B------o--------B------------------------B-BB-B-B---oo------o-------B--o-BB--B----B-------------------------o--|---|----B--
-|-B----Xoo----------B----o---E--------X--------o-----oB-o------------o--o-X-o---B---------B---------------B-------oB----o-----o-----------------B-X-X-B------------------------o-o-B---X---|---|------v
B|-----X-----T------------B---------o-oo---B-----B------------B-----oB---B------o--B-o---------B--o-----o---o-------------B-----------o-----o-?-------------------o-B--oB--o---------o-----o|---|------f
-|--B-o------|--X---o---o--------X---------------o--B------------BB--BB------------o-X---o-B-B-----------o--o---E--o-------B----------o-----B----B-------o-BB--------X-B--------------o-----|--B|---E--f
o|---o--oo-o-|----o---X-BB--o-B-oo---------B------oo----BB-----B---X---B----------------------------B-o-------oXo------------------Xo-oo-o--------oB-o---oX-------------B------o------------|-o-|---X--f
-|-----X-----|----X--o------B-----o------------BXo--X----oo-------o-X------o-BB----------Xoo--BB------B----B--B------X-B-----------Bo-o-B-----------Eo---o-------B-----------------ooo----B-|-o-|--BB--f
-|-----------|--------o-----ooo----X------oX------------------------XX--B-----o-E-o--------o------o-XX--BoB---T-------Xo-----o-B------B-----o----B-B--------------------B-B-X------o--B----o|--B|------f
-|-o--------o|-X--o---------oB-----oB-------o---------------EB------------------B---X------------------o------|----------o---------T-----o--------o-B-o---o----o------o------------o--o-Xo-B|---|------f
m|---XBoB---E|------X--EXXo-X-----o------o-----o-E-----------BBo----M---------o---B-E---o---E------------B-B-B|-o-----o---Xo------o|--------B----------------o--o-EB-E------EE--------------|--B|-------
XXXXXXXXXXXXXXXXXXXXXXXXXXXXXXXXXXXXXXXXXXXXXXXXXXXXXXXXXXXXXXXXXXXXXXXXXXXXXXXXXXXXXXXXXXXXXXXXXXXXXXXXXXXXXXXXXXXXXXXXXXXXXXXXXXXXXXXXXXXXXXXXXXXXXXXXXXXXXXXXXXXXXXXXXXXXXXXXXXXXXXXXXXXXXXXXXXXXXXXX
