-------------------------------------------------------------------------------------------------------M-B-----------????----------B----------------X----MX--XXXXXXX------------X-o---??X?????-------B--
----------------------------------------------------------------------------------------------B---------------X--------X----B-------------------------------X------X----X--B----B--X-X-BB--M??M?????----
---------------------------------------------------------------------------------------------------------------------------------X---B--------BX---------B-----------------------?----------------------
---------------------------------------------------------------------------------------------------------------X---------B--------------B---------X----T--------------X-BB-T------X-B--X----------------
--------------------------------------------------------------------------------------------B-------X?????--------------------X----------X-B----B------|-----X-------X--B--|-----B--BBBBXBBMooXB?X??B-X-
----------------------------------------------------------------------------------------------------------------------T------XX-----XXXXXXX---o--------|----XXX-----TX-----|------XBBBBXTX---XX----X----
----------------------------------------------------------------------------------------------------------B-----------|-----XXX----B---B--------B---X-B|-B-XXXX-B-XX|XB-X--|-----X-----T|-X-XXX-----TM--
--------------------------------------------------------------------------------------------------------T-------X-X--?|??M?XXXX-B------X------T----BoM-|--XXXXX---XX|X-----|---X-------||X-XXXX-----|--v
--------------------------------------------------------------------------------------------------------|---------?---|---XXXXXX--------------|--------|-XXXXXX--XXX|XX----|---XXoBBXXB||XXXXXX-----|--f
-X----------------------------------------------------------------------------------------X----?????----|-------------|B-XXXXXXXXB---------X--|-------o|XXXXXXX-XXXX|X-----|---XTX-TXX-||XXXXXXT-X--|-Bf
--------------------------------------------------------------------------------------------------------|--------X----|-XXXXXXXXXX-X----------|--------|TXXXXXXXXXXX|X--B--|---X|XX|XXX||XXXXXX|XX--|--f
----------------------------------------------------------------------------------------------------X---|-------T-----|XXXXXXXXXXXX---B-------|-------X||XXXXXXXXXXX|XX----|X--X|XX|XXX||XXXXXX|XX--|--f
-------------------------------------------------------------------------------------------------M------|---X--?|-----|XXXXXXXXXXXXX----------|-B----XX||XXXXXXXXXXX|XXX---|-X-X|XX|XXX||XXXXXX|XX--|--f
----------------------------------------------------------------------------------------------------M---|-------|----X|XXXXXXXXXXXXXX-----X---|-??--XXX||XXXXXXXXXXX|XXXX--|XXXX|XX|TXX||XXXXXX|XXX-|--f
m-------------------------------------------------------------------------------------------------------|--E-E--|---XX|XXXXXXXXXXXXXXX----XX--|-E-EXXXX||XXXXXXXXXXX|XXXXX-|XX-X|XX||XX||XXXXXX|XXXX|--X
XXXXXXXXXXXXXXXXXXXXXXXXXXXXXXXXXXXXXXXXXXXXXXXXXXXXXXXXXXXXXXXXXXXXXXXXXXXXXXXX--------XXXXXXXXXXXX-XXX|XXXXXXX|XXXXX|XXXXXXXXXXXXXXXX---XXXX|XX-XXXXX||XXXXXXXXXXX|XXXXXX|XXXX|XX||XX||XXXXXX|XXXX|--X
