----------------------------------------------------------------------------------------------------------------------------X--X----------------------------------o--B--M---X-------------B-------------
--------------------------------------------------------------------------X----------------------------B--------B-----------------X--------------------------B-----------XX-------------------------X---
---------------------------------------------------------------------------------------------------------------------------------------------------------------B--------B--BBBBBBBB-----B---------------
----------------------------------------------------------------------------------------------------------------X-------------------------------------------------X--Bo-XBX-B----------X----?B??------X-
-X---------------------------------------------------------------------------------------------------------XB-------------------B----------------------------T-X--???????--T-X---------X--X-?-X---X-T-X-
-------------------------------------------------------------------------------------------------------------------------------B-----------------------------|B-B-BX-------|XX--------XX------------|-X-
------------------------------------------------------------------------------------------------------------------B-----------B-----------------------------X|---oB----X---|XX-----B-XXX-------B--o-|-X-
---------------------------------------------------------------------------------------------------B---------------------------------------------------------|--X-X----MB-X|XX------XXXX-----X--XXXX|-Xv
------------------------------XXXX---------------------------------------------------------------------------------------------------------------------------|------X--T-XX|XX-----XXXTX-----XX--B--|-Xf
------------------------------------------------------------------------------B------------------T----------------XXXX---------B-----------------------------|--X-X--T-|XXX|XX-X--XXXX|X----XXXXBX--|-Xf
---X---------------------------------------------------------------?-----------------------------|-----------------------------?---------------------------?-|??----X|X|XXX|XX---XXXXX|X-----XXXX---|XXf
------------------------------------------------------------------------------------------------B|-----X---------B---------B---------------------------------|--TBBBB|X|XXX|TT--XXXXXX|X-----XXXXX--|XXf
-------------------------------------------------------------------------------------------------|---------------------------X---B---------------------------|--|--X-|X|XXX|||XXXXXXXX|X---?XXXXXXX-|XXf
-------------------------------------------------------B-----------------------------------------|-----------------------------------------------------------|--|---X|X|XXX|||XXXXXXXX|T-----XXXXXXX|XXf
m------------------------------------------------------------------------------E----------E------|----------------E-------E-----B-----XXXXXX----------------E|E-|XXXX|X|XXX|||XXXXXXXX||-XXEXXXXXXXX|XXX
XXXXXXXXXXXXXXXXXXXXXXXXXXXXXXXXXXXXXXXXXXXXXXXXXXXXXXXXXXXXXXXXXXXXXXXXXXXXXXXXXXXXXXXXXXXXXXXXX|XXXXXXXXXXXXXXXXXXX-XXXXXXXXXXXXX------XXXXXXXXXXXXXXXXoXXX|-M|-XXX|X|XXX|||XXXXXXXX||XXXXXXXXXXXX|XXX
