-----------------------------------------X-------------------------------------BBBB------------------X--------B--------------------------------------------M--------B---------X-B-----------------------
--------------------------------------------------------------------------------------------------B---?o----------------X--M--------------?---------------------------------X---B---------X-------X-----
----------------------------------------------------------------------------B----------------X------X-----------------------------------------------?------------X--------X-----------------------------
--------------------------------------------------------------------------------------------------B----------------X----------X------?------XXBXXX------------------------------------------------------
------B---------------------------------------------------------------------------X-------------X---X-----T-------------X--B-BB----------Xo-------X-----------------------------------------------------
-----M-----------------------------------------------------------B-----B---------X--X--X---------B---T-T--|------------XX--B--B---X--B--------------------TXXX-----X-----?----X-------------X-------BBB-
-----------------------------------------o----------------------------------------oBT-TX--XT-------XX|X|XX|XX-B----BBBXXX?--------------------TB----------|----------BBB------XX------B-----XT----------
-------------------------------------------------------------------o----------------|X|X---|--?-X----|-|--|---X?---BXXXXX---------------------|X----B-----|-------------------XXX----------XX|X-----B--v
----------------------------------------------------------------------------------X-|X|X-BB|-XXXXBX--|-|B-|---------XXXXX---------B---------X-|X----------|-------------------XXXX------TB--X|XXBBB----f
-----------------------------------------------------------------------XXXXX------BX|X|X---|B--------|-|--|--T---X-XXXXXX--------------------X|X---------T|--B------------BB--XXXXX-----|---X|XXX------f
------------------------------------------------------------------------------B---XX|X|X---|----X----|B|--|-B|----XXXXXXX--X-B------B-------TX|X---------||-------------------XXXXXX----|---X|XXXX----Xf
--------------------------------------------------------------------------------TXXX|X|X---|----X----|X|-X|??|??-XXXXXXXX--XX--------------X|X|X---------||---XX--------------XXXXXXX---|---X|XXXXX----f
------------------X-------------------------------------------------------------|XXX|X|X---|----XX---|X|-X|-X|--XXXXXXXXX--XXXB-----------XX|X|XX----X---||XX--XX-------------XXXXXXXXX-|B--X|XXXXXX---f
-------------------------------------------------------------------------------X|XXX|X|X---|----XXX-X|X|-X|XB|BXXXXXXXXXX--XXXXX---------XXX|X|XXX-------||-XXXXXX---XX--X----XXXXXXXXX-|---X|XXXXXXX--f
m----E------------------------------------E--------------------------------E-oXX|XXX|X|XE--|-B-XXXXXX|X|-X|XX|XXXXXXXXXXX-EXXXXXE-------XXXX|X|XXXX------||BXXXXXXX-XX--XXE---XXXXXXXXXX|---X|XXXXXXXXMX
XXXXXXXX----XXXX------XXXXXXXXXXXXXXXXXXXXXXXXXXXXXXXXXXXXXXXXXXXXXX---XXXXXXXXX|XXX|X|X---|BXBBXXXXX|X|XX|XX|XXXXXXXXXXXX-XXXXXX-XX-XXXXXXX|X|XXXXXXXXXX||XXXXXXXXXXXXXXXXXXXXXXXXXXXXX|???X|XXXXXXXXXX
