----------B-------------X--------------------------------o-------------------------------------------o-B----B-------------------B-----------------------------------X------B----------------------B-----
-Bo------------B-----------X-------------o----------B-----------------B--------o------oX-----------------X--------B----o-------------------o-----------------------E----B------o------------------------
--------------oXB----o---------BB----o--------------X---------B-X---o---------o--------------------B--------B----o--B-----o-------o----X---o----B------oB---o------------X-----Bo-----o--o----o------B--
---o-------------X---o-X-o--?-o------B-----oB----------o-o---o------B-----------------------?----oB--------------Bo-----B--B---o--------B--------o----B--o--------o---------B-Eo--------B---XX--------X-
----B-------------B----o---o-----B--------o---------o-o---------o--o-o--------X---oB-------------------------------------BB------------Eo---o--------o-----B---o--------------B----B--B------------o----
----------o---B----oB------o----o-X-------------------B--------------------Bo------------------------o-------------------o------B---B------o--------B-------------B----------B-o---B--------------------
---------------------o-o-------------B------------------------X--------X------------------------o----------o---------------o--B----o--------o--oX---------------------o-o--Xo-----o-----------Bo--------
---E-?---B---o----------------------------------------E----o--X----oB---X-----------------------B-----E-------o----B------------------B--o------------B---o-X----------B---E----------------o--B---oB--v
-------X----------o--o------X--------------X-o----------------B-o------------o----------X-----------o---o---Bo-------o------o--------o---------o----------Bo---------o---o----B-------------o----------f
--------o---------X--------B--------------------------X----------------B------X----o-------------o---B----B-----------------------------B--o--o------------------o--B--E------------------o------------f
--o-----------o---------B----------o-------------------------------o---?-o---B-------X-------o-----------E-Bo-----------------B--o--------o-o----------------------------X--------B-----E--B-----------f
-----------------------o----o---------------E---------o-------------------------------------------------------o--o-----------------------------------------------B-B--B-B---X------------------o-----o-f
------X-----------------------o-----?o----oBo--oo------------B------X----------o--X----------o--------B----oo------------------------------------------Boo-B--E--B--------X--?o--ooB-------X-B-o----X-of
---o--o-----------o---------B--X-------E----o-X------o----------o---BB------o--o----------------------------------------XB------BX-----------------o-o---o---o---------o---B-------B------o-B----------f
m--o-B----------Bo---------X-------------------X--o-----o--------Xo---o-------X--------X-----------------------o-------B-B-------------o------------------------o--------B-------o---o-----------------X
XXXXXXXXXXXXXXXXXXXXXXXXXXXXXXXXXXXXXXXXXXXXXXXXXXXXXXXXXXXXXXXXXXXXXXXXXXXXXXXXXXXXXXXXXXXXXXXXXXXXXXXXXXXXXXXXXXXXXXXXXXXXXXXXXXXXXXXXXXXXXXXXXXXXXXXXXXXXXXXXXXXXXXXXXXXXXXXXXXXXXXXXXXXXXXXXXXXXXXXX
