-------------------------------------------------------------------------------------------------------------------------------------------------------XXXXXXX------------------------------------------
----------------BBB-------------------------------------------------------------------------------------------------------------------------------------------------------------------------------------
------------------------------------------------------------------------------------------------------------------------------------------------------BBB-----------------------------------------------
----------???XXXXXXXX---------------------------------------------------------------------------------------------------------------------------------------M------------------------XXXX---------------
--------------------------------------------------------------------------------------------------------------------------------XXXXXX-XXXXXX-------------------------------------------BBBBBB----------
------------XXXXX--------------------------------------------------------------------------------------------------------B--BBB----------------------------------------XXXX-----------------------------
-------------------------------------------------------------------------------------------------------------------------------------------------------------o---------------------------------------??-
-----------------XXXXXXXX----------------------------------------------------------------------------------------------o----------------X--------------------------------------------------XXXXXXXX----v
----------------------------------------------------------------------------------------------------------------------------------o--------------------------------------------------------------------f
-------------------------------------------------------------------------------------------------------------------------------------------------------------------------------------------------------f
-----------????????--------------------------------------------------------------------------------------------------?----------------------------------------BB-------?????-------------------B-------f
----X----XXXXXX-----X------------------------------------------------------------------------------------------------------------------------------------------------------T--BBBBB--------------------f
----XXBB-----------XX-----------------------------------------------------------------------------------------------XXXXXXX---------------------o-----BBXXXXXXXXX----------|--------------------T------f
----XXX-----------XXX---------------------------------------------------------------------------------------------------X---T----------X------------------------o----------|--------------------|------f
m---XXXXBBB------XXXX---------------------------------------------------------------------------------------??X????---------|---------XX-----------------------------------|-----------------BBB|------X
XXXXXXXXX-XXXXXXXXXXXXXXXXXXXXXXXXXXXXXXXXXXXXXXXXXXXXXXXXXXXXXXXXXXXXXXXXXXXXXXXXXXXXXXXXXXXXXXXXXXXXXXXXXXXXXXXXXXXXXXXX--|-XXXXXXXXXXXXXXXXXXXXXXXXXXXXXXXXXXX------XXXX|XXXXXXXXXXXXXXXXXXXX|-XXXXXX
