-o------------oB----------B----o--Xoo-o--B-X----B--------------X---o--------o--EX--o-----B-o---------o------o----o----Bo---o---------------X----B-o-oB---o-B--------B-XX-oo-B--------X----X-B---BT-----o
---Bo-o----B---o---------B--o-------------o-----------Bo------BX--B-----X----X-Xo-----o------------o------X--------------o-----o-------------o---o-------B---o----o--------B-----o-o----o--B--o--|------
o--------o---X---------o-o---B-o--------B---B------B-B-----X-B-----o-----------ooB-----oo---o--------o-T------o-----X-o-----o--B----------o--------o-XX------o-oBo------o---o-B-B-------------T--|-----B
----o-------B-------B-o------X------X---B---o-----B---B----B----BB----------------X---------o---o-B--B-|----o---------o----B------X------o-----------------o--o-o-X----T-----B----------------|--|---BXX
Xo---o--o--X-o-oB-----------B---B-XB-o--o-o--o-o-----B-B----o--oB-----X--X-------X-----------o-------B-|-----o--X---X----------B--B-oo------------------------------B-B|--oB--o-o----------Bo-|--|-o----
-----------B-----o-----o--------o---o---oo----BBXoo------o----B-----X----E-B------oo-B-----------------|-------o-------Bo---o--------------o---o-----B-----o-B--------o|-------o-X-o--B-----B-|--|----o-
-------------o------o-o-X---B-o--o--X-----------oX-B---B---o----B--o-X---B-----o---B----------Bo--XoB-B|-X-B-o-B---o----B---X-----------B--------o-------o----X--------|----X-----------BBo-B-|--|------
----------o--------o-------o---B-----X---B------X-o-Bo-X-----------B-Bo------------o-------------E----X|-B--------Xo---B-o--BX----X--B-----o-------X-------o-----------|--B----B------X-------|-E|-----v
o--o----B-------o-----Bo--------------o-----o-------o----o---E-----B---B----X-oo----------o------B-----|-B-------o----------BB-------------B--B------B-----B--o--X---X-|-oX-------Bo----o-----|-B|---o-f
BBo-o--------------E---------o-B----o-oo----B------------X---B----------o-oB-------o-Bo----------------|--------o-----------B-------o--B--o--X----XX---o---------------|---o-BB-B-----E-----o-|--|-----f
X---o-----Boo------B-o--BB--o-------oo---o-----o----o--BB-X-XX-Bo?BB--BE----E------------X---o---------|------B-------o---o--o----------------oo----------o-E-----o---X|--o-----o-----B------o|--|-o---f
----------o----B--o-------B---o--------o--------------?-----o-----o--B-B----BB-oB-o--o--B-----oB-B-X---|--B---o--o----o-----------B------------B---o--------X--------oX|------o-------Bo------|--|--o--f
X----B-oB-o--------B------------B-B-o-----o-B-o-o----B-------X---B--o-o------o-----B-------------oo----|--oBo--o-B-o-----o-o-o------------------Bo---B-----B---o--o-B--|-------------------X--|--|-o--Xf
BB-B-------o------T-------o---------X------------o----X---o--o-T--------B------------------E--o--------|--o----------o------Bo---X---------B---o----------B--------o-o-|-------------o-o------|--|-----f
mXB--oX-o-------E-|----Xo--Xo----Bo-----------o---B---X-----X--|----B-----B-o----oB--------X-----o-----|---B----------X---X-oX-BB-B------------------E---B--------X---o|---X------------------|--|-----X
XXXXXXXXXXXXXXXXXXXXXXXXXXXXXXXXXXXXXXXXXXXXXXXXXXXXXXXXXXXXXXXXXXXXXXXXXXXXXXXXXXXXXXXXXXXXXXXXXXXXXXXXXXXXXXXXXXXXXXXXXXXXXXXXXXXXXXXXXXXXXXXXXXXXXXXXXXXXXXXXXXXXXXXXXXXXXXXXXXXXXXXXXXXXXXXXXXXXXXXX
