-------X---------------------------------------------------------------------------XXXX-----?-------------------B--------o?--M--?XXXXXXX--------------------------------------------------------------X-
-------------------------------------------------------------------------------------------------------------------XXXX--B-----M----oo---------------------------------------X-----------------------M--
--------------------------------------------------------------------------B-----------XXXXXXX------o-B-o--------oo----------?--Bo----------------------------------------------------------------B------
------------------------------------------------------------------------------------------Bo----------------------oT-oo-----T----T-T--------------------------------------------------------------------
----------T------------------------------------------------------------------------------??--T----------T----------|--T----B|BBT-|-|-o-------------------------------------------------------------M--X-
----------|------------------------------------------------------------------XT----X---------|-----T--X-|--XT-----T|T-|-TT--|T-|-|-|-----X--------X--------------------------------------------------oB-
----------|-------------------------------------------------------------o----X|----XX--------|-----|--XX|MXT|-M-oT|||-|-||TX||-|-|-|X---XXXX-----XX---------------------------------------------o-------
---X------|--------------------------------------------------------T---------X|X---XXX-------|-----|--XX|XX||X-T-||||-|-|||X||-|T|-|XXoXXXXX---XXXX---------------------------------T---X---BBBBBBBB---v
---XX-----|-------------------------------------o------------------|-T--X----X|XX--XXXX------|-----|--XX|XX||--|-||||X|-|||T||-|||X|XXTXXXXXXX-XXXX---------------------------------|---XXT-----------Mf
---XXX----|--------------------------------------------------------|-|--XX---X|XXX-XXXXX-----|X--BB|BXXX|XX||-T|?||||X|-||||||X|||X|XX|XXTXXXXXXXXX--X-----------------------------X|B--XX|-X-----M----f
---XXXX---|--------------------------------------------------------|-|--XXX--X|TXXXXXXXXXo---|XX-BB|XXXX|XX||-||-||||X|-||||||X|||X|XX|XX|XXXXXXXXX-XX----------------------T-----XX|---XX|XXT---?----Xf
---XXXXX--|--------------------------------------------------------|-|--XXXX-X||XXXXXXXXXX-B-|XXX--|XXXX|XX||X||-||||X|-||||||X|||X|XX|XX|XXXXXXXXXXXX----------------------|--XXXXX|-o-XX|XX|-------XXf
---XXXXXX-|--------------------------------------------------------|-|--XXXXXX||XXXXXXXXXTX--|XXXXX|XXXX|XX||X||X||||X|T||||||X|||X|XX|XX|XXXXXXXXXXXX----------------------|---XXXX|o--XX|XX|------TXXf
---XXXXXXX|------------------------------X-------------------------|-|--XXXXXX||XXXXXXXXX|XX-|XXXXX|XXXX|XX||X||X||||X||||||||X|||X|TX|XX|XXXXXXXXXXXX----------------------|--XXXXX|---XX|XX|X-B-TX|XXf
m--XXXXXXX|-----------------------------XX-------------------------|-|--XXXXXX||XXXXXXXXX|XXX|XXXXX|XXXX|XX||X||X||||X||||||||X|||X||X|XX|XXXXXXXXXXXXX---------------------|-XXXXXX|--XXX|XX|XX--|X|XXX
XXXXXXXXXX|XXXXXXXXXXXXXXXXXXXXXXXXXXXXXXXXXXXXXXXXXXXXXXXXXXXXXXXX|X|XXXXXXXX||XXXXXXXXX|XXX|XXXXX|XXXX|XX||X||X||||X||||||||X|||X||X|XX|XXXXXXXXXXXXXXXXXXXXXXXXXXXXXXXXXX|XXXXXXX|-XXXX|XX|XXXX|X|XXX
