--B---o---o---o---o---o-----------o------o--------------------B-----------X----------X--------B--------------o-----oo--o------------------o---o-----X---------------------------------------------------
------B----E-----------X-------o-B------o--------o---------------------------------B-----o-X-------------------o----------o------------o--o------o------------o----B-------o---X-----------------------o
---o----B----o------------o--------B--------X------------X--------------oXX--B-B---o-o---B------o--BB-------B-----B-o-------B---X-----------o-X-o-----X-------o-B-----ooo-------------------------------
-----------o-----o----------------------B--------o------o----X-----o---------------------------------------X-------oX-----B----------------X------------oo-----------o----oB-B------o-------------o-----
-----------------------o-------B-X-o-o---o-o-o---------------------------------oX--o--B----X--Eoo-------ooo--XB--B---o------------------------o------------------o-o------Bo--X-------B---B-------------
--o-B-o-o-----X------------------------------o-oB----o--------X---------B-----------oBo--------------B------X-------o------------o-------B--o-------o--B-o------B------X-B-------B----o-------B-------o-
--------------B-------X--B----------------o----o------B----o-B---o----Bo---o----------------o----o----X-------------X-----o--oXX-ooB---------------B----------o--o-o------o---o------------oB--B--------
--------o-----------B-----------X---------B------------o-o--------B---oo-B-?--o--o-X--o--oBX------B-----o-------------o-o----o---o-------o------o----------------X-B---o--------o--------------o---o--ov
-----X---X------X---o-------B--X----------o--------------B-------------X-----------------Booo-------BX----B-----o-XB--------------o-----X-o-----------------o-----------------------o-----------------Bf
--B----B-------X-B---B-----o---------------E--o------o-o-o----B--B--------------o---X-o-----B--B------------B------------B--o----o-o-XoBo-----X-----E-o-----o---X-----o---------Bo--------o-o------X-oBf
--X------o-----o-----o----------B----o---------o----------oB-----B------------o---o-o-B------X-------o-----o-------------o----------------BX-o--B--oo------o-------o-------o--------------------o-Bo---f
--------B-E---------------------BE-------------------------------------------------oo---------------------------------B----B---o------B-----B----B--------o-----o-B---B----------o----B--o-o---------o-f
-o--Xo---BB-B-------------X---------o-----o----------E--o-o----B----o-------X---o------o-----------oo--o----X----------B--B--X---o-----oB---o----o-----B?--------------o-----------B-------o--B--o-Bo--f
----B----E-----X-B-o---------------o-------BB-?-----o-X-----o-------------------oB----------B-----B-B---X--BB--o----------X-E------o------B-B------B----o-Xo------E---------o-B---B---------------oo---f
m-B-------------B---------oB-------B---------------------X-----------o--------o------o---------o----X---oX--oo---o--o-----oB---------B-----o-----o-------------oB---------o----X---------------o--B----X
XXXXXXXXXXXXXXXXXXXXXXXXXXXXXXXXXXXXXXXXXXXXXXXXXXXXXXXXXXXXXXXXXXXXXXXXXXXXXXXXXXXXXXXXXXXXXXXXXXXXXXXXXXXXXXXXXXXXXXXXXXXXXXXXXXXXXXXXXXXXXXXXXXXXXXXXXXXXXXXXXXXXXXXXXXXXXXXXXXXXXXXXXXXXXXXXXXXXXXXX
