-BX--B------B---------------ooB----X--------o--X--------------------o---------Boo-------X------o---------?o---B------o-------o----------------------oo----------o----o--o---------B?B----o-BB-----XB-o--
---BX------o--E-------?-----------B----o-B----------oB--------B--oB---------X--------oo-X------------o-----------------o----B--o-o---Bo-BBo----o---BX-o---o--B--------------o----oB---o----------------B
EB-o----X--------XB----o--o--B-o------XBB-----o------o-------o-------------o-X--------------o---B------B-----------------B--o-----o--Bo-------------------------------B--B--------------o-B-------------
X-o---------E-o----X-----T------B----BE---o-----------------------o---oX--o------o-----o-?---Xo----o-B-o---------B---------E--X-X------o-------o-------o-o---B-o--------Bo-o-----Xo---B--X---------o--o-
-o---B----B-X------------|-B-X--o-----X--X-B---------o-----------o--o---B---B----o--B-B---------------B------oXX--B---B----XE------o------X------X-------B------Xo---------B----o--XX-----BB--X---B---B-
o----B-o-oo--B------oE---|--o-------------oBo-------------o----------X--o----B--------B-X------Bo-------B--o----B-----XB----B---B------oo--o----B---o---o-------X----B-X----X---X----o---X-oo-----------
---------o---o---B-X-B-oo|-B-----------oo---------o---X--X---X---B----------X--oT---------o---BB----o-------------B-o--o---------o--o-----BT--o--------oB-o-?o--B------------oX-B-----B--B------T-X--B--
o----B-BX---------------B|-----B-----BX-------o-o--o--BX-------------T--o-X---o-|----B-----B-B--Bo--B------o---ooo--X-------o---o----------|---------o---------B-------B-------------X-----o-o--|-o-o--v
-------------o----B----oX|-------oT---------X-oo-o----B---B---o-B-o--|----T-----|------o--oo----------------o---oo--B----------oX-oE-----o-|-------B--o-o----B-----B--------B----------------B--|--X--Bf
o----o-B--o------o--o-o--|---o----|--------B---------B------o-----B--|----|-Eo--|---------B--------o----B-------o---B--------B-----X--B-B--|----Bo--o----o----------Bo------o---------o--o-X-XB-|--o---f
-X-------------oB-------X|--------|-X------o--------------BB----E-Xo-|----|-B---|--------B-------X-E---------------------o----------o--B--B|---oo----oo-------------oo------X----o-o-----B------|----o-f
-----o---B--o---------BB-|--------|----B----------BB--B--------XX----|----|-B--B|-------X----o-----B-----?-o---B------B---B-X---------o--oB|----o---B---o-----------------B-------o--------B----|------f
--------oo-------B------X|------o-|-----B----o---o----X-B----------B-|-o--|----X|--Bo--oE--o-o-oB-X---o-o--Bo------------?------X---------o|------B------X--o-X-BB-----X-------------Xo---------|------f
---B-----------B--X--B---|----B---|---B--o---o-------------T--B------|-o--|--B--|-------Boo---o---o?--B----o--B------------o--o-----XT-X-o-|--Bo----B---B-----------BB-----X----oX-E-------o---B|-B-T-of
mE------E-----o------B--B|-----B--|-o--E-o----X------------|-----E--E|----|-o--o|-o---------X-X-----E--o-oB--E-o--B----o-------E--B--|--B--|-----E----------------X-----------o----B------B-oX--|--E|--X
XXXXXXXXXXXXXXXXXXXXXXXXXXXXXXXXXXXXXXXXXXXXXXXXXXXXXXXXXXXXXXXXXXXXXXXXXXXXXXXXXXXXXXXXXXXXXXXXXXXXXXXXXXXXXXXXXXXXXXXXXXXXXXXXXXXXXXXXXXXXXXXXXXXXXXXXXXXXXXXXXXXXXXXXXXXXXXXXXXXXXXXXXXXXXXXXXXXXXXXX
