---------------------------------------------------------------------------------------------------------------------------------------------o----------------------------------------------------------
---------------------BBBBBBBBBBBBBB------------------------------------------------------------------X--------------------------------------------------------------------------------------------------
--------------------------------------------------------------------------------------------------------------------------------------------------------------------------------------------------------
--------------------------------------------------------------------------------------------------------------------------------------------------------BBBBB-------------------------------------------
------------------------------------------------------------------------------------------------------------------BBBBB----X--------------B-------------------------------------------------------------
---------------X--------?------------------------------------------------------------------------B----------------------------------------B--------------------X----------------------------------------
--------------------------------------------------------------------------------------------B--------------------------------------------------B--------------XX----------------------------------------
--BBBB-------------------------------------------------------------------------------------------------------------------------------------------------------XXX---------------------------------------v
----------------------------------------------------------------------------------------------------------------X-------------------------------------------XXXX---------------------------------------f
-----------------------------------------------------------------------------------------------------------------------------------------------------------XXXXX---------------------------------------f
----------------------------------------------------------------------------------------------X---------------------------------------T-------------------XXXXXX---------------------------------------f
------------------------------------------------------------------------------------------------T-T------T----------------------------|------------------XXXXXXX---------------------------------------f
------T-----------------------------------------------------------------------------------------|-|------|----?-------------B---------|-----------X-B---XXXXXXXX---------------------------------------f
---X--|-------------------B---------------------------------------------------------------------|-|------|---------o-----T---------o--|----------------XXXXXXXXX---------------------------------------f
m--XX-|-------------------E--BE----X------------------------------------------------------------|-|------|E----------X---|-----------o|--E------------XXXXXXXXXX----------X----------------------------X
XXXXXX|XXXXXXXXXXXXXXXXXXXXXX------XX-XXXXXXXXXXXXXXXXXXXXXXXXXXXXXXXXXXXXXXXXXXXXXXXXXXXXXXXXXX|X|XXXXXB|XXXXXX-XXXXXXXX|XXXXXXXBXXXX|XXXXXXXXXXXXXXXXXXXXXXXXXXXXXXXXXXXXXXXXXXXXXXXXXXXXXXXXXXXXXXXXX
