------B------------------------------------------------------------------------------------------------------------------B--B---------------B---------BB?????---XB--------X------------------------X----
----------------------------------------------------------------------------------------------------------------B-X---B--------------------------------X---o----B------------------------XXXXXX--X------
--X------------------------------------------------------------------------------------------------------------------------------------XB------B---M---X-----?---------------------X--------------------
--------------------------------------------------------------------------------------------------------X--XXXXXXX--------B---------------------?X----oX------------------------------------------------
-----------------------------------------------------------------------------------------------------------------XXB----------------B-----T--TM--------B-----------X-T----X-----------B-----------------
------------------------------------------------------------------------------------------------------------X--------T---X--------X-X---BX|--|-X----B---B--X------XX-|-----------------------------M----
----------------------------------------------------------------------------------------------------------TT---X--X-T|--T----X-BBBBBBBB-XX|X-|-X---------?--X----XXX-|-------o--------------------------
----------------------------------------------------------------------------------------------------------||-------X||--|--------B-----XTX|--|B-X----X----XXX-B-XXXX-|------?---------X-B--------------v
----------------------------------------------------------------------------------------------------------||------T-||--|-------------XX|X|X-|X---B-XXXXXXXXX--XXXXX-|--------------X-----B-----X------f
------------------------------------------------------------------------------------------------------B---||-X----|-||--|-----T----B-XXX|X|XX|------XXXX-XXXX-XXXXXX-|------o------BBB----------XX-----f
----------------------------------------------------------------------------------------------------------||------|?||B-|-----|-X---XXXX|X|XX|------XXXXXXXXXXXXXXXX-|--------------------------XXX----f
------------------------------------------------------------------------------------------------------B---||--X-BT|-||-B|-T---|----XXXXX|X|XX|X-----XXXXXXTXXXXXXXXXo|-----B-----T--------------XXXX---f
---------------------------------------------------------------------------------------------------------?||X----||B||BB|-|---|---XXXXXX|X|XX|XXM---XXXXXT|XXXXXXXXXT|-----------|--------------XXXXX--f
---------------------------------------------------------------------------------------------------------X||B----||-||-B|-|--X|--XXXXXXT|X|XX|XXX--BXXXXX||XXXXXXXXX||-------B---|--------------XXXXXX-f
m-B-E-----------------------------------------------------------------------------------------------------||?----||-||--|-|--B|-XXXXXXX||X|XX|XXXX-EXXXXX||XXXXXXXXX||----------?|?????---------XXXXXXXX
XXXXXXXXXXXXXXXXXXXXXXXXXXXXXXXXXXXXXXXXXXXXXXXXXXXXXXXXXXXXXXXXXXXXXXXXXXXXXXXXXXXXXXXXXXXXXXXXXXXXXXXXXX||-----||-||XX|X|oXX|XXXXXXXX||X|XX|XXXXXXXXXXX||XXXXXXXXX||XBXXXXXXXXX|XXXX-------XXXXXXXXXXX
