-----------------------------------------------------------------------------------------X-------------------X-------?-B???X------oX?oXXBoBB-XXXXXB--XBMB--X---?-oB-------------------------------------
--------------------------------------------------------------------------------------B----------------o--------------X------B----B-B---BBB-B-X-oo-BB---M----B-M----B-----------------------------------
---------------------------------------------------------------------------------------------------------X-----X-------B--???----B--XB-M-B--X-B-B-BXoXB?BBB--XXBX---------------------------------------
----o-------------------------------------------------------------------------------------------B---B-B----------T-XX-X-X-TX-B-T-ooBo-BBBB-B-?-ToT-???X???BXBBBBBBB----T--------------------------------
------------------------------------------------------------------------------------o--------------X-------XB----|--Xo-BXB|XBBX|o---B-XX-T--B--|-|T-ToT-------?-?-oXB-X|--------------------------------
--------------------------------------------------------------------------------------X-X---------XX-----o-B---X-|-XX---XB|-B--|XXTXTXTo-|-MM-T|-||?|X|--TB??T???-B----|--------------------------------
--------------------------------------------------------------------------------------------B-X-MXXXB------o-----|XXX-X---|X--B|XX|-|T|-X|-XT-||X||?|X|?-|B-B|XX-X--X--|------B-------------------------
--------------------------------------------------------------------------------------B-------XXXXXX-------------|XXXX----|----|XX|-|||TB|X-|X||X||X|T|XX|X??|XX?B?XX?-|-------------------X-----------v
---T-------------------------------------------------------------------------------------T----XXXXXX-T----------X|XXXXX-X-|XTXB|XX|X||||T|-B|X||X||X|||XT|XXT|XXXTXXX--|---X---------------------------f
---|-------------------------------------------------------------------------------------|----XXXXXXX|--------XXX|XXXXXX-T|X|XX|XX|X||||||TT|X||X||X|||X||XX||XXX|XXXB-|--XX---------------------------f
---|---------------------------------------------------------------------------B-X-------|---XXXXXXXT|T---X-B-XTX|XXXXXXX||X|XX|XX|X|||||||||X||X||X|||X||XX||XXX|XXX-X|-XXX---------------------------f
---|-------------------------------------------------------------------------------------|X-XXXXXXXX|||X-B--XXX|X|XXXXXXX||X|XX|XX|X|||||||||X||X||X|||X||XX||XXX|XXX-X|XXXX---------------------------f
---|-------------------------------------------------------------------------------------|XXXXXXXXXX|||XXX--XXX|X|XXXXXXX||X|XX|XX|X|||||||||X||X||X|||T||XX||XXX|XXXXo|XXXX---------B-----------------f
---|--------------------------------------------------------------------------T----------|XXXXXXXXXX|||XXX-XXXX|X|XXXXTXT||X|XX|XX|X|||||||||X||X||X||||||XT||XXX|XXXXX|XXXX---------------------------f
m--|--------------------------------------------------------------------------|E------EE-|XXXXXXXXXX|||XXXXXXXX|X|XXXX|X|||X|XX|XX|X|||||||||X||X||X||||||X|||XXX|XXXXX|XXXX------E--------------------X
XXX|XXXXXXXXXXXXXXXXXXXXXXXXXXXXXXXXXXXXXXXXXXXXXXXXXXXXXXXXXXXXXXXXXXXXXXXXXX|XXXXX----X|XXXXXXXXXX|||XXXXXXXX|X|XXXX|X|||X|XX|XX|X|||||||||X||X||X||||||X|||XXX|XXXXX|XXXXXXXXXXXXXXXXXXXXXXXXXXXXXXXX
