----------------------------------------------------------------------------------------------------------B----------B----------B------------X---BBBBBBBBX----X------B-X-----o------o-------------------
--------------------------------------------------------------------------------------X-----o---------B-M-----BBBBB---Bo-B---X-B-------B-X-B-BB----------X-----B----XXBXXXX--------oX-------------------
----------------------------------------------------------------------------------------------X--------X---?B--?--------Xo---X--B---X-----BM--?B--B---------B--B-B-BB-B-X--B----B---------------------B-
-------------------------------------------------------------------------------------------T--B------------------X----T----M-----oB------X----------T-----BBBBBBBB-?-X---X------------X---BBBBBBBB---B--
----------------------------------------------X------------------M-------------------------|------------XXXXXXXXX-----|----XX--X--X----------X-----X|---T--B-oB----X--XT----B---B------X----X---X-------
----------------------------B-------------------------------------------B-M----------------|---B--XX------XX------B-TB|X--X----B-----T-----X-X--X---|---|---------B--XX|--?X--B--X-----M---XXT----------
-------------------------------------------------------------X------------X---------B------|----------oB-XXX------BX|M|--B---TTXB---X|----XX--XXXXXX|---|------?T--XXXX|---XX----XX----X--XXX|----------
--------------------------------------------------------------------------T--------------T-|-----B--B-T-XXXX-B-BB-X-|B|-BB---||-----X|-T-TXXXXXXX---|-B-|--X-T--|--XXXX|-X-XXXBBBXXX--XX-XXXX|---------v
----------------------------------------------------------B------------B--|-B------------|B|-X--?----X|XXXXX-----XXX|?|-BB---||----BX|X|X|XX-XXXX---|-T-|-XXX|--|?XXXXX|XXXXXXX--XXXXXXXXXXXX|---------f
--------------------------------------------------------------------------|--------------|-|----------|XXXXXBXB---XX|-|oT-X-T||-BX--X|X|X|XXXXXXX-X-|-|B|XXXX|--|XXXXXX|BXXXXXXX-XXXXXXXXXXXX|--X?-----f
--------------------------------------------------------------------------|--o-----------|-|------TX-X|XXXTXXXX-B-XX|X|-|B--|||--XX-X|X|X|TXXXXXXX--|-|-|XTXX|X-|XXXXXX|-TXXXXXXXXXXXXXXXXXXX|---------f
---------------------------------------------------------------------?----|--B----X------|-|------|-XX|XXT|XXXXXo-XX|X|-|-M-|||--XXXX|X|X||XXXXXXXX-|-|X|X|XX|XX|XXXXTX|M|XXXXXXXXXXXXXXXXXXX|----X----f
--------------------------------------------------------------------------|---???XXX-----|-|--B-??|XXX|XX||XXXXTX-XX|X|X|--?|||--XXXX|X|X||XTXXXXXXX|-|X|X|XX|XX|XXXX|X|-|XXXXXTXXXXXXXXXXXXX|---------f
---------------------------------------------------------------------X----|-------XXX----|X|--B---|XXX|XX||XXXX|TXXX|X|X|---|||-TXTXX|X|X||X|XXXXXXX|X|X|X|XX|XX|XXXX|X|-|XXXXX|XXXXXXXXXXXXX|-B-------f
m---------------------------------------------------------E---------XX----|--EE---XXXX-E-|X|---E-X|XXX|XX||XXXX||XXX|X|X|XBB|||-|X|XX|X|X||X|XXXXXXX|X|X|X|XX|XX|XXXX|X|X|XXXXX|XXXXXXXXXXXXX|-----E?--X
XXXXXXXXXXXXXXXXXXXXXXXXXXXXXXXXXXXXXXXXXXXXXXXX----XXXXXXXXXX-----XXX----|--XXXXXXXXXXXX|X|XXX-XX|XXX|XX||XXXX||XXX|X|X|XX?|||B|X|XX|X|X||X|XXXXXXX|X|X|X|XX|XX|XXXX|X|X|XXXXX|XXXXXXXXXXXXX|--------XX
