---------X--------------------------------o--B--X------------------B------B-------------B------o------oo----X------o------------------------X-------------Bo-------B---------------X-----B--------------
-------------------------------B------------B-----------B-----o--B-B-----------o--------------B-----------------o---o------------------------o---------------o---o----o-----------B-------------B-o-X---
--------o--------X----BXBXB--o-------o--------------------ooB--------o--B---o-------B-----------------B----------B----o-o-------B-------------Bo---B-----o----------B----X---------------------X--------
----o--------------XM----o---------------------o-o-o-----------?---------X--------Bo-----o------------Xo------o---X-------X---BBo--o-----B------B----------------o-------o------------------X----X-o----
---oX--------o--------------------X--B----o---------o----B-oX-----BE--o--o--o-E------Bo---X---------o-o-E---------o----------------o--o-----EX------X---o-----B-B-B--------------X--------------B-------
---B-------oB--------o----------XE---o-----------oo--------X----oE-Bo-o-----o--------o-----------oB----o-B---B-------B----------X-----------------------------B-o-Bo--BB--------oo----o-----o---o-------
---B---------------oo-------------o-X-B----------X-----------------B----------B----B--------B---------B---------------o---X--o--B--B--B---B--------o----------X---------o-B------------B--------B-------
------o---X--Boo-X--------B----E---------X-------X-B---?-----o-o----------------------------------oX-----B--o------B-----------------o----------X--ooB---B-oB----------------B-o----------o-o-B--------v
---BooBo---B-o-------E-------Xo-------o-----------o-X--------o-o-Xo-----E---o---X-X---------o----B--o----o----o--o-o--o---X---------------o-------E----o-------oEo-------------o----o-----------Bo-----f
--o--o-----------B------------o-B-o----o---------------B-----X-------o--Bo--BB-----X-----X-B------B----X-Bo--o----o-----o---------B-----oB------BoBo---------o---------X------oB-o--B-----o---------Bo-f
---------------------------------------------oB---o-------o-------B------BB---B--Xo----------o---o--------o--Bo-X-B-----o---o---o---B-------oo---XB-------------------o------B---o------o-----------o--f
----o--o-B------oo-------------o--B---o-------oo-----------o---E-o------------XoB-o------------X------o--------X--o------o-----o-o---------E--o-o--------o---B----oB-------B-----------------o----o-X--f
--------------o--o---X-----o---X-o-----o-o------------B--------o--------------------B-B-----------o---o--------X----o--o---------B-------o--X---oo-------------o--B-----------X----B---------Bo-BE-B---f
-o----o----o-------o-----------o----------EB----------B-------o------o--------B-----B----B------o-oo-o----------o----oo---o---------o-------------oo----------o------o---o----B--o---------------------f
m---B---EX--B------------o---XX--ooo---B---B----B---X------o-o------B---------B-----o-oo-B-E---------------X-------X--B----------o------o--o-----Xoo-o-----------o-------oB--o--E-o-o--o---------------X
XXXXXXXXXXXXXXXXXXXXXXXXXXXXXXXXXXXXXXXXXXXXXXXXXXXXXXXXXXXXXXXXXXXXXXXXXXXXXXXXXXXXXXXXXXXXXXXXXXXXXXXXXXXXXXXXXXXXXXXXXXXXXXXXXXXXXXXXXXXXXXXXXXXXXXXXXXXXXXXXXXXXXXXXXXXXXXXXXXXXXXXXXXXXXXXXXXXXXXXX
