--------------------------------------------------------------------------------------------------------------------------------------------------------------------------------------------------------
--------------------------------------------------------------------B----------------------BBBBBBB---XXXXXX---------------------------------------------------------------------------------------------
----------------------------------------------------------------------------------------------------XXXXXXXX------------------------------------------------BBBBBBBB------------------------------------
-????????-----------------------------------------------------------------------------------------------------------------------------------------------------------------------------------------------
-----------------------------------------------------------------------------?-X--------X-----------------XXXXXXXXX-------------------------------------------------------------------------------------
--BBBBBBBB------------------------------------------------------------------------B------------------------------------------------------------------------------o--------------------------------------
-----------------------------------------------------------------------o--------------------------------------------------------------------------------------------------------------------------------
-----------------------------------------------------------------------------XXXXXX--------------------------------------------------------------------------------------------------------------------v
------------------------------------?????--------------------------------------------------------------------------------------------------------------------------------------------------------------f
-------------------------------------------------------------------------------------------------------------------------------------------------------------------BBBBBB------------------------------f
----------------------------------------------------------------------------------BB--------------------------------------------------------------------------------------------------??????-----------f
-?????BBB------------------------------------------------------------------------------------------------------T--o------------------------------------------------------------------------------------f
--------------------------------------------------------------T---------------X--------------------------------|---------------------------------------------------------------------------------------f
--------------------------------------------------------------|-----------X------------------------------------|--------------------------------------------------------------------B------------------f
m-------------------------------------------------------------|------------------------------------------------|---------------------------------------------------------------------------------------X
XXXXXXXXXXXXXXXXXXXXXXXXXXXXXXXXXXXXXXXXXXXXXXXXXXXXXXXXXXXXXX|XXXXXXXXXXXXXXXXXXXXXXXXXXXXXXXXXXXXXXXXXXXXXXXX|XXXXXXXXXXXXXXXXXXXXXXXXXXXXXXXXXXXXXXXXXXXXXXXXXXXXXXXXXXXXXXXXXXXXXXXXXXXXXXXXXXXXXXXX
