---M------------------------------------------------------------------------o-------------------------------------------------------------B-------------------------------------------------------------
--------------------------------------------------------------------------------------------------------------------------------------------------------------------------------------------------------
----------------------------------------------------------------------------o------B-------B-------------------B----------------------------------------------------------------------------------------
--------------------------------------------------------------------------------------------------------------------------------------------------------------------------------------------------------
------------------------------------------------------------------------------------XXXXX--------B---------------------------------------------------------------------------------------------------T--
---------T------------------------------------------------------------T-------------------------X-------------------------------------------------------------------------------------------B---o----|--
---------|------------------------------------------------------------|-----T---------B---------------------------------------------------------------------------o----------------------------------|--
---------|------------------------------------------------B-----------|-----|------------------------------------------------------------------------------------------------------------------------|-v
---------|------------------------------------------------------------|-----|-------------------------------------BBB-------------------------------------------------------------------B------------|-f
---------|------------------------------------------------B-----------|-----|------------------------------------------------------------------------------------------------------------B-----------|-f
---------|------------------------------------------------------------|----B|----X--------------X--------------------------B-------------------------------------------------------------------------|-f
---------|------------------------------------------------------------|-----|------------XXXXXB------------------------------------------------------------------------------------------------------|-f
---------|-----o------------------------------------------------------|-----|------------------------------------------------------------------------------------------------------------------------|-f
---------|------------------------------------------------------------|-----|------o-------------X---------------------------BBBBBB------------------------------------------------------------------|-f
m-------E|---------------------------------------------------------E--|-----|-----B--------------E---------------------------------------------------------------------------------------------------|-X
XXXXXXXXX|XXXXXXXXXXXXXXXXXXXXXXXXXXXXXXXXXXXXXXXXXXXXXXXXXXXXXXXXXXXX|XXXXX|XXXXXXXXXXXXXXXXXXXXXXXXXXXXXXXXXXXXXXXXXBXXXXXXXXXXXXXXXXXXXXXXXXXXXXBXXXXXXXXXXXXXXXXXXXXXXXXXXXXXXXXXXXXXXXXXXXXXXXXX|XX
