------B--B---o--o-------------B--o---X-X------------------o-------B--B----------------------o-----------o-o----Bo--------------B-o-o---X----oX-B-----------B-o-----------B----------X---------------o--B
-------------B-o-o--o----------o-o--oB------X---oB-------B-B--B--X-----o-o-?---------------oo---o----B-B-----B-o-----o-oXo------B--------oo--X---------B--o------B-----------B---B---oo------B-BB-o-----
---------o-----------o--B------B-B-------------o-------o-o------BX--------o-o----o------o--B-B---------o--B-o--o----Bo--------o------X--o-BoB----oo-----------------B---o-------o-o-----o--X-----o----o-
------X-------o-Bo---------BX---o--o--Xo--X-oo----------E-----o-------X--o-----Bo---------X-----o-o--BX-------o-------------oB-o--B------BB---oBoB------------------o---E--T-B-oo--o--o----------oo-E---
oX----------------------------B---B-----X-o-ooo--B----X-B-----X--o----BB--B------B-X-------o---o---o-----------------EB-E--------------------X-------o-o------------o---B--|--BB-------E-----BB-----XX-B
-oX-o----BB---E---TB-----B-----Xo---------Bo--------o-----B-B----o-o------------------o-----------B---?---o-B-------o-B-B--o-o--o------------------------------------o-----|--o-X--------T-B------------
-----------T--X---|----------o--B---EE---o----B---o-o-B-X---o----X---------Xo?---o--------o---------------------------o-------o-B---BB------B---B-B-----------o---X-X---o-B|-------o---X-|--o----o-B----
o---B------|-o----|--B--B------oB--o--X-------------o-------X--Bo-B--o---o----XB----X---------B--o---ooo-----E-B---B----o--o---X-----o--o--B--B---X------B-X-B----B--------|-----B-B-B---|-------------v
-------B---|------|--T-o-E-X--B-----------BB-o--B--oX---B--X-oB--Bo-To----B-o-----B-----------B-o------------------------------BB-o-X-----o-B---BB---B----o--B-------------|-o---X----XX-|-o--o--o-----f
---o-BX----|-oB---|--|---------XX-o--o------B---Xo---------B--X---o-|---------------------o-------BT--BB---X---B--------------oo----oo----B---------------o-B-----B--o----B|----------EB-|---------o-X-f
-oo-B--E---|-----B|--|----B-o------o--oB---B------Bo-o--B---o---o---|---o---o-B-o----B-B--B--X-X---|--oo--B-o-o-----?oo------Bo-------------o--B----X-----------X-B--------|--o------X---|-------------f
--X--o---Bo|------|--|---------T--X---o-o---oo---X---o-B--o------Bo-|--oo------oX-o--------o-------|----o-o-o----------XX-----o---------o-------o-----o----o-----o------X--|----------T--|--o----------f
o-------Bo-|-----B|--|--Xo----B|---E---o-o--o-------B-o---oX-B------|-o----B---X----o-------o------|-B---------B---o----B-----o--o--o---o-o----BB-----o-----B-----X-E------|-o-BB-----|--|-------------f
X----------|----o-|--|-Bo------|-----BB----o-------o-oo--------B-X--|--o--------------o-B-------o--|----o-oB--o--o----------------XoB--o----------E--o----------o--------o-|-----o--X-|--|---------B---f
m-o--o---oo|---o--|--|--E------|-E----E----X------E-------------o---|---------o---o----X-B----B----|-------E----B----oB---o----o--o---------X--o-----o----o---B-o--BEooE---|---E---X--|--|----E--o---B--
XXXXXXXXXXXXXXXXXXXXXXXXXXXXXXXXXXXXXXXXXXXXXXXXXXXXXXXXXXXXXXXXXXXXXXXXXXXXXXXXXXXXXXXXXXXXXXXXXXXXXXXXXXXXXXXXXXXXXXXXXXXXXXXXXXXXXXXXXXXXXXXXXXXXXXXXXXXXXXXXXXXXXXXXXXXXXXXXXXXXXXXXXXXXXXXXXXXXXXXX
