---------------------------------------------------------------------------------------------------------------------------------------------------------------------------BB---------------------------
----------------------------------------------------------------------------------------------------------------------------------------------------------------------------------B---------------------
--------------------------------------------------------------------------------------------------------------------------------------------------------------------------o-----------------------------
--------------------------------------------------------------------------------------------------------------------------------------------------------------------------------------------------------
-------------------------------------------------------------------------------------------------------------------------------------------------------------------B-X--------X-------------------------
--X-------------------------------------------------------------------------------------------------------------------------------------------------------??--------B----------------------------X------
----------------------------------------------------------------------------------------------------------------------------------------------------------???--------------B--------------------XX--X---
-----------------------------------------------------------------------------------------------------------------------------------------------------------------------------------------------XXX-----v
-------------------------------------------------------------------------------------------------------------------------------------------------------------------------------o------X-------XXXX----Xf
--------------------------------------------------------------------------------------------------------------------------------------------------------------------o----------?------XX-----XXXXX---XXf
--------------------------------------------------------------------------------------------------------------------------------------------------------------------------------------XXX---XXXXXX--XXXf
----X---------------------------------------------------------------------------------------------------------------------------------------------------B----------------XT-----------XXXX-XXXXXXX-XXXXf
----------------------------------------------------------------------------------------------------------------------------------------------------------T-------------o-|-----------XXXXXXXXXXXXXXXXXf
----------------------------------------------------------------------------------------------------------------------------------------------------------|---------------|-----------XXXXXXXXXXXXXXXXXf
m-----------------------------------------------------------------------------------------------------------------------------------------------------o---|-------E-------|-----------XXXXXXXXXXXXXXXXXX
XXXXXXXXXXXXXXXXXXXXXXXXXXXXXXXXXXXXXXXXXXXXXXXXXXXXXXXXXXXXXXXXXXXXXXXXXXXXXXXXXXXXXXXXXXXXXXXXXXXXXXXXXXXXXXXXXXXXXXXXXXXXXXXXXXXXXXXXXXXXXXXXXXXXXXXXXX|------XXXXXXXXX|-------X---XXXXXXXXXXXXXXXXXX
