--------------------------------------------------------------------------------------------------------------------------------------------------------------------------------------------------------
---------------------------------------------------------------------------------------------------------------------------------------------------------------B----------------------------------------
-------------------------------------------------------------------------------------------------------------------------------------------------------------------------------o---------------------?--
----?????-----------------------------------------------------------------------------------------------------------------------------------------------------------------------------------------------
----------------------------------------------------------------------------------------------------------------------------------------------------------------------------------------------??--------
----------BBB-------------------------------------------------------------------------------------------------------------------------------------------------------------------------------------------
--------------------------------------------------------------------------------------------------------------------------------------------------------------------------------------------------------
-------XXXXXXXX------------------------------------------------------------------------------------------------------------------------------?????--------------------------------------------------BBBv
-------------------------------------------------------------------------------------------------------------------------------------------------------------------B-----------------------------------f
-----------------------------------------------------------------------------------------------------------------------------------------------------------------------------------------BBBBBBBB------f
--------------------------------------------------------------------------------------------------------------------------------------------------------------------------------------???BBBB----------f
-XX---???----------------------------------------------------------------------------------------------------------------------------------------------------------------------------------------------f
---------------------------------------------------------------------------------------------------------------------------------------------------------------------------?????------------BBBBBB-----f
-------------------------------------------------------------------------------------------------------------------------------------------------------------------------------------------------------f
m-----------------------------------------------------------------------------------------------------------------------------------------------------------------------------E------------------------X
XXXXXXXXXXXXXXXXXXXXXXXXXXXXXXXXXXXXXXXXXXXXXXXXXXXXXXXXXXXXXXXXXXXXXXXXXXXXXXXXXXXXXXXXXXXXXXXXXXXXXXXXXXXXXXXXXXXXXXXXXXXXXXXXXXXXXXXXXXXXXXXXXXXXXXXXXXXXXXXXXXXXXXXXXXXXXXXXXXXXXXXXXXXXXXXXXXXXXXXX
