--------------XX----------------------------------------------------------------------------------------------------------------------------------------------------------------------------------------
------------------------------------B---------X----------------------B----------------------------------------------------------------BBBBB-----------------------------------------------------------B-
-------------------------------------------B------------------------------------------------------------------------------------------------------------------------------------------------------------
-----------------X------------------------------------------------------------------------------------------------------------------------------------------------------------????????------------------
----oBB---------------?-----------BBBBBBBB--------------------------------------------------------------------------------------------------------------------------??-------------------XXXXXXXX-------
-----??????-------------------------------------------------------------BBBBBBBB------------------------------------------------------------------------------------------------------------------------
--------------------------------------------------------------------------------------------------------------------------------------------------------------------------------------------------------
------------------------------------B---------------------------------------------------------------------------------------------------------------------------------------o-BBBBB--------------------v
---------------------------------------?????-----------------------------------------------------------------------------------------------------------------------------BBB---------------------------f
-----------------------------------------------X-----------------------------------------------------------------------------------------------------------BBB-------------------------??????????------f
----------------------------------------BB----XX-----------------------------------------------XXXXXXXX--------------------????------------------------------------------------------------------------f
---------------------------------------------XXX??????------------------------------T---------------------o--------------------------------------------------------------------------??BBBB------------f
----T----BBBBB------------------------------XXXX------------------------------------|----------------------M-------------------------------------------------------------XXXXXXXX----------------------f
----|---------???--XXXXXXX---------------o-XXXXX------------------------------------|-----------------------------------------------------------X---BB???????-XXXXXX----------------------X------------f
m---|---------------------E---------------XXXXXX------------------------------------|----------------------------------------------------------XXB---------------------------------------XX------E-----X
XXXX|XXXXXXXXXXBXXXXXXXXXXXXXXXXXXXXXXXXXXXXXXXXXXXXXXXXXXXXXXXXXXXXXXXXXXXXXXXXXXXX|XXXXXXXXXXXXXXXXXXXXXXXXXXXXXX---XXXXXXXXXXXXXXXXXXXXXXXXXXXXXXXXXXXXXXXXXXXXXXXXXXXXXXXXXXXXXXXXXXXXXXXXXXXXXXXXXX
