------B-----oo--o-o----B---XB-B--o--o----------------o--o---------B--B------------------X---o-o------------------------o-----o--------BX--o----B--------------------o----------------------------------B
---o--X--------o--------B------o-o--oBo-B--oX----------B---B-----X-----------------------oooo---------------o--------o--X-------BBoo--B---o----B-o--------o------BB--------B-B-----------o---B----------
--------------oo--o----------o---------BB----o-o--o------------o---B-o---------------------B-B---------o----o----EB--------B---------X--B-B-B------B------o--------------o------o-----Xoo--X-o--B-------
------------E-o-B-----oB-B--B------o--o-----------B------X--------X---o-----X--B----o-----o-----o-B--------o----o-X----o-----B-o--B-----BBB----B-B--oB----B--BB----o-B----oT---o---o---B----X-----oXE--o
o---------B-------------------o----X----B----o--------X-------X-------BB---------B-----------B---------X-B------B----B--BX-----o-oB---B-B-----B--------B-----------------BX|--B----B------o---------E-o-
-oX-o----XBo-----BT-X------o---X-----o-o-X-o--oo--oB----B-B-B--o---o---o--------------E------B----B-------o-------o-B-XXB-----X----------o----------B----o------E----------|--B-X-B------T--------------
---------o-T----o-|--X---------o----B----------o--o--------B---o------------o?------------o---------oo------o-------------------------------B---B-oB-----------------------|-------XB----|-------o-----o
o---BooB-BB|------|-----B-----Bo--B-----o--B--------o------X--EB-----o-----oB---------o-B-------B----oo--------B--------o-o--BB-o--B-o--o--------------B---X-B------o----B-|--------o----|------B------v
----XX-----|------|--T----o---B-o------------oo-B----o-------o---B--T--------X-----B------X--X--------------------?------------------oo------B-----B---------X-X---o---E-o-|----B--------|-o---------B-f
-o-o--X--X-|-o----|--|------o------o------X-B---Xo---B---B-o--B-o---|--o-------X--oo-----------oo--T--B--o---------?oX--X--B--o-o----oX-----B-B-B-E----B----Bo---X-o-o---o-|-B-----------|---------o---f
-o--Bo-----|------|-B|------oB--------oB-o-B----------Xo--B-BB-B----|--o-o---XB-B-o----X--B-----oB-|--oo-B-Xo---------o--X-oo-------B--o-o-o-B-------o-----------X--X------|--o-o-------B|---X--o---oE-f
---------Bo|------|--|-o-------T--o----o---------------o--B---------|--oo-o--o------o-o---------BB-|-o--o---o----o------o--o--o---B-Bo--o--------B-o--X----o-----BB--------|----------T--|-------------f
o-----B----|-o----|--|-------o-|-------o-o---oo-------o-------------|---------o-----o--o-B--o------|--------o------o----BE----o---------o---B-BBB-----------B-----------B--|-o-B-o---o|--|------------of
X-------B--|----o-|--|--E------|-o---------o-oo-----------B---o--Xo-|-oo---B--------------------o--|------X----B--B------o-o--o-B---B-----X--o----B-X--B-----B-------------|-----oX---|--|----B-B------f
m-X-------o|------|--|---------|-o----E--B-----------X-o----o---o---|--ooBE---BE-Eo-B------B----B--|----o---X-o-------B---o---X----------o--o----XB---------o-B------E-E-M-|------o---|--|-----oB-o-----
XXXXXXXXXXXXXXXXXXXXXXXXXXXXXXXXXXXXXXXXXXXXXXXXXXXXXXXXXXXXXXXXXXXXXXXXXXXXXXXXXXXXXXXXXXXXXXXXXXXXXXXXXXXXXXXXXXXXXXXXXXXXXXXXXXXXXXXXXXXXXXXXXXXXXXXXXXXXXXXXXXXXXXXXXXXXXXXXXXXXXXXXXXXXXXXXXXXXXXXX
