-------B-B---o--oBo----------o---o-X-X-X-o----------------B--o-----o------------------------o-------Xoo-o--X----o---------------o-------o-o--------------X------X---o--o------oo--------------------oBBB
--------o--Bo--o-o----B---------oo---B-----oXo---------B-B-BB-B-B--o----------o---------BXoo---oo---XX--o-o-o--o----oo--Xo--------oX--B---o----B-B--------o---o--B---------B-B-----------o---BoBo-------
------B-B-----oo--------B-----------------------B--------B-----o-B-------------B-----------o---------oBo----o-------o-----X-Xo---o---X--B--oBX--B-o------B----------oB-------X-B----o--Xo--XX-o---------
----------------B-X-----o---B------------------o------------o-oX-o---o---------B------------------o---B-o--B---B----B--------oo-----o---o--------B---B-X--o-----o----------T-B-B------B-----------o---oB
o------X-------------------oB-o----X-o------B-B---B----------o----oB--o------o----o------o-------------X--------------B--B---------Bo--B------B--B-B-o-----B--o------------|--------X-B----------o------
-o---------------BT---o-o------X---------XB---o---oB--------o---------o-X------------o-------X---XB-----o-------------o--------o---B-----------------o------X----o-------BB|--Bo--o------T----X---------
--o---B----T--o---|-X----B---E------B----B---X----o-o--BX-B--o-----------X--X----B-----o-------o------------B----o--------B----------B------B-------oB----XB----------Bo---|------X-----B|-o----o-----B-
o---------o|------|---o---X----------------X---B-----------X---------o------X-----o---oo-----------------o-----------------oo-o--o----------BXo-B-BE-------------B--o------|-------B-----|-------oo---ov
-----B----B|---B--|--T---o--o-------------o--------------o---B----o-TB-------X-X-oo-----B-X--oo--X----------------------------------B------------B-B-------o---------B-----|-------------|------------Xf
---o-Xo----|------|--|----o----X-o-o------X-o---Xo-------B-o----B-oo|-B---o----X--------oB-----E---T--B------o--o--?o---X----oX-o---o------B--B-B-----X----B---X-----o---o-|-B-----------|---o----B--o-f
--o--B-X-o-|-----B|-B|---------B--o----B---o-----B-----o-o---o-B--B-|---------------------B------oo|----------o-o-o-?--------B------o-XX----B------o------------X-o-o------|--oX-oX-B---o|----o-oo--o--f
--X----B---|------|--|---------T------o-----------o-B--B-----B-B----|--------B------BB-oB-----o--B-|----B---X-o--o-----oo--BX-o---B---BX--------B----------------B--Bo-XX--|----------T--|-------------f
o----------|-oo---|--|--o------|--------Eo--o--oB-----Bo------------|----------X---o-o-ooo--o-B-X--|--o---o----B-----B?--o---------------BX----B---B-------oo-X-------E----|-o---o---o|--|--o------B---f
X---B------|----oo|--|------BB-|-oX----B-----o---------------------B|-oo--B------------------------|--B------X------o----o--------B----------o----o--o-E--B--Bo----o-------|-----o--X-|--|---------o---f
m-X-X---E--|------|--|--------E|-------o----o---o------o----E-------|-----E--B---E-B---o---E-----o-|--------o-o-B------B------X------o-o---E---------o-B----B-B-oo---oE--B-|-B-E--X--o|--|-------o------
XXXXXXXXXXXXXXXXXXXXXXXXXXXXXXXXXXXXXXXXXXXXXXXXXXXXXXXXXXXXXXXXXXXXXXXXXXXXXXXXXXXXXXXXXXXXXXXXXXXXXXXXXXXXXXXXXXXXXXXXXXXXXXXXXXXXXXXXXXXXXXXXXXXXXXXXXXXXXXXXXXXXXXXXXXXXXXXXXXXXXXXXXXXXXXXXXXXXXXXX
