--------------------------------------------------------------------------------------B-----------X-------------------------------------------------------------X------------------?--------------------
-M-------------------------------------------X--------------------------------------------------------------------------------------------------------------------------------------------------------B-
----------------------?---------------------------------------------M-----------------------------------------------------------------------------------------------------------------------------------
--------------------------------------------------------------------------------------------------------------------------------------------------------------------------------------------------------
-----------------------------------------T--X------------------------------X----------------------------------------------------------------------------------------------------------------o-----------
-----------------------------------------|------------------X-------------XX----------------------------------------------------------------------------------------------------------------------???---
-----------------------------------------|-------------------------------XXX------------------------------------------------------------------------------------------------------------------------X-X-
-----------------------------------------|------------------------------XXXX-----------------------------------------------------------------------------------------------------------------------XX--v
----------------------o------------------|-----------------------------XXXXX----------------------------------------------------------------------------------------------------------------------XXX--f
-----------------------------------------|----------------------------XXXXXX---------------------------------------------------------------------------------------------------------------------XXXX--f
----------------------------------------B|---------B----------------XXXXXXXX--------------------------------------------------------------------------------------------------------------------XXXXX--f
-X---------------------------------------|--------------------------XXXXXXXX-------------------------------------------------------------------------------------------------------------------XXXXXX-Bf
-----------------------------------------|-?-----------------------XXXXXXXXX------------------------------------------------------------------------------------------------------------------XXXXXXX--f
-----------------------------------------|------------------------XXXXXXXXXX----------------------------------------------------------------------------------------------------------------BXXXXXXXX--f
m---o-----E------------------------------|---------E-------------XXXXXXXXXXX----------------------------------------------------------------------------------------------------------------XXXXXXXXX--X
XXXXXXXXXXXXXXXXXXXXXXXXXXXXXXXXXXXXXXXXB|XXXXXXXXXXXXXXXXXXXXXXXXXXXXXXXXXX-----XXXXXXXXXXXX---XXXXXXXXXXXXXXXXXXX------XXXXXXXXXXXXXXXXXXXXXXXXXXXXXXXXXXXXXXXXXXXXXXXXXXXXXXXXXXXXXXXXXXXXXXXXXXXXXXX
