-oo--o---B-------B-------B------------------------o-X--------oo-------o------------B-o-B----------B-------------B----o---------B-BoBB-----------------o------------o----------------o---o-o-------------
-o--o-X-----o--oo---oB--B--o--o-----BoX---o----B----E-ooBB--B-o-o----B-o------o---------o------------------oXBX-------------B---------------o-----B-o-----B-----o-----oo-------B----------------B--B--o-
----------------o----?-o-----------B--B----B--------B-B---B------oo-o-----------B-----------o----------------Xoo----------------X--B-----E----------oo--E------o---BB-Xo----------------E------o-----o--
X---o-------B-o--B----------------oB---------------------------------------------o----X-----B-oB-B-o--o----o------------B---oo---o------o-------o--------o----o--------B--BX---o--o--------------B--X--o
-X-----X-----oB--------B------BB----------B----------------o------BX--o----oB--o--------B-o--------------B--o-------------------o---B----B------B--------o-o--B----B----------o--Bo------B-----X-------B
Bo-----------------o---------B-----------o----oB-o---------B--oB---o------------o--X----------o--o---------B---------------X-o-------o------B----Bo-----X--------o----X--B---ooo-----B-B------B--B--o---
---------X--o---o--------------B---X--o---o-------X----o-o-------Bo-o---------BB-?-----E--o--Bo-----B--------o----------B-T---o--o---o------B-o----o--Xo-----------B---------------E--o-------------o---
----oo----------X-o-----o--o-----B-XX------oo-o-----X-X-------------------oo---o--------B-------o--B--------o----ooo------|-o----------B---------o-o-----B-------------Bo--B-----B---X--o----o---o-----v
-----B-o---------o----------o----------------------------o---------B----o---------------o-----B----o-----B-X--o----B-E----|-----------------BB------------B--Bo-oB--------B-----o-----o--B-B------o-Boof
-B---------------------ooo-------------------------B------oB--X-------------------oB-------B---B--oXoo---X--------------B-|-----B-------o---oo----o--B---o----Bo----B---B-E----o----o---XX---B---------f
---T-----o-------oo---------------------B-B---T---o--------B-----o--------o---------B-------B--B---------o---BBo----E--Xo-|-------o-----B--B---------o------B-o--------XB-o--------o-E------B--Bo------f
---|------oB-BoB-------X----o-------oB--X-ooB-|---oo-----o----------B---------BB-o-------o-------X---o--o-B--o--BX----B---|--Bo---------oo-B--oo----B-----------o----B----X------o----E----B---X---X--of
-B-|-----o-----------o------o-----oo-X--------|----X-----o---------------------------------o--------o-oo-o--B--B----B-oo--|---B-------o-----------B--BB-------X-o--BB---o-oX-X----------------o--------f
---|--------------Bo--o----B-oo-o---o-o--B----|-------E--o-----o--B-B-o------------o---B-o--------BT--B-------------------|----B-------o--------o-----E-B-------X----o----------o-----o--------X---Booof
m--|--B--E---------o----o-----------B---------|-------------o----ooo-B----------B----oo--Booo--o-o-|--------E-BE-BE------X|---------------B------o--------o---oB------o--X------oX----o-E-o-----B--B----
XXXXXXXXXXXXXXXXXXXXXXXXXXXXXXXXXXXXXXXXXXXXXXXXXXXXXXXXXXXXXXXXXXXXXXXXXXXXXXXXXXXXXXXXXXXXXXXXXXXXXXXXXXXXXXXXXXXXXXXXXXXXXXXXXXXXXXXXXXXXXXXXXXXXXXXXXXXXXXXXXXXXXXXXXXXXXXXXXXXXXXXXXXXXXXXXXXXXXXXX
