---------------------------------------------------------------------------------------------------------------------------------------------X------X---------------------X-------M---------BBBBBBBB----
-------------------------------------------------------------------------------------------------------------------------------------------------------X------------------B---B-------------------B-----
------------------------------------------------------------------------------------------------------------------------------------------------------------------------------------------------------X-
-------------------------------------------------------------------------------------------------------------------------------------B-----------T---T-M----B-B-------X-------------------------------B-
-------------B---------------------------------------------------------------------------------------------------------------------B-----------?-|B--|X-------------------B-X-B--------------------X----
-------------------------------------------------------------------------------------------------------------------------------------------------|---|----???????-------X--XX--X------------------------
-------X------------------B----------------------------------------------------------------------------------------------------------------------|--X|o--------------X--XXXXX--XX---X--------------T----
--------------------------------T----------------------------------------------------------------------------------------------------------------|---|--------------XX--XXXXX--XXX---------o--XX---|T--v
--------------------------------|--------------------------------------------------------------------------------------------------------------T-|---|M----BT------XXX--XXXXX--XXXT-----------X----||--f
--------------------------X-----|------------------------------------------------------------------------------------------------------------T-|-|---|---o--|-----XXXX-XXXXXX--XXX|X-X-------XXBBBX||B-f
----------------------X------X--|------------------------------------------------------------------------------------------------------------|-|-|---|--XB--|----XXXXXXXXXXXXX-XXX|XXXX-----XXX----||--f
-----------------XX-------------|-----------------------------------------------------------------------------------------------------------T|-|-|---|------|---XXXXXXXXXXXXXXXXXX|XXXXXX-BXXXX----||--f
--------------------------------|-----------------------------------------------------------------------------------------------------------||-|-|BXX|XXXX--|--XXXXXXXXXXXXXXXXXXX|XXXXXX-XXXXX-o--||--f
--------------------------------|-----------------------------------------------------------------------------------------------------------||-|B|---|---B?-|-XXXXXXXXXXXXXXXXXXXX|XXXXXXXXXXXX----||--f
m---------------------------E---|------------------------------------------------------------------------------------------------B----------||-|-|--X|E-----|XXXXXXXXXXXXXXXXXXXXX|XXXXXXXXXXXX----||--X
XXXXXXXXXXXXXXXXXXXXXXXXX----XXX|XXXXXXXXXXXXXXXXXXXXXXXXXXXXXXXXXXXXXXXXXXXXXXXXXXXXXXXXXXXXXXXXXXXXXXXXXXXXXXXXXXXXXXXXXXXXXXXXXXXXX-Xo--X||-|X|BXX|XXXX-M|XXXXXXXXXXXXXXXXXXXXX|XXXXXXXXXXXXXXX-||--X
