--------------------------------------------------------------------BBBBBB----------------------------------------------------------------------------???????-------------------BBBBB-------------------
-------------------------------????????--------------------XXXX-------------------------------------------------????????-----------------------------------------------------------------------XXXXX----
-------------------------------------------------BB---------------------------------------------------------------------------------------BBB--------------------XXXX--XXXXX-o--------------------------
-----------------X---------------------------o-------------------------------?------------------------------------------------------------------------B--------------------BB---------------------BXXX--
------------------------------------BBBBBXB---------------------------------------------------------------------------------------------------M---------------------------------------------------XXXXX-
--------------------------------XXXXXXX------------------------X----------------------------------------------------------BBBBBB------------------------------------------------------------------------
--------------------------------------------------------------------------------------------------------------------------------------------------------------------------------------------------------
---------XXXXXXXX-----------------------------------------------------------------------------------------------------------------BBBBBBBB-----------------------------------------------??????--------v
--------------------------------------------------------------------------------------------XXX---------------------------------------------------------------------------XXXXX----------???????-------f
--------?------------------------------------------------------------------------------------------------------------------------------------------BBBBBBBB----------------------------------------??--f
-------------------------X-------------------------------------------------------------------------------------XX------------------------------------------------------------------XXXXXXXX------------f
--------------------------------------------------------BBBBBBBBB--------------------------------------------------------------------------------XXXXXXX--T--------------------------------------------f
----------------XXXXXX----------------------------------------------------o---------X------------------------------------------------------o--------------|----------------------T---------------------f
-----------------------------------------------------------------------------------XX-------------------------------------T-----------------?????----XXXXX|XXXX------------------|-----------BBBBBXXX--f
m-------------Eo-E--E-------------------------------------------------------------XXX-------------------------------------|---------------------------XX--|-----------------E----|---X-BBBBBBB---------X
XXXXXXXXXXXXXXXXXXXXXXXXXXXXXXXXXXXXXXXXXXXXXXXXXXXXXoXXXXXXXXXXXXXXXXXXXXXXXXXXXXXXXXXXXXXXXXXXXXXXXXXXXXXXXXXXXXXXXXXXXX|XXXXXXXXXXXXXXXXXXXXXXXXXXXXXXX|XXXXXXXXXXXXXXXXXXXXXX|XXXXXXXXXXXXXXXXXXXXXX
