----------------------------------------------------------------------------------------------------------------------------X--M--X---B-----------------------------B-----------B-B------B--------------
--------------------------------------------------------------------------X----------------------------B--------B-----------------X--------------------------------------X----------B-------------------
-------------------------------------------------------------------------------------------------------B--------------------------B-------------------------------------B--------------B--------B-------
----------------------------------------------------------------------------------------------------------------X-------------------------------------------------X--B------------X----X--------------X-
-X---------------------------------------------------------------------------------------------------------XB---------------B---B----BBBBBBBBB-----------------------------T-X--B-M-X--X----X-X--XX---?-
-----------------------------------------------------------------------------------------------------------------B-------------B---MXX-------------------------------------|XX--B--X?XXX??-XX--XXX?-B-B-
------------------------------------------------------------------------------------------------------------------B-----------B--------------------------------------------|XX---?-BoXXXB-XXX--XXT------
---------------------------------------------------------------------------------------------------B------------------------------BB--BX--------------------------------B-X|XX?XB--BXXXX-XXXXXXXX|--X-Xv
------------------------------XXXX---------------------------------------------------------------------------------------------X-----o-XX------------------------------T-XX|XX-X---XXXTXXXXXXXXXX|--XX-f
------------------------------------------------------------------------------B------------------T----------------XXXX---------B-------XXX-B---------M-----------------|XXX|XX-X--XXXX|XXXXXXXXXX|--XXXf
---X---------------------------------------------------------------?-----------------------------|-----------------------------?-------XXXX-------------------------o-X|XXX|XXX--XXXXX|XXXXXXXXXX|--XXXf
------------------------------------------------------------------------------------------------B|-----X---------B---------B---------T-XXXXX--------------------T-----X|XXX|TT-TXXXXXX|XXXXXXXXXX|--XXXf
-------------------------------------------------------------------------------------------------|---------------------------X-B-B---|-XXXXXX-------------X----X|----XX|XXX|||X|XXTXXX|XXXXXXXXXX|XXXXXf
-------------------------------------------------------B-----------------------------------------|-----------------------------------|-XXXXXXX----------?????---|---XXX|XXX|||X|XX|XXX|XXXXXXXXXX|XXXXXf
m------------------------------------------------------------------------------E----------E------|----------------E-------E-----B----|XXXXXXXXX-------------E---|--XXXX|XXX|||X|XX|XXX|XXXXXXXXXX|XXXXXX
XXXXXXXXXXXXXXXXXXXXXXXXXXXXXXXXXXXXXXXXXXXXXXXXXXXXXXXXXXXXXXXXXXXXXXXXXXXXXXXXXXXXXXXXXXXXXXXXX|XXXXXXXXXXXXXXXXXXX-XXXXXXXXXXXXB--|-XXXXXXXXXXXXXXXXXXXXXXXXX|XXXXXX|XXX|||X|XX|XXX|XXXXXXXXXX|XXXXXX
