---------------------------X------------------------------------------------------------------------------------------------------------------------------------------X--------?--B---------------------
--------------------------------????????----------------------------------------------------------------------------------------------------------------------------B-----B---B----o---------------?--X-
------------------------------------------------------------------------------------------------------------------------------------------------------M-------------------------------o-------------B---
------------------------------------------------------------------------------------------------------------------------------------------------------------B-B-----?-XBX------B-T-----BBBBBBBB---------
-------------B---------------------------------------------------------------------------------------------------------------------------------------------------------BBBB--BBX-|B-------X-------------
------------------------------------------------------------------------------------------------------------------------------------------------------------------B-----X--------|-X------T----X-X------
-------X------------------B------------------------------------------------------------------------------X---X-------------------------------------------------X--BBBB--XX--X-X--|XX?---X-|---XXXXX-----
-------------------------------BT---B----------------B------------------------------------------------------XX------------------------------------------------T----M---XXXXXXXXXX|XX------|--XXX-XXX---v
--------------------------------|--------------------------------------------------------------------------XXX------------------------------------------------|----XXB-BXXXXXXX-X|XX-X-X--|-XXXXBXXXX--f
--------------------------X-----|-------------------------------------------------------------------------XXXX----------------------------------------------o-|-B-----X-XXXXXXXXX|XX---M--|XXXXXXXXXXX-f
----------------------X------X--|------------------------------------------------------------------------XXXXX-----------------------------------------------B|---------XXXXXXXXX|XXX-----|XXXXXXXXXXXXf
-----------------XX------------B|-------------------------B------XXXXXXXX------X------------------------XTXXXX------------------------------------------------|----B---XXXXXXXXXX|XX----XX|XXXXXXXXXXXXf
--------------------------------|---X-------------------------------------------------------X----------XX|XXXX----------------------------------------------BB|BBBB-?-XXXXXXXXXXX|XX---XXX|XXXXXXXXXXXXf
--------------------------------|---------------------------------------------------------------------XXX|XXXX-----X------------------------------------------|------XXXXXXXXXXXX|XX--XXXX|XXXXXXXXXXXXf
m---------------------------E---|-------E--------------------E-------------------------------EE------XXXX|XXXX------------------------------------------------|-----XXXXXXXXXXXXX|XXBXXXXX|XXXXXXXXXXXXX
XXXXXXXXXXXXXXXXXXXXXXXXX----XXX|XXXXXXXXXXXXXXXXXXXXXXXXXXXXXXXXXXXXXXXXXXXXXXXXXXXXXXXXXXXXXXXXXXXXXXXX|XXXXXXXXXXXXXXXXXXXXXXXXXXXXXXXXXXXXXXXXXXXXXXXXXXXX|XXXXXXXXXXXXXXXXXX|XXXXXXXX|XXXXXXXXXXXXX
