-B----B----o------------------B-E------X-o--o--oX-B--o-o-oB---X--------------o---BB-B------XX-------------o--------------o------B-------E-----o-------BB-----X-------o------o------oo--------B---Bo--oB-
---o---oX---------------X-------X----o-------o---------B----B--------o-o------o-----------B--------B----------------B---o---o--o--o-B---B-B---?o-----------o----X----X--B-----------Xo---o--B-o--X------
---------o------B-o---o--o-B--------oo-----------o--o---BB---------o?----------o-o-B---------------------oB---o-----------X-o-------X---BoBo------------------ooXo--T------X---o---------oo-X-X-B-----B-
---------B--B-------B-o-----B-----------------E--o-o--oo---------o------o---o---------------o--B----X--B-----------oX--T--B----------o----o-o---B-------o-o--o----o-|-B------------B-------------------o
---o-------B--------B---o------o---o------X---B-----Xo-o----oB--o-----X----B--B-o---B--X-o-----------o---BB---B-o--B-o-|-----------o---o----X------------Bo---------|------XB------Bo-----X--o------B---
-B-------B-------BB--o----X-----B-X-----X----B--o------X---X---o------o-BB-X---X--o----------oo--o---o----------o------|---Bo-o--------o---o--B---------o--o----E---|------------o-B-o---o-------------B
----X-----o------------oo----B-------o-B---o--X-o--o--------o----------Xo-o---X--B---X---oB---X-----oX-B----X-X-o------|---------?----B---BX--o---X--B-B----o-o-B--o|----o--X-------X-----XX--o-----oE--
-Eo--------B----oo-B----o---o-o--------B--o-o--oo----o-o----B-----o---o----------o---------X--o------------o----o-oX---|--------------o---o-oo-o--------BX-B-o--o--X|-----oX---XX---B----o-B-X---o---X-v
-XXo------o-------X-------oo------B---------o--B-X------------B---------o--o-----o---------------------------o---------|-T-B-----o---o-------o--o----------o--------|-o------------B------o--o--o------f
X-o-----B------------B-o--o--o-B-------o-B-----oB---?--------X---o-X---o-------BB----B---oX------------oo---X---o-E----|-|-B--------B-B--------------o-----?--------|-----o---B-------B----o----B-o----f
---BB------------B--------X---------oo------o-----X--B---oB--------------o----X-----oo---------------o-----o-B----Boo--|-|---------Xo-o--------o-------B------T-----|--oo-B-------o--o-----oE--B-B-----f
-----X----o----o----------------------------------o--B------------X---o----------o-o---------------X---------------o--o|-|-o------------X-------o--------B----|-----|------B--XB--B---------X--oo-o-B--f
X------o--BB--o-----XoB-o-oo-oo--------o-------------------o--o--------o----o---B---B--------o--B----oX---o---o---B-oo-|-|---------B---B----------------------|---o-|-----o---X-------BE---o---B-----o-f
----o--------B--o-o-Bo----XB---o-------o---oBo--B---------o--o---------o-----o---o------BB-o-----X----B----B------X----|-|-----o-o-------o--o---BB---o------X-|-oB-o|--XB-----BB--o---oB----------oB---f
m-o----T------B-BEEB-----B-B----ooo--------EE----X-BoEB----o-o---B--oBB-------B---B--------------oB-XB----o---------oE-|-|-o-B----E-oE-B------o---B-------oE--|----o|---------o----o--B----o---------o-X
XXXXXXXXXXXXXXXXXXXXXXXXXXXXXXXXXXXXXXXXXXXXXXXXXXXXXXXXXXXXXXXXXXXXXXXXXXXXXXXXXXXXXXXXXXXXXXXXXXXXXXXXXXXXXXXXXXXXXXXXXXXXXXXXXXXXXXXXXXXXXXXXXXXXXXXXXXXXXXXXXXXXXXXXXXXXXXXXXXXXXXXXXXXXXXXXXXXXXXXX
