--------------------------------------------------------------------------------------------------------------------------------------------------------------------------------------------------------
--------------------------------------------------------------------------------------------------------------------------------------------------------------------------------------------------------
--------------------------------------------------------------------------------------------------------------------------------------------------------------------------------------------------------
--------------------------------------------------------------------------------------------------------------------------------------------------------------------------------------------------------
--------------------------------------------------------------------------------------------------------------------------------------------------------------------------------------------------------
--------------------------------------------------------------------------------------------------------------------------------------------------------------------------------------------------------
--------------------------------------------------------------------------------------------------------------------------------------------------------------------------------------------------------
----------------------------------------------------------------------------------------------------------------------------------------------------------------------------------------------------BBBv
---------------------------------------------------BBB-----------------------------------------------------------------------------------------------------o-------------------------------------------f
------------------------------------------------------?------------------------------------------------------------------------------------M-----------------------------------------------------------f
---------------------------------------------------o------------------------------------------------------------------------------------------------------------------------------B--------------------f
------T---------------------------------------------------------------------o--------------------------------------------------------------------------------------------------------------------------f
------|-------------------------------------------------------------------------------------------------------------------------------------------------------------------------------------------o----f
------|---------------------------------------------------------------------------------------------------------------------------------------------------X--------------------------------------------f
m-----|-------------------------E---------------------------------------------------------E---------------------------------------------------------------XX-------------------------------------------X
XXXXXX|XXXXXXXXXXXXXXXXXXXXXXXXX---XXXXXXXXXXXXXXXXXXXXXXX-------XXXXXXXXXXXXXXXXXXXXXXXXXXXXXXXXXXXXXXXXXXXXXXXXXXXXXXXXXXXXXXXXXXXXXXXXXXXXXXXXXXXXXXXXXXXXXXXXXXXXXXXXXXXXXXXXXXXXXXXXXXXXXXXXXXXXXXX
