------B---X---------B---B----------------------------------X-----------------------------X------------------------------------------------------------B---------------------B---------------------------
-------------------------X----------------------B----------------------------------------------------------------------------X--------B----------------------------------------X------------------------
-------------------------------------------X--X----B-------------------------------------------------X-------------X------------------------------B------------B------------------------------B---------
---------------------------------------------------X----------------------------------X-------------------X------------------X------XX---------------B-----------------B------------B-------------------
----BB-------------------------------------B--------X-------------B----B-X--------X--------------------X-X---------------------------------------------------------B------------------------------------
----X----------X-B---X----------------------------------------------B---------------------------------B---------------------------------------------------------XB--------------------------------------
-----------B-----------------------------------B-------------X----X------------------------X-----------------X-------B----B---------------------------------------------------------------X-------------
---------------------X---------------------------------------------B------------------BX---------------------------------B-------------------------B---------------------------------------------------v
------------X-BB----------------------------X-------------------------------------X--------------------------B-------------------------X------------------------B--------------------------------------f
----------------------------------B---------------------B-----------------------------------------------------------------------B---B-X---X----------------------------------------B-------------------f
-B---------------------------------------------------------------------------------BB---------------------X----------B------------------------------------B-------------------X------------------------f
------------------------------------------XX-----------------------------------B---------------------------------------B---------------------------------------------------------------------X---------f
--------B---------------------------------------------------------------------------------------------B-X----B-----------------X-B--------------------------------B------------------------------------f
-B-----------X--------X----------------------------B----X--------------------X----------------------------------------------------B-----X----------------------------X---------X-----------------------f
m------------X--------------------X-----------------------------X---------------------------B-----------------------X----------------------------------------------------------------------------------X
XXXXXXXXXXXXXXXXXXXXXXXXXXXXXXXXXXXXXXXXXXXXXXXXXXBXXXXXXXBBXXXXXXXXXXXXXXXXXXXXXXXXXXXXXXXXXXXXXXXXXXXXXXXXXXBXXXXXXXXXXXXXXXXXXXXXXXXXXXXXXXXXXXXXXXXXXXXXXXXXXXXXXXXXXXBXXXXXXXXXXXXXXXXXXXXXXXXXXXXX
