-------------------------------------------------------------------------------------------------------------------------------------------------------------------B------------------------------------
--B----------------------------------B---------------------------------------------------------------------------------------------------------------------------------------XB-------------------------
------------------------------------------------------B-------------------------------------------------------------------------------------------------------------------------------------------------
-----------------------------------------------------------------------B---------------------------------------------------------------------------------------------B----------------------------------
--------------------------------------------------------------------------------------------------------------------------------------------------------------------------------------------------------
-------------------------------------------------o------------------------------------------------------------------------------------------------------------------------------------------------------
---------------------------------------------B--B-X---------------------------------------------------------------------------------------------------------------B-------------------------------------
----X--------------------------------------------------------------------------------------------------------------------------------------------------------------------------------------------------v
---------------------------------------------------------B-B------B-------------------------------------------------------B------------------------X---------------------------------------------------f
---------------------------------------------------------o--B-------------------------------------------------------------------------------------XX---------------------------------------------------f
---------------------------------------------------BB--------------------------------------------------------------------------------------------XXX-------------------------------X-------------------f
----------------------------------------B-------------------------------------------------------------------------------------------------------XXXX----------T------------X-------XX------------------f
----------------------------------------M---------X--------X---------T-------------------------------------------------------------------------XXXXX----------|------------------B-XXX----T---------T--f
------X------------------------------------------XX------------------|------------------------------------------------------------------------XXXXXX----------|-------------B------XXXX---|---------|--f
m----XX-----------------------------B-----------XXX--E---------------|-----------------------------------------------------------------------XXXXXXX----------|--------------------XXXXX--|----E----|-XX
XXXXXXXXXXXXXXXXXXXXXXXXXXXXXXXXXXXXXXXBXXXXXXXXXXXXXXXXXXXXXBXXXXXXX|XXXXXXXXXXXXXXXXXXXXXXXXXXXXXXXXXXXXXXXXXXXXXXXXXXXXXXXXXXXXXXXXXXXXXXXXXXXXXXXXXXXXXXXX|XXXXXXXXXXXXXXXXXXXXXXXXXXX|X-XXXXXXX|XXX
