-----BBBB-------------------------------------------------------XX-------------BB--------------B---------------------------------------------------------------------------------------X--X-------------
---------------------------------------------------------------------------------------------X---B----------------------------------------------------------------------------------?---------------X---
-----------------------------------------------------------------------------------------------------B------------------------------------------------------------------------------B-------B---M--X-X--
-----------T----------------------------------------------------------------------B---------------------------------------------------------------------------------------------B--X-o--X---------------
---?-------|----------------------------------------------------------------------------X--------------T-B------------------------------------------------------------------------XXX-----B-BX---T------
-----------|---------------------------------------o------------------------o----------XX-----------B--|-----------------------------------------------------------------------------B--???B??---|------
-To--------|------------------------------------------------------------------B-------XXX---X---X------|-------------------------------------------------------------------------------X-?-X--M--|----X-
-|---------|----------------------------------------------------------------X--------XXXX-----o---BBBBB|BB----------------------------------------------------------------------------B-oB-X-----|-M---v
-|---------|---------------------------------------------------------------????-----XXXXX-------T------|????---------------------------------------------------------------------M----?----------|----Xf
-|---------|-----------------------------------------------------------------------XXXXXX---X--X|--oX--|---------------------------------------------------------------------------BX-----X------|---TXf
-|--T------|----------------------------------------------------X--------X--------XXXXXXX---XXBB|BBBXX-|--X------------------------------------------------------------------------BB-XT---------|--X|Xf
-|--|o-----|-------------------------------------------------------------XX------XXXXXXXX-B-XXX-|-X-XXX|-XXoX---T---------------------------------------------------------------------X|---X-----|-TX|Xf
-|--|------|-------------------------------------------------------------XXX--M-XXXXXXXXXX--XXXX|---XXX|XXX-----|-------------------------------------------------------------------o-X|X--XX----|X|X|Xf
-|--|------|-------------------------------------------------------------XXXX--XXXXXXXXXXXX-XXXX|--XXXX|XXX-----|------------------------------------------------------------------B--X|XX-XXT-T-|X|X|Xf
m|-E|------|-------------------------------------------------------------XXXXXXXXXXXXXXXXXXXXXXX|XXXXXX|XXX-----|--------------------------------------------------------------------EX|XXXXX|X|X|X|X|XX
X|XX|XXXXXX|XXXXXXXXXXXXXXXXXXXXXXXXXXXXXXXXXXXXXXXXXXXXXXXXXXXXXXXXXXXXXXXXXXXXXXXXXXXXXXXXXXXX|XXXXXX|XXX-XXXX|XXXXXXXXXXXXXXXXXXXXXXXXXXXXXXXXXXXXXXXXXXXXXXXXXXXXXXXXXXXXXXXXXX-X-X|XXXXX|X|X|X|X|XX
