X---o-----BB--B----o-------------BB-----------B-------------X---------oo--------XXX--------X-------B-------------B----X-X--oB--BB--------BX-------------------------o-B----BB---o-oo--------T----o-X----
-B---o-X-o-----oB---o---XB------X---o---o-X-E-o---------------o---XBo-------oX-o---o--Eo--o----BX----o-o----------------------B---o----------o-----o-X-X---------B--X-o-----XBB-------------|-------o---
--B-----oo---o-B----BoBo----Xo-X----------------o--oo-------o--------------B-------o---X-----B-oB-------B-------------o---o------X-----BX---------B----------X--o---o-----o---o----Bo--X----|-----o-----
X-----BB------X----X-oB-----o--------------oB-------B-------o---------B-----oo-o---B-----------B-B----o-o------------B---X----B-o--B--X-o------B------o----B---------B-----------o-----o----|--B--------
-------oB--E--o----E-X-o-------o-o---X----B-o----------X----o-o---o-B-B-----B--o---------oB-B---o----o-B----X-------B--oE----o----B-X----------o-B-----B--Xo---o------BBX-X------Bo----B-B-B|--o---X----
-T--------------B----E-------------X-X---------o-----Xo------------B-B-X------o---------o-oo-------B-----------B-----------------X-o--------B-------o----oo---oBB--oX------o------Xo--------|--oT-----o-
B|--X---o----------B-B--o--B---o--o-X-------B--------------------oB----------B---------------B---B------o-------------B----B-BX-o-B--o-----B----------o-o----o-BoB---B-------o-----o--------|-o-|----B--
-|----------B------o---BB-B-----X--o-o--------Bo---------------oo-------------o--B------------B--o---o-B-o---X-o------o--o-----B--B---o-----B-----EB---B-------o-----------B-o--B---B---XB--|--B|------v
B|--------B--T-o--------o-----------B--B----X--o--o---B--B--B-----X-----B----o-----B--------B-X------o-----o----o---o-----------B-BXo-oB---o---------oX-o-----------X--------E------------o-|---|------f
-|--BB--o---X|--X--------o-o---------B-X-----X--------B--X-o-B---BB--BoB--E------------o-B-B------o--o-----EBB----oB---B------BX------o----------B--XX---------------X--o----o--------------|-o-|-----Bf
o|---o-----oo|---------Xo-o-oo------------X--B-----o-----------B----------o----B------X------B-----o------------o--------------------Boo-----o-E--o--o-o-oX------X------B-----------B---o-B-|---|------f
-|---------o-|--------o--o-o------o-------o-----------B--o--------o-BX------B----------o-ooB----B--X-oBo------B--o--oB---B--X-B--X--o-------------X----------B-------B--o-----o--o----XB-B--|--o|-B-B--f
-|---o-----o-|----------------B-B----------------B-------o-X-------o-X------B-------------o-----o----Xo------BT---B---oX--------X---------------o--B-----------oX--B----o---B----ooo--o----o|---|---B-of
-|-oX-----oBo|--X-o----B-o-X------E-X-----B----o---------X----------B----B---B------B-o--B--oM-B------E---BBo-|-----B---------ooX--T-----Xo--------B------o-----o--------------o--oo-o--oE-o|-X-|------f
m|--E---B----|---E-----oB--X------o--B-oXooE-o---B-----o-oo--EBo-B-----B-------oE-oo--B-----o--E---E-oX-X---oo|-o---o-oE---o------X|-B---------------E---------B-o--EE----B-EX----E--o---o-o|---|-------
XXXXXXXXXXXXXXXXXXXXXXXXXXXXXXXXXXXXXXXXXXXXXXXXXXXXXXXXXXXXXXXXXXXXXXXXXXXXXXXXXXXXXXXXXXXXXXXXXXXXXXXXXXXXXXXXXXXXXXXXXXXXXXXXXXXXXXXXXXXXXXXXXXXXXXXXXXXXXXXXXXXXXXXXXXXXXXXXXXXXXXXXXXXXXXXXXXXXXXXX
