--------------------------------------------------------------------------------------------------------------------------------------------------------------------------------------------------------
---------------------------------------------------------------------------o----------------------------------------------------------------------------------------------------------------------------
-----------------------------------------------------------------------???????--------------------------------------------------------------------------------------------------------------------------
--------------------------------------------------------------------------------------------------------------------------------------------------------------------------------------------------------
-----------------------------------------------------------------------------------------------????????-------------------------------------------------------------------------------------------------
--------------------------------------------------------------------------------------------------------------------------------------------------------------------------------------------------------
-------------------------------------------------------------------------------------------------o------------------------------------------------------------------------------------------------------
---------------------------------------------------------------------------------------------------XX--------------------------------------------------------------------------------------------------v
------------------------------------------------------------------------------------------------------------------BBBBBBB------------------------------------------------------------------------------f
-------------------------------------------------------------------------------------------------------------------------------------------------------------------------------------------------------f
--------------------------------------------------------------------------------------------------------XXXXXXX----------------------------------------------------------------------------------------f
--------------------------------------------------------------------------------------------------------------------------------------------------------------------------------------------X----------f
--------------------------------------------------------------------------------------------------------------------------------------------------------------------------------------------XX----T----f
------------------------------------------------------------------------XXX-----------------------------------------------------------------------------------------------------------------XXX---|----f
m----E-------------------------------------------E------------------------------------------------------------------------XXX---------------------------------------------------------------XXXX--|----X
XXXXX-X---XXXXXXXXXXXXXXXXXXXXXXXXXXXXXXXXXXXXXXXXXXXXXXXXXXXXXXXXXXXXXXXXXXXXXXXXXBXXXXXXXXXXXXXXXXXXXXXXXXXXXXXXXXXXXXXXXXXXXXXXXXXXXXXXXXXXXXXXXXXXXXXXXXXXXXXXXXXXXXXXXXXXXXXXXXXXXXXXXXXXXXXX|XXXXX
