--------------------------------------------------------------------B-----------------------------------------------------------------------------------------------------------------------------------
--------------------------------------------------------------------------------------------------------------------------------------------------------------------------------------------------------
--------------------------------------------------------------------------------------------------------------------------------------------------------------------------------------------------------
------------B--BB-------------------------------X---------------------------------------------------------------------------------------------------------------o---------------------------------------
--------------------------------------------------------------------------------------------------------------------------------------------------------------B-----------------------------------------
-------------------------------------------------------------------------------------------------------------------------B----------------------------------------------------B-------------------------
----------------------------------------------------------------------------------------------------X---------------------------------------------------------------------------------------------------
--------------------------------------------X--------------------------------------------------------------------------------------------------------------------------------B-------------------------v
-------------------------------------------------------------------------------------------------------------------------------------------------------------------------------------------------------f
--------XXXXXX-------------------------------------------------------------------------------------------------------------------------------------------------------------------------X---------------f
---------------------------------------------------------------------X--------------------------------------------------------------------------------------------------B-----X------------------------f
----------------------------------------------------------X-----------------------------------------------------------------------------------------------------------------------X--------------------f
----------------------------------------------------------XX-----------------------------T------------X------------------------------------------------------------------------------------------------f
---------o-------------X----------------------------------XXX----------------------------|-----------XX---------------------X---------------------------------------o----------------------------------f
m-EEEE----------------XX----------------------------------XXXX-----------E---------------|----------XXX--------------------XX-----------------EE------E------------------------------------------------X
XXXXXXXXXXXXXXXX----XXXXXXXXXXXXXXXXXXXXXXXXXXXXXXXXXXXXXXXXXXXXXXXXXXXXXXXXXXXXXXXXXXXXX|XXXXXXXXXXXXXXXXXXXXXXXXXXXXXXXXXXXXXXXXXXXXXXXXXXXXXXXXXXXXXXXXXXXXXXXXXXXXXXXXXXXXXXXXXXXXXXXXXXXXXXXXXXXXXX
