----o-----------------------------------------------------------B-o---------o--------X---BB-o------o------------o----------X-o-o-------X-oo-o----X---------B----B-X-------X-------X----BoB--------------
----o-o-X--------XB---B-------o------------------B---------X---oB--oB----o-------B-------------o-------B---------o-o-o--o-----------------------o-o---o----oo-----------------------BoX---------Bo------
-----------------------B-XB------o--o-----o--X------X--B-BoB---------------B---B----o-XX-----o-------------o---------------o----o---o------------------B--Boo------B--------o--------------E---------B-X
------o---------o--------o----o-Xo---E--B-B-----o-o--------oBX---------o---------o------------------o--------------B-------------X---o---------------X----------------------------B--------------------o
----------o------o-----------------o-B-----------o----o------o-o----o-----B-o---B-----------o--BoB---------o-B--Bo---------------------B------X-o-------------Bo---o--o-o-B---oX------B----------o-o----
-----o--------B---B-------------o-----ooo----B-----------------------o--------B-------oE---o-------B-------------o-----B-o----------o---o---X---X--------------------------oXBo-------o-o-----o--oo--o-X
---------B----o-B--o-----------------o---X--B---B----------------B---X--X---oo---------X--------B--------B----------o--X--o-B-----------o--------------o---------o?-B----o-B-----X-------------X---oo---
--------o-----o-------X------------------------B---------o-B----------o--oo-----B----------------B-Xo-----B--------B----X-------B---B-----------------o------------------------------------X-----------v
----o--Xo-------o----X-------E-----o----o-o-oo---------o--------B-------X-------------------B-------X----------------------o-B-------o----------------------B--o--------------------X------o-o---------f
-----o-o---o----o---o-----------o---------o--------o-----o--o--B-ooo----XXB----Bo-----B----B--B-------o--X---------------B-----B----------------Bo---------o-----------------oo-X-------BB--B----------f
----B------o---o--------------o-----oo------o--------B---------------X-o--o-o----------o---oX----------o-------------o------X----------------------o---B----oo----------------X-B--o--o--o--------X----f
---------X-B------o--B-----B-------------------------B---X--Bo------------o------------o-Bo-----B----------?---------o-----o----B--o------o----oo--------o----------o-----o-o--B--B------X-Xo----------f
------o---B---?B------------------------B-------------o--o-o--o----o-o--B-oB--X----o-----------X----------------------o----B-------------------o-----------MB--------o-X---------o-B----X-X-----o---o--f
---------------o------------B---o-o---------o---o--B----------oo----------B---o-------oX---o-------B-------------X-------o----X--o---o---------o-----o----------o------------B--o-----------o-----oX-o-f
m-BB--------B------------o-----o-------o--X-X------oo-X---o---B----o-o-----o---B-o--------oB-X--------o------oE----B-o-o------B----o----E-o---------o-oB-B-----------B------------------------o-------BX
XXXXXXXXXXXXXXXXXXXXXXXXXXXXXXXXXXXXXXXXXXXXXXXXXXXXXXXXXXXXXXXXXXXXXXXXXXXXXXXXXXXXXXXXXXXXXXXXXXXXXXXXXXXXXXXXXXXXXXXXXXXXXXXXXXXXXXXXXXXXXXXXXXXXXXXXXXXXXXXXXXXXXXXXXXXXXXXXXXXXXXXXXXXXXXXXXXXXXXXX
