-----------B----------------------------------------------------XX-------------------------------------------B--------BMX-------------------------------------------------------------------------------
---------------------------------------------------------------------------------------------X-------------------------oX-XBBXB-----------X-BBBB----------------------------------------------------?---
-----------------------------------------------------------------------------?-----X-----------------B----B---XXX---BXB------------------XB--o?????X?----------------------------------------------X----
-----------------------------------------------------------------T------------B--------------------------T------------???---BBBBBBBTB-T----XXXXT--------------------------------------------------------
----------T-----------------------------------------------------X|-------------------------------------T-|----T----o---T----M--?---|--|--------|--------------------------------------------------------
----------|------------------------------------------------------|---------------X------------o-----B-X|-|----|XB--T---|----BBBBBo-|--|-X------|-----B------------------------------------------------B-
----------|------------------------------------------------------|------------------------------------X|-|----|X-XB|B-X|--X-MB-----|--|---BooX-|-XXXXXX----------------------------------------------X--
----------|------------------------------------------------------|------------------------XB------X---X|X|----|XXX-|-XX|BTBXB------|--|-B---XX-|-------------------------------------------------------v
----------|------------------------------------------------------|--------------------?---XX-o----XX-BX|X|??--|XXX-|XXX|-|-XXB----M|--|----XXX-|-------------------------------------------------------f
----------|------------------------------------------------------|------------------T-----XXX---M-XXX-X|X|X---|XXXX|XXX|X|-TXX-BBX-|o-|---XXXX-|-X-----------------------------------------------------f
----------|------------------------------------------------------|------------------|-----XXXX----XXXXX|X|XX-X|XXXX|XXX|X|B|XXX--T-|XB|--XXXXX-|-B-----------------------------------------------------f
----------|------------------------------------------------------|------------------|---X-XXXXX---XXXXX|X|XXXX|XTXX|XXX|X|X|XXXXT|-|XX|-XXXXXX-|-B--------------------------------------------o--------f
----------|------------------------------------------------------|------------M-----|-----XXXXXX--XXXXX|X|XXXX|X|XX|XXX|X|X|XXXX||-|XX|XXXXXXX-|B------------------------------------------------------f
----------|------------------------------------------------------|----------X-------|--X--XXXXXXX-XXXXX|X|XXXX|X|XX|XXX|X|T|XXXX||X|XX|XXXXXXX-|--X----------------------------------------------------f
m---------|-X----------------------------------------------------|-------------E----|--XX-XXXXXXXXXXXXX|X|XXXX|X|XX|XXX|X|||XXXX||X|XX|XXXXXXX-|---EX---------------------------------------------?----X
XXXXXXXXXX|XXXXXXX--------XXXXXXXXXX-XXXXXXXXXXXXXXXXXXXXXXXXXXXX|XXXXXXXXXXX-XXXXXX|XXXXXXXXXXXXXXXXXX|X|XXXX|X|XX|XXX|X|||XXXX||X|XX|XXXXXXX-|--X---XXXXXXXXXXXXXXXXXXXXXXXXXXXXXXXXXXXXXXXXXXXXXXXXXX
