----------------------o-------B---------------------------o--o---------X----------------?-----o----B--B-B---------------B---------------X--o------------B---------------o-----X-------------------------
--ooBo--------------B--------B---o----------------------o----BXo-------o--B----o-----------------B-o------B---o-B-B-------------------B-X------o-B-oB--------------o---B-------o----B-------------------
----------B----------X--------o-o---X----oo--------X--------B------------o--------X----X--o----oBo-----o----o-----o-Eo---------ooX------------X----------oo---B-------o----E-----B-oo------o---------o--
------------o--o-o-------X-----BoX---B----B---------oX--B--oXX---------------B---XB-X-----o---------B---o----------B--o------------------o------X-----?----B-o-X-X---------B----X------oBo--------------
-------------B-------------B-----------B-------o--------X-----------E----oB------------B--------------------------------X-B---------------o------o----------o-------o------------X--------B-o--------o-o
--------B-o----X----------o-------BB--o-------------------Bo--o-------oB------oo--o----------B-o----------------B--------X----o-B--B-B-X---B---X-------o-------B--o-------XB----B----o-o-B--------------
----------o--X---o--o--o-----------XXoX--------------o------o-o-X-----------B-------B---o--------------o----B---oX---------o------Bo---o------M---o---B-------------oo---------------B-o--------X---B---
---------B--------Bo------------------o-----------------o----B---B-BB----o-o-------o------B--------------------B------B-oo---------------X--------ooE------------o-o--o------------E-B--------B--o-----v
-----------X--------------oB--XB--BB------o-------------o---oo--B-------------E---------------B----o--------------------o-----------B-------------------------o---B------------X----o-o--B-----X-------f
------X--oB-----o-X-o-X---Bo--o------------------------o-------------oB------------X-------o---------------------o------B------------------o-E-------X--o-Xo-----------------o--B---------o-----B-B--o-f
----o--------o-B-----------B---------------o-o---o------------X-------o---------------------o---oo-E-----o-----o----oo------B-----X----E--B---o---B-----------o----o--------oX--------Bo--------B--o---f
----------------o----------B-B--------------------o------o----Bo-------o-----o---------B--------------o----oo----B--------X-----------------B-----B----------oo---ooo-------------B-----o------------o-f
--o--o---------o--X-----------B-----B-o---oX---M------------ooo---o--BB---B---B------------BX-o-----o--o---------------o---B-o--o--oo---------BB--------B---o------o-----------X--------------oo------of
--------------B-----B-----------o--o---oo--------------oo----B----o---------o-------o------------o-------B-XB-X-----o-----B------------o------o-----------------------o-----BB-Bo------o---o--------B-Ef
m----o---X------o------o--B----------M------------------o--E----B----E----B-B-X------B--o---o------B---------------B-----o--X----B----E------Bo-----o-Eo--X-----------------B----o---B------o---BoXo----
XXXXXXXXXXXXXXXXXXXXXXXXXXXXXXXXXXXXXXXXXXXXXXXXXXXXXXXXXXXXXXXXXXXXXXXXXXXXXXXXXXXXXXXXXXXXXXXXXXXXXXXXXXXXXXXXXXXXXXXXXXXXXXXXXXXXXXXXXXXXXXXXXXXXXXXXXXXXXXXXXXXXXXXXXXXXXXXXXXXXXXXXXXXXXXXXXXXXXXXX
