------------------------------------------------------------------------B--------------X--------------------------------------------------------------------------------------------------------o-------
-----------B---------------------------------------------------------------??--------------------------------------------------------------------------------------------------------------B------M-----
--------------------------------------------------------------------------------------------------------------------------------------------------------------------------------X-B---------------------
-------------------------------------------------------------------------------------------------------------------------------------------------------------------------------------????B--------------
------------------X--------------------------------------------------------------------B----------------------------------------------------------------------------------------------------------B---X-
-----------------XX----------------------------------------------o-----------------------------------------------------------------------------------------------------------M--------B-----X-----X-X---
----------XT----XXX------------------------------------------X-----------------------------------------------------------------------------------------------------------------------X-------------XX---
---------T-|---XXXX--------------------------------------------------------------------------------------------------------------------------------------------------------------------X----------XXX--v
-----B---|-|--XXXXX-----------------------------------------------------------X--B-----X-------------------------------------------------------------------------------------------X-------------XXXX--f
---------|-|-XXXXXX------------------------------------------------------X-------------------------------------------------------------------------------------------------------T-XX--T-X------XXXXXX-f
---------|-|XXXXXXX------------------------------------------------------XX------------------------------------------------------------------------------------------------------|-XXXX|-----B-XXXXXX--f
---------|-|XXXXXXX------------------------------------------------------XXX--B-----------------------------------------------------------------------------------X--------------|-XXXX|X----XXXXXXXX--f
---------|X|XXXXXXX-----------------------------------------------B---X--XXXX----------------------------------------------------------------------------------------------------|-XXXX|----XXXXXXXXX--f
---------|X|XXXXXXX------------------------------------------------------XXXXX---------------------------------------------------------------------------------------------------|-XXXX|X---XXXXXXXXX-Mf
m-------X|X|XXXXXXX--------------------------------------------------B---XXXXXXE-------------------------------------------------------------------------------------------------|-XXXX|XXEXXXXXXXXXXB-X
XXXXXXXXX|X|XXXXXXXXXXXXXXXXXXXXXXXXXXXXXXXXXXXXXXXXXXX------XXXXXXXXXXXXXXXXXXXBBBBBBBXXXXXXXXXXXXXXXXXXXXXXXXXXXXXXXXXXXXXXXXXXXXXXXXXXXXXXXXXXXXXXXXXXXXXXXXXXXXXXXXXXXXXXXXXX|-XXXX|XXXXXXXXXXXXXXXX
