----------------------------------X-----------------------------B-------------------------------------B-----------------------------------------------------------------B-------------------------------
--------------------------------------------------------------B---------------------------------------B--------------------o--Bo--------------------------------X-X-----------------o-------------------
------------------------------------------B----------------------------------------------------------------------X--B------------------B--------------------------------------------------------BBBBBBB-
---------------------------------X---B-X-----X---------------------------------------------------------------------B-B----BBB---------------------------------------------------------------------------
--------------------------------------------------M-------B-----BBBBBBB-------------------------------X-----------------------------------B-----------B-------------------------------------------------
-----------------------------X-X--------------------B----------------------------------------------------------------T----------X-----------------------------------------------------------------------
----------------------------------?-??B--------------X----------------B--------??------------------------------X-----|o--------B-X-----M-----------------------------------?--------------------------B-
-------------------------------------X-------------------------------------------------------------------------------|--------B----X-------------------------------------------------------------------v
------------------------------------XXT--X-------X---------------B------------------------X--------------o-----------|-------------X----------------------------------------------------M--------------f
------------------------------------MX|X--------BBB-----------------------------------T--XX--?-----------------------|---------------XX----------------------------------------------------------------f
------------------------------X----o-X|XXo---------X----------------------------------|-XXX---------------MB---------|---------------------------------------------------------------------------------f
----------------------------------?--X|XXX?----------X--------------------------------|XXXX----X---------------------|----X-----X------T--X------------------------------------------------------------f
---------------------------------T---X|XXXX---------------------B---------------------|XXXX----------------B-------X-|-----------------|---------------------------------------------------------------f
-----------------------------B---|---X|XTXXX-----X---XXXXXXX------------X-X--------B-X|XXXX--X-----------X-----------|----------------X|-----------------------------------------------BBBBBBB---------f
m-----------------------------?--|---X|X|XXXXE--------------------------------------XX|XXXX------------------B-------|-E---E----EE-----|-E-------------------E----------------E------------------------X
XXXXXXXXXXXXXXXXXXXXXXXXXXXXXXXXX|X--X|X|XXXXXXXXXXXXXXXX------XXXXXXXXXXXXXXXXXXXXXXX|XXXXXXXXBXXXXXXXXX------------|-XXXXXXXXXXXXXXX-|-----XXXXXXXXXXX----XXXXXXXXXXXXXXXXXXXXXXXXXXXXXXXXXXXXXXXXXXXX
