-----------------------------------------------------------------------------------------------------------------------------------------------------------------------------?????----------------------
--------------------------------------------------------------------------------------------------------------------------------------------o------------------------------X---------XX-----------------
-------------------------------------------------------------------------------------------------------------------------------------------------------------------------------------------------B------
-----------------------------------------------------------------------------------------------------------------------------------------------------------------XXXX----------------------B------------
---------------------------------------------------------------------------------------------------------------------------------------------------------------------------------------X-----?--B-------
-----------------------------------------------------------------------------------------------------------------------------------------------------------------------------------B--------------------
-------------------------------------------------------------------------------------------------------------------------------------------------------------------------------B-------T----------------
-------------------------------------------------------------------------------------------------------------------------?---------------------------------------------------------X---|-------o-------v
------------------------------------------------------------------------------------------------------------------------------------------------------------------------------X-------B|------------B-Xf
-------------------------------------------------------------------------------------------------------------------------------B-----------------------------------B----------XX-------|---------------f
----------------------------------------------------------------------------------------------------------------------------------------------------------------------------B-XXX------|--B-------T----f
------------------------------------------------------------------------------------------------------------------------------------------------------------------------------XXXXB----|-----B----|----f
-----------------------------------------------------------------------------------------------------------------------------------------------------------------------------XXXXXX-B--|--M-------|---Xf
-----------------------------------------------------------------------------------------------------------------------------------------------------------------X---------X--XXXXXX---|----------|--BXf
m--------------------------------------------------------------------------------------------------------------------------------------------------------------------------XX-XXXXXXX-E|-E-E---EBE|---XX
XXXXXXXXXXXXXXXXXXXXXXXXXXXXXXXXXXXXXXXXXXXXXXXXXXXXXXXXXXXXXXXXXXXXXXXXXXXXXXXXXXXXXXXXXXXXXXXXXXXXXXXXXXXXXXXXXXXXXXXXXXXXXXXXXXXXXXXXXXXXX-XXXXXXXXXXXXXXXXXXXXXXXXXXXXXXXXXXXXXXXX-|XXXXX---XX|XXXXX
