----------------------------------------------------B------------------------B-------------?X----B-------------------------------------------------------------o-------XXXXXX---------------------------
----------------------------------B-----------------------------------X-----------BBBBBBB-----------------?---------------BBBMBBBBBBBBB--------------------------B--B------X---X-----------------X------
-------------------------------------o---B-------X------------------------o---------------------------------------------------------------------------X----------------------------B-----------B--------
-----------------------------------------------????B??-------------------------------B?---------X----------X-------------X---------X---------------------------X-----?----------T---o----------------B--
----------------------------------------------B---------B----------------------------------X---------------------X--------------------------------------------------------------|------------X-oX-B-----
---------B-------------------------B----------?-o----------T---------T-----------X----------------X------T--------T---------B---------------------------------XB---M---------X-T|------XBXBBBB-XX-----X-
---------------------------------------B-------------------|---B-----|-----------XX-------------------T--|--------|-------------------------------B------T----XX-BB?XBBBB---XX-||-------X--?B?XXXB?---X-
-----------------------------------B----BBXBBB----X----X---|--B-----X|-----------XXX----------------B-|--|-----X--|----X-------o---------X-----------B--B|----XXX-------T--XXT-||-------XXX--XXXX-----Xv
------------------------------------------XX-B--------BXX--|-T-----B-|-----------XXXX----T----?-------|--|-----XXX|T??-XX-B--?------------------T-------B|B---XXXXXXXXX-|-XXX|-||-T--BXXTXX-XXXXX-----Xf
------------------------------------------XXXM------???XXX-|-|-------|B---?????--XXXXX---|---X--------|--|-----XXX||X--XXX----------------------|--------|----XXXXX--XXX|XXXX|X||X|BX---|XXXXXXXX-----Xf
-------------------------------------B----XXXX---------XXXX|-|-------|-----------XXXXXX--|---X--------|--|-----XXX||XX-XXXX???------------------|--------|-B--XXXXXXBXXX|XXXX|-||X|-o---|XXXXXXXX-----Xf
-------------------------------M----BoB--XXXXXX----T---XXXX|-|-------|---------X-XXXXXXX-|--XX--------|--|--B-XXXX||XXXXXXXX-------B---X--X-----|X-------|----XXXXXXXXXX|XXXX|-||X|-B--X|XXXXXXXX-----Xf
----------------------------------------XXXXXXXX---|--XXXXX|X|------X|--------XX-XXXXXXXX|-XXX-------X|--|---XXXXX||XXXXXXXXX-B-------XX------T-|--------|----XXXXXXXXXX|XXXX|X||X|-----|XXXXXXXX-----Xf
---------------------------------------XXXXXXXXXX--|---XXXX|X|-----XX|-??????XXX-XXXXXXXX|XXXX--------|--|--XXXXXX||XXXXXXXXXX---X---XXX--T---|-|--------|----XXXXXXXXXX|XXXX|X||X|----X|XXXXXXXX-T---Xf
m-------------------------------------XXXXXXXXXXXX-|---XXXX|X|X---XXX|E-----XXXX-XXXXXXXX|XXXXE-----EX|o-|-XXXXXXX||XXXXXXXXXXX-----XXXX--|---|E|E--E----|--X-XXXXXXXXXX|XXXX|X||X|---XX|XXXXXXXX-|--XXX
XXXXXXXXXXXXXXXXXXXXXXXXXXXXXXXXXXXX-XXXXXXXXXXXXXX|XXXXXXX|X|XXXXXXX|-----XXXXXXXXXXXXXX|XXXXXXXX--XX|--|XXXXXXXX||XXXXXXXXXXXX-XXXXXXX-X|---|X|XXXXXXXX|X-XXXXXXXXXXXX|XXXX|X||X|--XXX|XXXXXXXXX|-XXXX
