---------------------------X-----------------------------------------------------------------------------------------o-------X---B----------o-----------------------------X-----------------------------
--------------------------------????????--------------------------------------------------------------------------------------------------M--X----------------------------------o-----------------------
------------------------------------------------------------------------------------------------------------------------------------B-----------------------------------------------------------------X-
----------------------------------------------------------------------------------------------------------------------------------------T--------------X?--------------B-B---------X---BBBBBoBB-----M---
-------------B-----------------------------------------------------------------------------------------------------------------X-----BX-|---------B-----------o---------------B--B----------------------
-------------------------------------------------------------------------------------------------------------------------------------XX-|------------------------------------------------------X--------
-------X------------------B------------------------------------------------------------------------------------------------------X--XXX-|-------------------------BBBB----X-X-----------------XX------X-
-------------------------------BT---B----------------B------------------------------------------------------------X--------------XXXXXX-|--------T------------T---B-------XXX----------------XXX-------v
--------------------------------|----------------------------------------------------------------------------------B------------TXXXXXX-|--------|-------X----|--X--------XXX-----T---------XXXX-------f
--------------------------X-----|-----------------------------------------------------------------------------------------T-----|XXXXXX-|----T--X|----------o-|----------XXXXX----|------??XXXXX-------f
----------------------X------X--|----------------------------------------------------------------------------------------B|---??|XXXXXX-|----|-XX|------------|---------XXXXXXX---|-X-----XXXXXX-------f
-----------------XX------------B|--------------------------------XXXXXXXX----------------------------------------------X--|----X|XXXXXX-|---X|XXX|---------B--|----B---XXXXXXXXX--|-----XXXXXXXX-------f
--------------------------------|---X-------------------------------------------------------------------------------------|---XX|XXXXXXX|--XX|XXX|-------X----|-----?-XXXXXXXXXXX-|----XXXXXXXXX-B-XM--f
--------------------------------|-----------------------------------------------------------------------------------------|--XXX|XXXXXXX|-XXX|XXX|-----o------|-B----XXXXXXXXXXXXX|X--XXTXXXXXXX-------f
m---------------------------E---|-------E-------------------------------------------------------------M-----E----------BE-|-XXXX|XXXXXXX|XXXX|XXX|---E--------|--E--XXXXXXXXXXXXXX|EEXXX|XXXXXXX-------X
XXXXXXXXXXXXXXXXXXXXXXXXX----XXX|XXXXXXXXXXXXXXXXXXXXXXXXXXXXXXXXXXXXXXXXXXXXXXXXXXXXXXXXXXXXXXXXXXBXXXXXXXXXXXXXXXXXXXXXX|XXXXX|XXXXXXX|XXXX|XXX|XXXXXXXXXXXX|XXXXXXXXXXXXXXXXXXX|XXXXX|XXXXXXXB----XXX
