-----BBBB--------------------------------------------------------------------------------------------------------------------------------------------------------------------X------X-----X-------------
------------------------------------------------------------------------------------------------------------------------------------------------------------------------------B---oo?----BB-X-------X-B-
-------------------------------------------------------------------------------------------------------------------------------------------------------------------------oo---X--X--B-------B---M----X--
-----------------------------------------------------------------------------------------------------------------------------------------------------------------------------B-XX--X----------B---------
------------------------------------------------------------------------------------------------------------------------------------------------------------------------------B----XX-----B-BX---T------
--------------------------------------------------------------------------------------------------------------------------------------------------------------------------B------X---B--???M?T--o|------
-To---------------------------------------------------------------------------------------------------------------------------------------------------------------------X-B--------o--X------|M--|---XX-
-|------------------------------------------------------------------------------------------------------------------------------------------------------------------B---XX----?--X----B--B-M-|---|-M---v
-|-------------------------------------------------------------------------????-----------------------------------------------------------------------------------T-----XXX--X---M----?-X----|---|----Xf
-|----------------------------------------------------------------------------------------------------------------------------------------------------------------|----XXXXXT-B----X----XXX--|---|---TXf
-|----------------------------------------------------------------------------------------------------------------------------------------------------------------|-----XXXX|BX----BB-XTXXX--|---|B-X|Xf
-|---o------------------------------------------------------------------------------------------------------------------------------------------------------------|-----XXTX|X--------X|XXXX-|o--|-TX|Xf
-|----------------------------------------------------------------------------------------------------------------------------------------------------------------|-----XX|X|XXB----o-X|XXXXX|BM-|X|X|Xf
-|-------------------------------------------------------------------------------------X--------------------------------------------------------------------------|-B---XX|X|XXX---B--X|XXXXX|-T-|X|X|Xf
m|-E-----------------------------------------------------------------------------------XX-------------------------------------------------------------------------|---BXXX|X|XXXX--B-EX|XXXXX|X|X|X|X|XX
X|XXXXXXXXXXXXXXXXXXXXXXXXXXXXXXXXXXXXXXXXXXXXXXXXXXXXXXXXXXXXXXXXXXXXXXXXXXXXXXXXXXXXXXXXXXXXXXXXXXXXXXXXXXXXXXXXXXXXXXXXXXXXXXXXXXXXXXXXXXXXXXXXXXXXXXXXXXXXXXXX|XXXXXXX|X|XXXXX--X-X|XXXXX|X|X|X|X|XX
