-----------------------------o----B-o------------------------?--------X-----------o--X------------------------X-o--o-B--------------------------------------------B---------B--B---------Bo-------------
----------B-------------------o------B------o------B----o----B----------X------o-------oo---X-------B---------------o-----------B-------B--------------X--------o--X--------BB---------B----------X--B--
o---------------o--X---B--------------X-oBo---------------B-----------------B----------B---B-o--------------oB----B?------------X--X---------------------oo---B-o--o------------------------o---B-------
o-B----------------o--X------X--X----o----B-o----------B---B--o------X--o-o---------o-o--X----------o---o--o----B-------XB--X-------------------X-X------------o----X-o-B---o------B---XB--------oo----o
------------------oo---Bo--B----------E?---oB--o------------oX----B-----------B---------B--------o-o--B-XX--o---o------------------o---B----o---------ooo-o------------------------------X--o----------o
------------Bo-------X-----B---------o----Xo--B------------------------------------------E---o-----o-B--------oBo-----------------BB-------B-o---o----o-----B-o-oX--Bo---B-oo--B-o---------B----------o-
------oB--------X--------B-o-------X----B-----B--o----------B--Bo-----BBE-----B------------Bo---------oo-X--o---B---B--------------------B-----B------B---------B-----o--------------B--------------X---
---B--B-------o--------B------------------o-B-----o------------o----------X-----------B-----B--E-------------oo---------o---------o--B-----o----o-------o----------------Xo-X------B-----B--B----------v
B-----------------------o---o-----------o--XBB---B--B---EB--------B-----XX-------X----------o-o-X----------------------o--------X---o-----o------------------o------o--o---X---oXo-------o-o-o-------B-f
-----------B--------o-o---------------X-o----o-o---------------o--------------Xo-X---------o-X----o--B------------------o------B----o-B----------o--oB-----X-----o---------------o-B-------B-----------f
---------o-----------------o-B-X---B---------?--oB---------------------X---B--o------o---------oX----------------------o--------------B---o-------o------------o-o---------------o------X-------o------f
--B--Xo--------B--E------o--B----------------B----o--B-----oX------B----oX---X-o---o------oBB------o-----oBB-------o--------?------B------------B----------------------------o---------o---------o-BB-Bf
o-o-----o--------------------------B--oo----B-X-B--B-----X-----------o------------------B--------B---------------------o--B---------o-------B-------E------E----XB----X------------E--o--X---------oB-?f
----o--Bo-------EX---BB-------------X-----Xo------------o--o-------------o--------B--o-------------o----o----------------X----o----X-------o-----E----------X---oX---B----X--------B-------------X-----f
mo-------o--BB--E--E-oo--E-E-BBo-E-------------o-E-o----oEE--------oo--o-X--E------BB-----------------------o--Bo---B-------oEX--M-B--B-B-X-E---E---Eo--X-----E-Bo----EB----------o-XX-o--------XoBE----
XXXXXXXXXXXXXXXXXXXXXXXXXXXXXXXXXXXXXXXXXXXXXXXXXXXXXXXXXXXXXXXXXXXXXXXXXXXXXXXXXXXXXXXXXXXXXXXXXXXXXXXXXXXXXXXXXXXXXXXXXXXXXXXXXXXXXXXXXXXXXXXXXXXXXXXXXXXXXXXXXXXXXXXXXXXXXXXXXXXXXXXXXXXXXXXXXXXXXXXX
