--------------------------------------------------------------------------------------------------------------------X--------------------------------------------BX------X-XXXXXoXo-XXXXXXXXXXX--B------
---------------------------------------------------------------------------------------------------------------------------------------------------------------------------B------?--X------???B??X?-BB-
-------------------------------------------------------------------------------------------------------------------------------------B------------------------------------?------------------X----------
-------------------------------------------------------------------------------------------------------------------------B----BB-----------------------T------------------B--XXXXXXX---X------X---B-----
---------------------------------------------------------------------------------------------------------------------------------X----------T----------|-------------X-----BB-------BBBBoBTM-????X??B---
--------------------------------------------------------------------------------------------------------------------------------XX--XXXXTXX-|------B---|------X-----XX------------BBBBBX-X|--------X----
------------------------------------------------------------------------------------------------------------------------B----X-XXX-B---B|---|---B------|-----XX----XXXB--B-------X-----XX-|-T--T--XXT---
--o-------------------------------------------------------------------------------------------------------------------o------XXXXX------|---|-------o--|----XXX---XXXX--------------XT-XXX|-|--|----|--v
-----------------------------------------------------------------------------------------------------------------------------XXXXX------|---|----------|---XXXX??XXXXX-----------o--X|-XXX|-|--|----|-Xf
-----------------------------------------------------------------------------------------------------------------------B----XXXXXT------|--X|----------|--XXXXX-XXXXXX--B------XT-XTX|XXXX|X|X-|-X-B|-Xf
-------------------------------------------------------------------------------------------------------------------------X-XXXXXX|-X----|---|----------|-XXXXXXXXXXXXX--B------X|o-|X|XXXX|X|?X|XX--|-Xf
--------------------------------------------------------------------------------------------------------------------------XXXXXXX|X---BX|BBB|B---------|XXXXXXXXXXXXXX---XXXXXBX|X-|X|XXXX|X|XX|XX--|-Xf
---T---------------------------------------------------------------------------------------------------------------------XXXXXXXX|XX----|---|---B------|XXXXXXXXXXXXXX---------X|XX|X|XXXX|X|XX|XX--|-Xf
---|--------------------------------------------------------------------------------------------------------------------XXXXXXXXX|XXX---|---|-M-----?-X|XXXXXXXXXXXXXX---------X|XX|X|XTXX|X|XX|XX--|-Xf
m--|------------------------------------------------------------------------------------------------------------------EXXXXXXXXXX|XXXX--|---|-E-E-?--XX|XXXXXXXXXXXXXX---------X|XX|X|X|XX|X|XX|XXX-|-XX
XXX|XXXXXXXXXXXXXXXXXXXXXXXXXXXXXXXXXXXXXXXXXXXXXXXXXXXXXXXXXXXXXXXXXXXXXXXXXXXXXXXXXXXXXXXXXXXXXXXXXXXXXXXXXXXXXXXXXXXXXXXXXXXXX|XXXXX-|--X|XXXX--XXXX|XXXXXXXXXXXXXX----XXXX-X|XX|X|X|XX|X|XX|XXXX|-XX
