--------------XXXX----?---------------------------------------------------------------------------------------------------------------------------------------------------------------------------------
-----------------------------------------------------------------------------------------------------------------------------------------------------------------------------------------------------BB-
-----????-----------------------------------------------------------------------------------------------------------------BBB---------------------------------------------------------------------------
--------------------------------------------------------------------------------------------------------------------------------------------------------------------------------------BBBBBB------------
-------------------------------------------------------------------------------------------------------------------------------------------------------------------------------------XXX--------X-------
------------??------------------------------------------------------------------------------------------------------------------------------------------------------------------------------------------
--------------------------------------------------------------------------------------------------------------------------------------------------------------------------------------------------------
-----------o-------------------------------------------------------------------------------------------------------------------------------------------------------------------------------?-----------v
-------------------------------------------------------------------------------------------------------------------------------------------------------------------------------------------------------f
------X??---X------------------------------------------------------------------------------------------------------------------------------------------------------------------------------------------f
-----XX-----XX------------------------------------------------------------------------------------------------------------BBBBB-------------------------------------------------------XXX--------------f
----XXX-----XXX-----------?????------------------------------------------------------------------------------------------------------------------------------------------------------------------------f
---XXXX-----XXXX----------------------------------------------------------------------------------------------------????-------------------------------------------------------------------------------f
--XXXXX-----XXXXX-----------X-------------------------------------------------------------------------------??????---------------------------------------------------------------------------------????f
mXXXXXX-----XXXXXX----------XX------------------------------------------------------------BBBB-------------------------------------------------------------------------------X-------E---------------E-X
XXXXXXX--XXXXXXXXXXXXXXXXXXXXXXXXXXXXXXXXXXXXXXXXXXXXXXXXXXXXXXXXXXXXXXXXXXXXXXXXXXXXXXXXXXXXXXXXXXXXXXXXXXXXXXXXXXXXXXXXXXXXXXXXXXXXXXXXXXXXXXXXXXXXXXXXXXXXXXXXXXXXX---XXXXXXXXXXXXXXXXXXXXXXXXXXXXXXX
