-------------------------------------------------------------------------------------------------------------------------------------X-----------XX-XBB------X-B---------B---------------X--------------
------------------X------------------------------------------------------------------------------------------------------------------------BX-------X------?--B------------X---X------------------------
---------------------------------------------------------------------------------------------------------------------------------------------------B------------------------------o---------------------
---------------------------------------------------------------------------------------------------------------------------------------------------T--B-------X----o-----------X---------------B--------
----------------------------------------------------------------------------------------------------------------------------------------BX---------|--oX------------------------X------X-----?--B-----X-
-----------------------X------------------------------------------------------------------------------------------------------------------B--------|---X--------------------------------X------------XX-
------------------X-------------------------------------------------------------------------------------------------------------------------B--XBBB|BXoBXX-o---oM----T---------B--------------------XXX-
--------------------------------------------------------------------------------------------------------------------------------------M------------|-X---T-----------|---T---X----?----o--o------?-XXXXv
-----------------------------------------------------------------------------------------------------------------------------B-------------X---T---|-----|X----------|---|--XX-------------------oXXXXXf
------------------------------------------------------------------------------------------------------------------------------------X--------?X|-T-|-T---|-X--X----B-|---|-XTX-------B-X------B--XXXXXXf
-----------------------------------------------------------------------------------------------------------------------------------BXX---X---XX|-|-|X|XX-|-----------|---|XX|X------------------XXTXXXXf
--------------------------------------------------------------------------------------------------------------------------------------------XXX|-|-|-|--X|-----------|---|XX|X-X---------------XXX|XXXXf
--------------------------------------------------------------------------------------------------------------------------------X----------XXXX|-|-|B|-X-|--B--To----|--X|XX|X------B------X--XXXX|XXXXf
---------------------------------------------------------------------------------------------------------------------------o----XX--------XXXXX|-|-|M|-XX|-----|-X---|-XX|XX|X--XX-------BBBBXXXXX|XXXXf
mM---B--------E----B------------------------------------------------------------------------------------------------------------XXX-B----XXXXXX|-|X|X|-XX|-----|-----|XXX|XX|X--------E----EXXXXXX|XXXXX
XXX------XXXXXXXXXXXXXXXXXXXXXXXXXXXXXXXXXXXXXXXXXXXXXXXXXXXXXXXXXXXXXXXXXXXXXXXXXXXXXXXXXXXXXXXXXXXXXXXXXXXXXXXXXXXXXXXXXXXXXXXXXXXXXXBXXXXXXX|-|X|X|-XX|XXXXX|XX-XX|XXX|XX|XXo-Xo--X--B--XXXXXXX|XXXXX
