---------------------------------------------------------------------------------------------------------------------------------------------------------------------------------------XXXXXXXX---------
-------------------------------------------------------------------------------------------------------------------------------------------------------------B------------------------------------------
-----------------------------------------------------------------------------------------------------------------------------------------------------------B-----?-----------------X--------------------
-----------X-------------------------------------------------------------------------------------------------------------------------------------------X----------------BB---X--------------------------
----------------------------------------------------------------------------------------------------------------------------------------------------------------T--------B---------X--------------------
----------------------------------------------------------------------------------------------------------------------------------------------------------------|-??-----------M--X-------o-----o-------
----------------------------------------------------------------------------------------------------------------------------------------------------------------|-----------X-----XX--------------------
------------------------------------------------------------------------------------------------------------------------------------------------------T-------X-|---------?-------XXX------------------v
------------------------------------------------------------------------------------------------------------------------------------------------------|--------B|-----------------XXXX--------?-------Xf
------------------------------------------------------------------------------------------------------------------------------------------------------|---------|-----------------XXXXX-------T-------Xf
------------------------------------------------------------------------------------------------------------------------------------------------B-----|---B-----|-----------M-----XXXXXX------|-X-----Xf
------------------------------------------------------------------------------------------------------------------------------------------------------|---------|--X--------------XXXXXXX----B|BBBBBBXXf
-----------------------------------------------------------------------------------------------------------------------------------------------------X|-????????|---------------X-XXXXXXXX----|-----XXXf
------------------------------------------------------------------------------------------------------------------------------------------------------|T--------|-------B---X-----XXXXXXXXX---|----XXXXf
mX-----------------------------------------------------------------------------------------------o----------------------------------------------------||--------|------EM--E?E--E-XXXXXXXXXX--|---XXXXXX
XXXXXXXXoXXXXXXXXXXXXXXXXXXXXXXXXXXXXXXXXXXXXXXXXXXXXXXXXXXXXXXXXXXXXXXXXXXXXXXXXXXXXXXXXXXXXXXXXXXXXXXXXXXXXXXXXXXXXXXXXXXXXXXXXXXXXXXXXXXXXXXXXXXXXX||XXXXXXXX|XX---XXXXXXXXX---XXXXXXXXXXX-|--XXXXXXX
