-----------------B---------B-BBB-------o---------BBBBBB----------------M------------------------------B--------------B-M------------------------------------------------B-X-----------------------------
-------------------o-B---------------------B-------------------B--------------------------------------B------------------------o-----------------B--------------------------X---------------------------
--------------X-----------------------------------------------------------------------------------------------------B-XX-------o----------------------------------------------X-------------------------
----------------?????----------------B-X-----X----o-----------------------------------------------------B--X-X---TBBXB---------------------------B---------oX----------------------------------------B--
-------------------------------?----BXXXXXXX------M-------B-----XBXBBBB---------------------------------X--------|------------------------B------------M-----------B----------------------X-------------
--M-------------------------------------X----------X--T----------XX------------------------------------X-B---o--X|----------------Bo----------------X-XXXX?XX-----------?-TT----------------------------
---------------------------B------------------X-------|-B-------XXX-T-B--------??-------------------?B--------B--|o----------------------X-------X---B------X-------------||-------------------X--------
-----------------------X-------------X------X---------|--------XXXX-|---------------T---------------------X----X-|-----B-------X---X-----XX-----XX--X-----X---------------||----B--------------XXB-----v
--------------X---X----XX-----------BXT-BX-XXB--?B----|--T----XXXXX-|-----------X---|--------------------o---Xo--|BBBXBBBT----XX---------XXX---XXX------------------------||-----------------T-XXT-----f
--------------XX----XX-XXX-----------X|X--XXX-B-BBB---|--|---XXXXXX-|---X------XX---|--------?----BX-------------|--X----|---XXX-----X---XXXX-XXXX------------------------||--X--BBB---------|-XT|X---Xf
--------------XXX------TXXX---X------X|XXXXXX------X--|--|--XXXXXXX-|---------XXX---|--------------XX------B-----|-------|--XXXX---------XXXXXXXXX------------------------||-XX--------------|-X||XX-XXf
--XXXXXXXX----XXXX--???|XXTX-------X-X|XXXXXX--X------|--|-XXXXXXXX-|----X-X-XXXX---|----------X---XXXX-------X--|-----B-|-XXXXX---------XXXXXXXXX------------------------||XXX--------X-----|-X||XXX-Xf
---XX---------XXXXX----|XX|XX-----XX-X|XXXXXTX-XX---X-|--|XXXXXXXXX-|--XXXXXXXXXXXXX|XX------------XXXX-------XXX|-X--XXX|XXXXXX----o----XXXXXXXXX------------------oB----||XXX--------------|-X||XTXXXf
---XXX--------XXXXXX-X-|XX|XXX---XXXXX|XTXXX|XXXXX----|--|XXXXXXXXX-|--XXXXXXXXXX--B|------------X-XXXXX-X-B--XXX|-------|XXXXXX------X--XXXXXXXXX-------------------?----||XXX---------BBBBB|-X||X|XXXf
m--XXXX-E-----XXXXXXX-E|XX|XXXX-XXXXXX|X|XXX|XXXXXX-B-|-X|XXXXXXXXX-|-XXXXXXXXXXX---|--E---------X-XXXXXXEXX--XXX|--E---X|XXXXXXE-------EXXXXXXXXX-----------XXX---E--E--X||XXXE----M-------E|-X||X|XXXX
XX-XXXXX-XXXXXXXXXXXXXX|XX|XXXXXXXXXXX|X|XXX|XXXXXXX--|XX|XXXXXXXXXX|XXXXXXXXXXXXXXX|XXXXXXXXXXXXXXXXXXXXXXX--XXX|XXXX-XX|XXXXXX--------XXXXXXXXXXXXXXX-XXXXXXXXXXXXXXXXXX||XXXX--XXXXXXXXXXX|XX||X|XXXX
