---------------------------o----------------------------------X------------o-------B-----------o------------B------------------------------B--B---BB---------o-----------o-----B------------------o-----
---Bo---o--------------B-B----X---------X-------------------X--------o----------X-----o-B----o----o-----------------o--o------B---X-Xo--------o-------o---o--------B--------------B-B-X-o--o-X--o-------
--B----X----------------------------o---o-o----------B-----X-----o------B-o------X-o-B--oB----X----o-----------o--------------X-oo-X--o----------------XX--------B-----o-------------Bo-B------o--o---B-
--B------B------------B-o-o-?o----------B----B--------------------B-------?---B-----------X--------------o----o---------------o---------------------------------Bo-o-B--------------------o---------o---
-B----------Bo------B-----Xo--oo-------------o-----B-------------B-----B-o------o---B-o--X---Bo---o------B---B--B---o-------------B------o-B--------o-----o----B--o-----X-------B-E--------B---------o--
----BX-----------E--------B-----o---------B---B--Bo-----------B--B---o---B-------------X-----------o------o---B----------X--B--------------------B-------o-o--o-o---oX------B----B--o---oB----o---B---B-
------------o--B-----------X---------B---------X------o-B-o-------o-----------Bo-----oo--------o--o----o-o------------o-----X--B-----B------oo----Bo----B--------o--------o----B-------------BB---------
-----o----------------o-B-------------B------oo------------------o-X-----X----------o-------------X-B--B-o--------o-----oo--------B--o--o---o--o-o---o------o---o---X--------------B------------------ov
-------------B-------o-----------o-------o----o-----------o---------------oX--o----------o-oX---------B-o-------o----------o-B-X-----------------B--B---o-X------------------------o-----Bo-----o---ooof
-------------------XB----B-----------------X-----BoBB--E-------------------o-----X----o--------------X----------o-------------------o-o---------o--BX--oo-----------o-o-----------------------oX--o--o-f
-------X-o---o---------------B----B----o-------------B--oo--------------BB---------------B-----------B--B-----o--B------o---oo--------------------o--X-----------------B-B----------------o----o-o-----f
-o----------------X---B--------X-----B--o---------------X-oo--B-------o--oo--oX------X----------------o-----B-------------o--------X----------B----E-------------------B-XX-B------X-------E-----------f
-B---------X--------o----o-o------B-B---B-o---------oB----o---o--------------B------B--B------------B---B-----o---X--------------X------------B---B-------------o---------B----------------------Bo----f
--------o---o-----------o---------X---Xo------o------o-B---------XE----------B-oX--------B---X----o---o-----------oo-o--------------------------o---o--X------------E----o-o--B--X----oB-------------B-f
m---------------oE---------E----B--------------o----B--E------oE----------o----------------------o-X--o--X-BX----Xo----X-o---EB----B--o------------B-o------------oX---B-----o-B------------oo--------B-
XXXXXXXXXXXXXXXXXXXXXXXXXXXXXXXXXXXXXXXXXXXXXXXXXXXXXXXXXXXXXXXXXXXXXXXXXXXXXXXXXXXXXXXXXXXXXXXXXXXXXXXXXXXXXXXXXXXXXXXXXXXXXXXXXXXXXXXXXXXXXXXXXXXXXXXXXXXXXXXXXXXXXXXXXXXXXXXXXXXXXXXXXXXXXXXXXXXXXXXX
