--------------------------------------------------------------------------------------------------------------------------------------------------------------------------------------------------------
--------------------------------------------------------------------------------------------------------------------------------------------------------------------------------------------------------
--------------------------------------------------------------------------------------------------------------------------------------------------------------------------------------------------------
------------B--X----------------------------------------------------------------------------------------------------------------------------------------------------------------------------------------
--------------------------------------------------------------------------------------------------------------------------------------------------------------------------------------------------------
--------------------B-----------------------------------------------------------------------------------------------------------------------------------------------------------------------------------
-----------------B---o-----------------------------------------------------------------------------------------------------------------------------------------------------------X----------------------
-------------------------------------------------------------------------------------------------------------------------------------------------------XXXXXXXX---------B-----------M-------M----------v
--o-------------------------------------------------------------------------------------------------------------------------------------------------------------------------------------------B--------f
--------XXXXXX--B---------B----------------------------------------------------------------------------------------------------------------------------------------------------------------------------f
------------o--------------------------------------------------------------------------------------------------------------------------------------------------------------------------B-o-------------f
-------------------------------------------------------------------------------------------------------------------------------------------------------------------------------------------------------f
--o----------------T--------------------------------------------------------------------------------------------------------------------------------------------------------------------------------T--f
--------------T--B-|----------------------------------------------------------------------------------------------------------------------------------------------------------X--------o------------|--f
m------E--E---|----|------------------------------E----------------------------------------------------------------------------------------------------------------E-------------X-----X-----E------|o-X
XXXXXXXXXXXXXX|XXXX|XXXXXXXXXXXXXXXXXXXXXXXXXXXXXXXXXXXXXXXXXXXXXXXXXXXXXXXXXXXXXXXXXXXXXXXXXXXXXXXXXXXXXXXXXXXXXXXXXXXXXXXXXXXXXXXXXXXXXXXXXXXXXXXXXXXXXXXXXXXXXXXXXXXXXXXXXXXXXXXXXXXXXXoXXXXXXXXX|XXX
