----------------------------------------------------------------------------------------------------------------------------------------------------------------X---M-------------B----------------X----
----------------------------------------------------------------------------------------------------------------------------------------------------------------B--------?--------------------B--X------
---------------------------------------------------------------------------------------------------------------------------------------------------------------------------B----------???--BBBB---------
------------------------------------------X--------------------------------------------------------------------------------------------------------------------------X-?------X---o--X------------------
---------------------------------T---------------------------------------------------------------------------------------------------------------------------------X------------------B--T----------X-B-
---------------------------------|--------B----------------------------------------------------------------------------------------------------------------X------XX------X-T--M---------|------X--M--B-
---------------------------------|-------------------------------------------------------------------------------------------------------------------------------XXXB-------|------------|-------BBX----
-------------B--------M----------|--------------------------------------------------------------------------------------------------------------------X---------XXXX--------|---------X-B|-------------v
---------o-----------------------|------------------------------------------------------------------------------------------------------------------XXXXXXX----XXXXX--------|--o---------|-------------f
---------------------------------|T-------------------------------------------------------------------------------------------------------------------XXX-----XXXXXX-----XX-|------BBB---|-------------f
---------------------------------||---------B---------------------------------------------------------------------------------------------------------XXXX---XXXXXXX--------|------B-----|-------------f
---------------------------------||-------------------------------------------------------------------------------------------------------------------XXXXX-XXXXXXXXo---X--B|---------X--|---------B--Mf
-----------B----------B----------||-------------------???????-----------------------------------------------------------------------------------------XXXXXXXXXXXXXX--------|------------|B------------f
---------------------------------||-------------------------------------------------------------------------------------------------------------X-----XXXXXXXXXXXXXX--------|B-----------|-----B-------f
m-E---X--------------------------||-----------------B-------------------------------------------------------------------------------------------------XXXXXXXXXXXXXX--E----E|---E??????BB|---E--------EX
XXXXXXXXXXXXXXXXXXXXXXXXXXXXXXXXX||XXXXXXXXXXXXXXXXXXXXXXXXXXXXXXXXXXXXXXXXXXXXXXXXXXXXXXXXXXXXXXXXXXXXXXXXXXXXXXXXXXXXXXXXXXXXXXXXXXXXXXXXXXXXXXXXXXXXXXXXXXXXXXXXXXoXXXXXX|X-----------|---XXXXXXXXXXX
