----------------------------BBB--------------------------------------------------------X-------------------X-Xo---B--?-B???X------oX?oXXBooB-XXXXXX--X-------------------------------------B------------
----------------------------------------------------------------------------------------X--------B-----o---M----------X---X--B----B-B---BBB-B-X-----B-------------------------------------------X-------
---------------------------------------------------------------------------------------------------------------X---XB--B--???----B--XB-M-B--X-B---X----------------------------------------------?------
------------------------------------------------------------------------------------------------B---B-BX--------BT-XX-B-X-TX-B-T-ooBo-BBBB-------o-?????????--------------------------X--X--------------
-------------------?-----------------------------------------------------------------------------X-XB------TB---B|--Xo-BXB|XBBX|X---B-XX-T--X-----T--o--------------------------------------------M-----
-------------------o----------------------------------------------------------M----T----XXX-------XX-------|--XXX|-XX--BXB|-B--|XXTXTXTo-|-MM-----|--XX--------------------------------------------X----
-----------------------------------------------------------------------------------|-----XXX----MXXXB------|-X-X-|XXX-X---|XB-B|XX|-|T|-X|-XT---XT|?XXX?-X----------------------------------------XX----
-----------------------------------------------------------------------------------|----XXXXX-B-XXXX-----XB|----B|XXXX--B-|----|XX|-|||BB|X-|BBBX||XXXXXXX---------------------------------M-----XXX---v
---T-------------------------------------------B------------------------------M---?|????-TXXXX-XXXXX--X---B|----X|XXXXX-T-|XTXB|XX|X|||BT|-B|---X||XXXXXXX--------------------------------------XXXX---f
---|-------------------------------------------------------------------------------|----X|XXXXXXXXXXXXBBBBX|-XXXX|XXXXTX|T|X|XX|XX|X|||-||-T|-BXX||XXXXXXX---------------------------------T---XXXXX---f
---|-------------------------------------------------------------------------------|X--XX|XXXXXXXXXXTXT--XX|B-XTX|XXXX|X|||X|XX|XX|X|||X||X||BXXX||XXXXXXX---------------------------------|--XXXXXXX--f
---|------------------------------------------------B-----------------------B------|-----|XXXXXXXXXX|X|XXXX|XXX|X|XXXX|X|||X|XX|XX|X|||-||T||XTXX||XXXXXXX---------------------------------|-XXXXXXXXX-f
---|------------T-----------------------------------------------------T------------|---BB|XXTXXXXXXX|X|XXXX|XXX|X|XXXX|X|||X|XX|XX|X|||X|||||X|XX||XXTXXXX---------------------------------|XXXXXXXXXXXf
---|------------|-----------------------------------------------------|------------|-----|XX|XXXXXXX|X|XXXX|XXX|X|XXTX|X|||X|XX|XX|X|||X|||||X|XX||XX|XXXX---------------------------------|XXXXXXTXXXXf
m--|------------|-----------------------------------------------------|------X-----|B--E-|XX|XXXXXXX|X|XXXX|XXX|X|XX|X|X|||X|XX|XX|X|||X|||||X|XX||XX|XXXXX-------------------------------X|XXXXXX|XXXXX
XXX|XXXXXXXXXXXX|XXXXXXXXXXXXXXXXXXXXXXXXXXXXXXXXXXXXXXXXXXXXX----X---|XXXXXXXXXXXX|B---X|XX|XXXXXXX|X|XXXX|XXX|X|XX|X|X|||X|XX|XX|X|||X|||||X|XX||XX|XXXXXXXXXXXXXXXXXXXXXXXXXXXXXXXXXXoXX|XXXXXX|XXXXX
