--------------------------------------------------------------------------------------------------------------------------------------------------------------------------------------------------------
----------------------------------------------------------------------------------XXXXX-----------------------------------------------------------------------------------------------------------------
-----------------------------------------------------------------------?-----------------------------------------------------------------------------o--------------------------------------------------
--------------------------------------------------------------------------------------------------------------------------------------------------------------------------------------------------------
-------------------------------------------------------------------------------------------XXXXX--------------------------------------------------------------------------------------------------------
----------------------------------------------------------------------------????---------------M--------------------------------------------------------------------------------------------------B-----
--------------------------------------------------------------------------------------------------------------------------------------------------------------XXXXX-------------------------------------
----------------------------------------------------------------------XXXXXX-------------------------------------BBBBBB-?BBBBBBB-----------------------------------------------o-----------------------v
-----------------o-------------------------------------------------------------------------------------------------------------------------------------------------------------------------------------f
------------------------------------------------------------------------------------------------------B--------------BBBBB------------------------------------------------------o----------------------f
-----------------------------X----------------------------------------------------------------------------------------------------------------------------------------------------------X--------------f
----------------------------XX------------------------------------------------------------------------------T----------------------------------------------------------------------T----XX-------------f
---------------------------XXX------------------------------------------------------------------------------|----------------------------------------------------------------------|----XXX---BBBBBBBB-f
--------------------------XXXX------------------------------------------------------------------------------|----------------------------------------------------------------------|----XXXX---------T-f
m------------------------XXXXX--------------------------------------------------????------------------------|-------------------------------------E-------------------E------------|----XXXXX--------|-X
XXXXXXXXXXXXXXXXXXXXXXXXXXXXXXXXXXXXXXXXXXXXXXXXXXXXXXXXXXXXXXXXXXXXXXXXXX-XXXXXXXXXXXXXXXXXXXXXXXXXXXXXXXXX|XXXXXXXXXXXXXXXXXXXXXXXXXXXXXXXXXXXXXXXXXXXXXXXXXXXXXXXXXXXXXXXXXXXXXX|XXXXXXXXXXXXXXXXX|XX
