------B---o--B-------------X--B--o-Xo----o--------------o---------B--B----X--------------B-----o----X-B----X---B----o--o-----o-BX----BBX--o----B-------------o---------------o-------------B-----------B
---o-----------o------o-B------ooo--oB----o-X---------oB---BB-----------------------o---oXoo-----oB-X-------o--o-----oooX-------B-oo------o------o--------o--o---o-------o-B-B-----------o--o--B--------
--------------o---------B---X--B-o-----B---o-o----oo---o--------------------o--o-----------B-B-------X-o----o-----B--B-o-------------X--B-BoB----Boo------oB--------o----B--------E--o-ooo-X----o----o--
------X---------------o--B-B-----------o-------X-oB--B--XX-B------X-----o-----------------EB----o-----X----o--o-o-X-B--oo----B-o--o--o-----------B------o-o-----------B-B--T-B-BB--o--o----BX--o-o--E-B-
o------X-o--------------------o-------------oo--------o--------X------B-B-X--?---B-------o-X-------------B----------oB---X-----o--------B-B----------o---------------------|-oE---o-------o--o-o-o--X---
--XoXB----------oBT-X------o--o-o---o----XBo--o----B----BXB----o---o------------E---------X------------B----------B-----BB--B------------o----------B-B-X---o---Bo---o-----|--ooX-B------T----X-------X-
-------B-o-T------|---B------o------B------------o--------------B-----E--B-Xo?------------o-----B---oo------o-----B----o--o--o--B-B--BB----------------------E--B--B-------|-----B--oB---|---X--------E-
o---Bo-----|-o----|------B------------X--B-----B----o------X--------------------------o-------X------oo------B----------------BXo-----------X--B-----------X-B-----oooX----|-----B--o--o-|-------------v
-----Bo--o-|-X----|--T----o---B-o----B--------BBB----o--------B-----T--------X------B?o---X--X-----------------------oX-----B--------Bo----B-B-----B--------------o--------|----X-X---o--|--------X--B-f
-o-o-------|-oo---|--|----o-------oo-BB-----B--EXo---B---Bo---Bo----|--o----------oo---------o-----T--B-----------o?o---X-----o--o--ooB-------B-BX-------o--B--Xo---ooB--o-|-B--B-----B--|---------o---f
-o--B------|------|-B|-------------o--o----Bo-----o-o--oo-B---------|----o--oX-oB------------------|--oB---X---o------X--o---B--X-----o----X------------B--X----X---X------|----oB-------|------o---o--f
---------Bo|------|--|--------ET--X----o---o-----X-----X--o----o-B--|--oo-------------o------o-o---|-o------o--------------oo-o---B-----X---B------o--X--E-o-----o--o--XX--|----------T--|--oo---------f
o-----B----|-oo---|--|--o-E----|-------o-o--------B----------------B|---------o------o------o--oX--|---o-----------B-----o----o-----o---B------BB-------------B------------|-o-B-----o|--|-------------f
X----------|------|--|--o------|-o---------o-o--------B-------o--X--|-oo-?-------------o------o-o-?|--B---o---------------B---o-------------------E-X--B-o-------------B---|-----o--X-|--|----B-B------f
m-B--B-----|------|--|----X----|-E----E--------o---E---o------E-----|--oooB----E--o-B-X--EoB---E---|---E----X-o------oB---o---X-------oo-E--B-B---B--o----------o---oE-----|---E------|--|-----oB------o
XXXXXXXXXXXXXXXXXXXXXXXXXXXXXXXXXXXXXXXXXXXXXXXXXXXXXXXXXXXXXXXXXXXXXXXXXXXXXXXXXXXXXXXXXXXXXXXXXXXXXXXXXXXXXXXXXXXXXXXXXXXXXXXXXXXXXXXXXXXXXXXXXXXXXXXXXXXXXXXXXXXXXXXXXXXXXXXXXXXXXXXXXXXXXXXXXXXXXXXX
