--------------------------------------------------------------------------------------------------------------------------------------------------------------------------------------------------------
-----------------------------------------BBBBBB---------------------------------------------------------------------------------------------------------------------------------------------------------
--------------------------------------------------------------------------------------------------------------------------------------------------------------------------------------------------------
--------------------------------------------------------------------------------------------------------------------------------------------------------------------------------------------------------
---------------------------------------------------X------T---------------------------------------------------------------------------------------------------------------------------------------------
--------------------------------------------------XX------|---------------------------------------------------------------------------------------------------------------------------------------------
-------------------------------------------------XXX------|---------------------------------------------------------------------------------------------------------------------------------------------
------------------------------------------------XXXX------|--------------------------------------------------------------------------------------------------------------------------------------------v
-----------------------------------------------XXXXX------|--------------------------------------------------------------------------------------------------------------------------------------------f
----------------------------------------------XXXXXX------|---------------------------------------o----------------------------------------------------------------------------------------------------f
-------XXXX----------------------------------XXXXXXX------|--------------------------------------------------------------------------------------------------------------------------------------------f
--------------------------------------------XXXXXXXX------|------------------o----------M--------------------------------------------BBBBBBB-----------------------------------------------------------f
-------------------------------------------XXXXXXXXX------|---------------------------------------------------------------------------------------------------------X----------------------------------f
------------------------------------------XXXXXXXXXX------|--------------------------------------------------------------------------------------------------------------------------------------------f
m----------------------------------------XXXXXXXXXXX------|----------------------------------------------------E---------------------------------------------------------------------------------------X
XXXXXXXXXXXXXXXXXXXXXXXXXXXXXXXXXXXXXXXXXXXXXXXXXXXXXXXXX-|------XXXXXXXXXXXXXXXXXXXXXXXXXXXXXXXXXXXXXXXXXXXXXXXXXXXXXXXXXXXXXXXXXXXXXXXXXXXXXXXXXXXXXXXXXXXX--------XXXXXXXXXXXXXXXXX-------XXXXXXXXXXX
