--------o----o--o-o--------X-----o-----X------o-------B--o--------B---X------B--------------oo------Xoo----X-------------------BX------Xo-o-----B------------o------o---o-----o-------------B-------o--B
-------------B-o-----------------oXo-B--------o------o---B-o-------o-------X----X-------B-X---o-o-----B-o--Bo-Bo----oo---o------B--o----o-o------B----------B-o---BBo------B-BoE-B---X---o--o-o---------
------B-BB-o----o-----------------------------o-------o--------oo-B--BX--------o-----------o----------Bo---------o---B-----------o---X-----XBX-o------E-------o---o--B---M---X------B?-Bo---o--oo-------
---------BE---o-B---------------------Xo-------o-B---------B---BB------X--------o---o---o-o-o---ooo--BBoB--o-----------o----EB----------o-----o--BB-------o---------------oTB--B--oo--B------o---oB-----
o------X-----B-X-X--------X----X-------X----BoB--B-----XX-------------o------o---B-o-------X---------o---------o-------B-X-----o-----------------B-B-----------------------|--B----------o-o--B-o-----o-
-o---------------BT-X---oo-----o-B-------X--X------B----B---o--o---oo-------------o-o-o---Xo-o---Xo-------------E----E-oB---B--B----------o--------B-o-------X-------o----B|---o---o---B-T--B-X---------
-----Bo--B-T------|----------o-----------------B----Bo----B-B-X----------B--Xo------------X-----------oB----B-----------o----X---X---B------B-----B--B---oXBX---------BB---|----o-X------|-o----o-----X-
o----o-----|------|--B--B-B-----------o-------B----X------o-X-----Bo-----o-------------o---------B-----ooo---B-B--o--X--B-----o--o-o------------B-B----o---X--------o---oB-|-------BoB---|------------ov
---o---Bo--|---o--|-oT------B----o--------BB--o-B--o--B--B---o---o--T-------oX-B--o-------------X----o-X-------------------------o--B--------B------------------------o----|-o---------X-|-------------f
---o-Bo-B--|----o-|--|-----------o---o----X--o-B-oo---------o-----o-|-Bo-----------o-----------o--BTo-B--B-X----o---o---------o-o---o-------B--oB----------------oB------o-|-B-----------|--------o-o--f
-oo--o-----|-----B|--|-----------------B---------BB--o--B-B--E-B----|--o-o--------o---o---B-o--X-o-|-oo-o---o---oB-------X-------o---------XBX-o----E------oX-o--------o-X-|---B---------|------o------f
-------B--o|------|--|---o-----T-----B-------o------B-oBB-----BB--o-|------------EB---o----B------B|------o---o---------------oo---B--oXo---------------o-BB-----o---------|-----o----T--|-----E-------f
o----------|--o-o-|--|--o-E----|-------o----oo-B----o-o-------------|-o----B---XE--o-oB-----o-B----|---ooBo-o--B---oo-?o-o----o-----------X---B-B---------XoB-X-------o----|-----o---o|--|---B----o----f
X--------B-|------|--|-------B-|-o---XB---Xo-o---EX---B------------B|-ooB-B--E--E-----E------------|--BB---B-X----o-E---------o---Bo---o------o-o----oo---o--------oo---oo-|-----o----|--|----o--------f
m-E-oB----o|------|--|------o--|-E------B------o-------o----X-E-E-o-|--o--B--B---XX-B-Bo-----------|---------Eo--------B---o---------oE-o-E-------o---------B---oo--oE-E-B-|---E-ooo-o|--|--------o-B---
XXXXXXXXXXXXXXXXXXXXXXXXXXXXXXXXXXXXXXXXXXXXXXXXXXXXXXXXXXXXXXXXXXXXXXXXXXXXXXXXXXXXXXXXXXXXXXXXXXXXXXXXXXXXXXXXXXXXXXXXXXXXXXXXXXXXXXXXXXXXXXXXXXXXXXXXXXXXXXXXXXXXXXXXXXXXXXXXXXXXXXXXXXXXXXXXXXXXXXXX
