X---o------B--B----ooo----------BBB--------------X--o--------------Boo-o--X-----Xoo-o------X--X-----B-----?------B-----B---o---B-------------B----------------------------XBBB-----o--------T----o-X-XX-
------o--o--o--o----o---XB-------B------o-o---X--------------Xo--o---X------Bo---------o--B----o------------o---------oBo--B-o----o-X--------o-B-------X--------------Bo-----B-o-----o-o----|-------o---
--B-----E-o---------BoB-X---X-----B-------B----o--------------------X------o---o-XXo--B------BX--X------B-X--------o--o------------------B-------o-X-----o----------oB---Xo--B-----o---XB-X-|------o-o--
X----oBo--X-------------o-----B-------X---oo--------------B---------------B--XB--------------------------------X--------o----E--------B----------------B----B---B----X--o-------Bo----------|-oB--------
----o----o-oB----------o----------o-----------------------------------------o-------------Bo------o-Bo-------------o-------B----------o---B----o-B------oBXo--------o-----X-------o----B--oB|--o-------E
-T------o-------Bo---E---------oB--------------o------o----o-------B-------------o-B-------B--------------X------B--B--o---------oo---X--B----B-o--o-------B-o------B-----oX------X---------|---T-------
B|------B--B-----o---Bo------o---X--X---------o--o---------------oB--------B---B-----o---------X-----X--o-X-B-----B--------B-B----X--o---X---B--B----Bo-o-------oBB----------------oo--o----|---|-------
-|----------B----------BXo------X---BX-------XBoo-----X-------B------------X-----B---o-----o-----o-----------Xo---------B-o-------Boo--------o-B---oBo-B--o-o--o---X---o---------o--B-------|---|------v
B|------o----T-B---B------oo--X-----o------o---o------o----X-B----------B-----B-o--B-----o-------o------o---o---o--o----------X----oo-oo--X-----------B-o-----------Bo-B---------o---B------|---|-B----f
-|--BXo-oo---|--X-----B-B---------------X----X---B--B------o-B---BB-------------------------B--B--o---------B--o-----X-----------o------o--------B--X-o-------------o-------B----B---o-----X|-o-|------f
o|----X------|------B-X--oo-o----------X-----B----------B-----XB--X---oB-Xo----B-B------B--EXX--------oE----------------------------E-----oX-oBo--o---X--oX-------o---------o---------------|---|------f
-|-B---o-----|----X-----X---B---B---------------------B---B-o-Bo--o-X---B-----------o-E---oB-o--------o---B---B----X-----Bo----o---B--o-B-------o----B---o----------X-------------o-o--X-X--|---|--o---f
-|--o--X--Xo-|-o-------X------E--o---------------BB--------X--------oX--B---B-B-B-X---o--o---E----o--X-o------T---B----X-------BX-o--o-o------------o--------------B---------------B----E-B-|--B|---o--f
-|-oX-------o|---B-------o-----BB--oX-oX-------X---------------o----o--X----o--B---------------B------oX---Bo-|----oB----EB----o---T-----Xo--------B--X---------o---o--------------o-o-B---B|---|------f
m|----B---X--|--E---E--o--B-B--------B-X------Bo--o-----Eoo----o-X-o---BB-----ooE---o-------B-o---------X---E-|-o-------MBoo---X---|-B------------E-------B-o----o--E-----B-E------oE---EBoo|---|-------
XXXXXXXXXXXXXXXXXXXXXXXXXXXXXXXXXXXXXXXXXXXXXXXXXXXXXXXXXXXXXXXXXXXXXXXXXXXXXXXXXXXXXXXXXXXXXXXXXXXXXXXXXXXXXXXXXXXXXXXXXXXXXXXXXXXXXXXXXXXXXXXXXXXXXXXXXXXXXXXXXXXXXXXXXXXXXXXXXXXXXXXXXXXXXXXXXXXXXXXX
