--------------------------------------------------------------------------------------------------------------------------------------------------------------------------------------------------------
----------------------------------------------------------------------------------------------------------------------------------X---------------------------------------------------------------------
-X----------------------------------------------------------------------------------------------------B-------------------------------------------------------------------------------------------------
-------------------------------------------------------------------------------------------------------------------------------------------XXXXXXX------------------------------------------------------
-----------------------------------------------------------------------------------------------------------------------B-------------------------------------X------------------------------------------
--------------------------------------------------------------------------------------------------------------------------------------------------------------------------------------------------------
------------X-------------------------------------------------------------------------------------------------------------------------------------------------------------------------------------------
------?--------------------------------------------------------------------------o-----------B----------------------------------------------------------------------------------------------------X----v
-------------------------------------------------------------------------------------------------------------------------------------------------------------------------------------------------------f
--X---------------X------------------------------------------------------------------------M-----------------------------------------------------------------------------------------------------------f
--XX-------------XX-----------------------------------------------------------------------B------------------------------------------------------------------------------------------------------------f
--XXX-----o-----XXX----------------------------------------------------------------------T---------------------------------------------------------------------------------------BBBBB-----------------f
--XXXX---------XXXX----------------------------------------------------------------------|---------------T--------------------------------X------------------------------------------------------------f
--XXXXX-------XXXXX---------------------------------------------------------------X------|---------------|----------------------------------------------------------o----------X---------o-------------f
m-XXXXXX-----XXXXXX----------------------------------------------------------------------|---------------|--------E--X--------------------------------------------------------------------------E------X
XXXXXXXXXXXXXXXXXXXXXXXXXXXXXXXXXXXXXXXXXXXXXXXXXXXXXXXXXXXXXXXXXXXXXXXXXXXXXXXXXXXXXXXXX|XXXXXXXXXXXXXXX|XXXXXXXXXXXXXXXXXXXXXXXXXXXXXXXXXXXXXXXXXXXXXXXXXXXXXXXXXXXXXXXXXXXXXXXXXXXXXXXXXBXXXXXXXXXXXX
