--------------------------------------------------------------------------------------------------------------------------------------------------------------------------------------------------------
------------------------------------------------------------------------------------------------------------------------------------------------------------------------------------B-------------------
----------------------------------------------------------------------------------------------------------------------------------------------------------------------------M---------------------------
--------------------------------------------------------------------------------------------------------------------------------------------------------------------X--------------X----X---------------
--------------------------------------------------------------------------------------------------------------------------------------------------------------------------------------------------------
----X------------------------------------------------------------------------------------------------------------------------------------------------------------------------------------------------X--
----XX-----------------------------------------------------------------------------------------------------------------------------------------------------------------------------M---------------X----
----XXX-------------------------------------------------------------------------------------------------------------------------------------------------------------------------------------------XX---v
----XXXX-----------------------------------------------------------------------------------------------------------------------------------------------------------------------------------------XXX---f
----XXXXX----------------------------------------------------------------------------------------------------------------------------------------------------------------------X----------------XXXX---f
----XXXXXX--------------------------------------------------------------------------------------------------------------------------------------------------------B----------------------------XXXXX---f
----XXXXXXX-------------------------------------------------------------------------------------------------------------------------------------------------------------------B---------------XXXXXX---f
----XXXXXXXX---------------------------------------------------------------------------------------------------------------------------------------------------------------------------------XXXXXXX---f
----XXXXXXXXX-----------------------------------------------------------------------------------------------------------------------------------------------------T--------------------X----XXXXXXXX---f
m---XXXXXXXXXX----------------------------------------------------------------------------------------------------------------------------------------------------|------------------------XXXXXXXXX---X
XXXXXXXXXXXXXXXXXXXXXMXXXXXXXXXXXXXXXXXXXXXXXXXXXXXXXXXXXXXXXXXXXXXXXXXXXXXXXXXXXXXXXXXXXXXXXXXXXXXXXXXXXXXXXXXXXXXXXXXXXXXXXXXXXXXXXXXXXXXXXXXXXXXXXXXXXXXXXXXXXX|-----------------------XXXXXXXXXXXXXX
