--------------------------------------------------------------------------------------------------------------------------------------------------------------------------------------------------------
------??????-------------------------------------------------------------------------------------------------------------------------------------------------------------------X--XB---X----------------
---------------------------------------------------------------------------------------------------------------------------------------------------------------------------------------------XXXXX------
--------o----------------------------------------------------------------------------------------------------------------------------------------------------------------------o------------------------
----------------------------------------------------------------------------------------------------------------------------------------------------B---------------------------------------------------
--------------------------------------------------------------------------------------------------------------------------------------------------------------------------------------------------------
--------------------------------------------------------------------------------------------------------------------------------------------------------------------------------------------------------
-------------------------------------------------------------------------------------------------------------------------------------------------------------------------------------------------B-----v
------------------X----------------------------------------------------------------------------------------------------------------------X---------------------B---------------------------------------f
-----------------XX------------------------------------------------------------------------------------------------------------------------------------------------------------------------------------f
----------------XXX------------------------------------------------------------------------------------------------------------------------------------------------------------------------------------f
-T--T----------XXXX------------------------------------------------------------------------------------------------------------------------------------------------------------------------------------f
-|--|---------XXXXX------------------------------------------------------------------------------------------------------------------------------------------------------------------------------------f
-|--|--------XXXXXX------------------------------------------------------------------------------------------------------------------------------------------------------------------------------------f
m|--|-------XXXXXXX---------------------------------------------------------------------------------------------------------------------------------------------------------X--------------------------X
X|XX|X---XXXXXXXXXXXXXXXXXXXXXXXXXXXXXXXXXXXXXXXXXXXXXXXXXXXXXXXXXXXXXXXXXXXXXXXXXXXXXXXXXXXXXXXXXXXXXXXXXXXXXXXXXXXXXXXXXXXXXXXXXXXXXXXXXXXXXXXXXXXXXXXXXXXXXXXXXXXXXX-XXX-XX-XXXXXXXXXXXXXXXXXXXXXXXXX
