-X----------X--o-o-B--------o-----o--------o---X-o-------XB------------------o-o-X--X-X---oo-----X---------B---oo-X---o-oo--o--X---------o--oBo-E-----------o-o-----o-----B------------oB--B--------BT-X
-o----B--------X--------X--------------------Bo--o----B----oo--o----o-------o-Xo----------B----oX--BB---o---o-o-----X--XB---E-------X----Bo---o-X---o-E---oB-Xo-o---o-BB--o-----X----X----B---X------|--
-----------B----------------BEB------oB---------------------XB-o---o---------------------BX---------o----X------X-o-X-------?X--o---o--BB--o-----B----B-o-------------X----o-----X---o---------------|--
-B----------B--X--o----------B--------------o----------o----------B----o---X-------B------------o---B------o--o----------------------B--?---o--o----------------------Bo------------oo-o-------o-----|--
--------B--------o-X---X-----------o------o-o-EB--------o---oB--------X--Bo-B--oBXX-----B------X------B---------oo----------o-Bo-B-------------B--B----o--T---o----o---------o----------o---o--------|--
----o----o-----o---B--X----o-X---B---oB----X--X----BE---X-------B---o-----X--------o----o--o--------------o--BoX-o-----X-----------B---------------o-o-T--|----o--B--------------o------------------o|--
B------X-------------X-o---X------Bo--------o-Xo-oo-Bo---B--------------------o---o-B---B-----B------B----B------B-oXo-------o---Bo--o-------X--XB-----|-B|--X--B-X------------X-B-B------B--------o-|--
--------o-----o-oo-----------o-----------o-----oB--o------o------B-------o---oB---B--o--------B----o-o----o-B------X---------B-oo-------Bo--T----B----B|--|---o----o----B---o----B---oBo----o-------o|-v
--B------------ooE---o-----o--B--BB---o-oB--B--B-X-----------oB-o-o-----------------X---oBo-o-B---------------X----------o-------o-----?--X-|------o--B|-o|-B-----B-----T------------oo---oB----E----|-f
--XB-----E-------Xo----T-T--B------oB--B--X-oo--------X-B----BB-------o----X----X---o---B-B--o----Xo-------X-------Bo---o-------B---E---o-E-|------o---|--|---------Bo--|----------o--B--o------B----|-f
---B-----X--------X----|-|----o----oo--Bo-----X-----o-----Bo-------o-----B-----T--B-X-E------------o----o-B-X----B--------------o-B-B-----B-|--o------B|--|-o---BB-B-o-B|---------o--B-BB------------|-f
-XoX--B--B--B----------|-|---------------B-----------B-------------------------|-?----X-o-oBB-B----X------------------------o-o-------------|--BB---X--|--|--ooX-----o--|-----B----------------------|-f
---o-o----------E-X----|-|------B---------------B-X-----XB-------------------B-|--B----------B----oo-----B-o-----o-----o-----o-----o---o--o-|----oo-BB-|--|--o------X---|--o-----------BB-B-B--o--o--|-f
------o----?X---BX-oB--|-|----o--------------o----o----------o-----oo--Xo--o-o-|----------Bo-X------o--oX-----o---B-----B----B-o--o-------X-|-oB-o-----|--|--B------o---|---B-X----B-X---X-----------|-f
mX-o----E----------X--X|-|-oE----EB------Bo-----------B-------------------E--E-|-------o-------o-----oBE--Bo-o--Xo------B-o---------B-----o-|-Xo--o--X-|--|-------BoB---|---------oBB--o--oX-------E-|-X
XXXXXXXXXXXXXXXXXXXXXXXXXXXXXXXXXXXXXXXXXXXXXXXXXXXXXXXXXXXXXXXXXXXXXXXXXXXXXXXXXXXXXXXXXXXXXXXXXXXXXXXXXXXXXXXXXXXXXXXXXXXXXXXXXXXXXXXXXXXXXXXXXXXXXXXXXXXXXXXXXXXXXXXXXXXXXXXXXXXXXXXXXXXXXXXXXXXXXXXX
