-----------------------------------------------------------------------------o-----------------------o-------------------------------------X----------------------X--------------------B----------------
-----------------------------o--------------------X------B-----------------B-------------XB-----o--------------o----XoB----------B--------------o----------B---B-------------?------------------oo--Xo--
--------X----------B------o-----------o-----o---o----B--------------o-------------o-----o-------o-----------------o-----------oo-----------B-----------------------------EoB-------oo-----------X-------
---------o---------X---o--------X--------Xo------------B-------B-X-----o--------------oB---------------Xo---------oo---------X---------------------B----------XB-------o---o--------o--o--------o--o---B
----------Bo----------------------------B--o--Bo------X--------------X----o-----------------o------------------------o---X-----------------o-----------X-------------------------------------B----------
-X----o---------------------------------------B-B----------o-----------o---------------------ooX-----------o----Xo-----------B---------o--------------o--Bo------------X--o--------o----------------o---
----------------o---X-----B---------------------o-B-o--o-B---------------o---------------B-----------X---o--o-------X---o------o-----------o------o-E---------------------------B----------X--o---------
--------B-----------o-------o-------------X-B-------------------------oo--------o--------------------X-----------o-----o---X------Xo-----------------------o--o-----------X-o-----o-----o--------------v
---------B-----------------------o---------------------o--------------------------------------------o---Bo------------o-B-----o----------------Xo---o--o------Bo--B-----------B-----------------------of
--o-B----------X--o-o-------B---o--Xo-------------------------o--------B------------o------B---------------------o---oo------B-----------o--B----------------o-------------o-----o-------B----------o--f
---------XB-----o--B-o-o----------------------------B----------------------B------o----------X------o-----o---oo----------B--------X---------------------------------o------------------o-------------of
--------------------B-----B--X----o--o----------B----B-------------------------o----B----------------------------o-------o-------------------------X---B----o--o--B----o---B-o-----o----X--------------f
----o-o-------o------B---------------X----------Bo-----B---o--------B----------------o--o-----------o------------B---------------o-------B-------------o------?---------o----o---B-------o-X--------o--f
-------o---------------------------------o----------------X----------X-------B-o----B-o--oE----------------o---B------------------o----------o--------o--------o---oo-o--------------o-------B-------B-f
m-----o-----o----------o-----o---o----------------X--B---------o--oX------oo-o------------o---o------B-----------o--o-------B-B--------------B-----B-o--o--------o----------B-o------X------B--EoX-----X
XXXXXXXXXXXXXXXXXXXXXXXXXXXXXXXXXXXXXXXXXXXXXXXXXXXXXXXXXXXXXXXXXXXXXXXXXXXXXXXXXXXXXXXXXXXXXXXXXXXXXXXXXXXXXXXXXXXXXXXXXXXXXXXXXXXXXXXXXXXXXXXXXXXXXXXXXXXXXXXXXXXXXXXXXXXXXXXXXXXXXXXXXXXXXXXXXXXXXXXX
