--------------------o-----------------------------------------------------------------------------------------------------------------------------------------------------------------------------------
----------------------M---------------------------------------------------------------------------------------------------------------------------------------------------------------------------------
--------------------------------------------------------B----------------------------------------------------------B------------------------------------------------------------------------------------
--------------------------------------------------------------------------------------------------------------------------------------------------------------------------------------------------------
--------------------------------------------------------------------------------------------------------------------------------------------------------------------------------------------------------
-----------------------BBBB-----------------------------------------------------------------------------------------------------------------------------------------------------------------------------
-----------------------------------------------------------------------------------------------------M--------------------------------------------------------------------------------------------------
-------------------------------------------------------------------------------------------------------------------------------------------------------------------------------------------------------v
---------------------------------------------------------------------------------------------------------------------------X---------------------------------------------------------------------------f
--------------------------------------------------------------------------------------------------------------------------XX---------------------------------------------------------------------------f
-------------------------------------------------------------------------------------------------------------------------XXX---------------------------------------------------------------------------f
----------------------------------------------------------------------------------------?????---------------------------XXXX---------------------------------------------------------------------------f
------------------------------------------------------------------X----------------------------------------------------XXXXX---------------------------------------------------------------------------f
-----------------------------------------------------------------XX---------------------------------------------------XXXXXX---------------------------------------------------------------------------f
m-----------------------------------?---------------------------XXX--------------------------------------------------XXXXXXX--------------------------------------------E------------------------------X
XXXXX----XXXXXXXXXXXXXXXXXXXXXXXXXXXXXXXXXXXXXXXXXXXXXXXXXXXXXXXXXXXXX--------XXXXXXXXXXXXXXXXXXXXXXXXXXXXXXXXXXXXX-XXXXXXXXXXXXXXXXXXXXXXXXXXXXXXXXXXXXXXXXXXXXXXXXXXXXXXXXXXXXXXXXXXXXXXXXXXXXXXXXXXXX
