-------------------------------------------------BBBBBBBB-----o------B-o-----------M---------Mo----o------M----XoXXXX-------o----------B---o------------------------------------------------------------
-------------------------------------------------------------------------o-----------o---------------?-------XXX----o-----------------------------------------------------------------------------------
---------M---------------------------------------------X-----------??-BXXXXXXoX------M-----------o------?XoBBBBB------M---------------------------------------------------------------------X-----------
-----------------------BBB--------------------M------------X----------M?BTTBBBB----------------B--B------T--?--T-------o-T??T?????--????????------------------------------------------------------------
------------------------?------------?-----------------------oB-?-M---o--||X----T--??o????????-T-XoTo--TT|-B---|-T-oX---X|--|---------------------------------------------------------------------------
------------------------------------------------------M----------X--o-MX-||T----|-o-M-X--X----B|M--|-X-|||TT---|X|-XX-XXX|--|---------------------------------------------------------------------------
----------------------------------------X------?-------X--T-B-------T-MXX|||----|-BX-TXX--T----|o-T|BXX|||||X-X|X|XXXXXXX|-?|-----------o---------------------------------------------------------------
---T------------------------------------XX---------XXM-XT-|---T-?---|--XX|||To--|XXX-|XXXB|----|-X||XXT|||||XX-|X|XXXXXXX|-X|--------------------------------B-----------------------------------------v
---|------------------------------------XXX------XXX---X|X|--X|-----|--XX||||ToB|XXX-|XXXX|--X-|XX||TX||||||XXX|X|XXXXXXX|XX|---BBXXBBB-------------------------------------------------------------X--f
---|------------------------------------XXXX-----------X|X|--X|-----|-XXX|||||-X|XXXX|XXXX|-XX-|XX|||X||||||XXX|X|XXXTXXX|XX|----XXX---------------------------------------------------------------XX--f
---|-----------------------------------XXXXXX--M-------X|X|XXX|-BBBB|XXXX|||||XX|XXTX|XXXX|XXXX|TX|||X||||||TXX|X|XXX|XXX|XX|---XXXX--------------------------------------------------------------XXX--f
---|----------------------------------X-XXXXXX-T--B----X|X|XXX|-X---|XXXX|||||XX|XX|X|XXXX|XXXX||T|||X|||||||XX|X|XXX|XXX|XT|-TXXXXX-------------------------------------------------------------XXXX--f
---|---------------------------------XXXXXXXXXX|-------T|X|XXX|XXXXX|XXXX|||||XX|XX|X|XXXX|XXTX||||||X|||||||XT|X|XXX|XXX|X||-|XXXXX------------------------------------------------------------XXXXX--f
--T|----------------------------------XXXXXXXXX|-------||X|TXX|XX-XX|XXXX|||||TX|XX|X|XXXX|XX|X||||||X|||||||X||X|XXX|XXX|X||X|XXXXX--o--------------------------BBBBBBBB----------------------XXXXXX--f
mE||----------------------------------XXXXXXXXX|X--X--X||X||XX|XXXXX|XXXX||||||X|XX|X|XXXX|XX|X||||||X|||||||X||X|XXX|XXX|X||X|XXXXX---------BBBB---------------------E-----------------------XXXXXXX--X
XX||XXXXXXXXXXXXXXXXXXXXXXXXXXXXXXXXXXXXXXXXXXX|XX-XXXX||X||XX|XXXXX|XXXX||||||X|XX|X|XXXX|XX|X||||||X|||||||X||X|XXX|XXX|X||X|XXXXX---XXXXXXXXXXXXXXXXXXXXXXXXXXXXXXXXXXXXXXXXXXXXXXXXXXXXXXXXXXXXXXXXX
