----????-----------XX-----------------------------------------------------------------------------------------------------------------------------------------------------------------------------------
-BBB----------------------------------------------------------------------------------------------------------------------------------------------------------------------------------------------------
--------------------------------------------------------------------------------------------------------------------------------------------------------------------------------------------------------
--------------------------------------------------------------------------------------------------------------------------------------------------------------------------------------------------------
----???----------------------------------------------------------------------------------------------------------------------------------------------------o----------------------BBBBBB----------------
--------------------------------------------------------------------------------------------------------------------------------------------------------------------------------------------------------
------B-------------------------------------------------------------------------------------------------------------------------------------------------------------------------------------------------
------------------o-----------------BBBBB--------------------------------------------------------------------------------------------------------------BBBBBBB-----------------------------------------v
-BBBB--------------------------------------------------------------------------------------------------------------------------------------------------------------------------------------------------f
-------------------------------X---------------------------------------------------------------------------------------------------------------------------------------------XXXXXX--------------------f
-------XXXXX------------------XX-----------------------------------------------------------------------------------------------------------------------------------------????--------------------------f
-----------------------------XXX---------------------------------------------------------------------------------------------------------------------T-------------------------------------------------f
-------------------------XXXXXXX---------------------------------------------------------------------------------------------------------------------|------------------------------------------T------f
------------------------?--XXXXX-----------------------------------------------------------------------------------------------------------------X---|------------------------------------------|------f
m-------------XXXXXX------XXXXXX-------------------------------------------------------------------------------------------------E---------------XX--|------------------------------------------|------X
XXXXXXXXXXXXXXXXXXXXXXX--XXXXXXXXXXXXXXXXXXXXXXXXXXXXXXXXXXXXXXXXXXXXXXXXXXXXXXXXXXXXXXXXXXXXXXXXXXXXXXXXXXXXXXXXXXXXXXXXXXXXXXXXXXXXXXXXXXXXXXXXXXXX|XXXXXXXXXXXXXXXXXXXXXXXXXXXXXXXXXXXXXXXXXX|XXXXXXX
