-----------------------------B-B--BBBBXXXXX-----------------------------------------------------------B--------------B------------B--------B--------------------B-------B-B------------------B----------
------------------------M----------o------XXXXX----------XB-------o-------o---------------------------B--------------------o---o------B------------oXX---------B-o-o--------X--X------------------------
--------------X----------------------B------------------------------------------------------------------------------B--B-------o-------B---X---Bo-----B---------B---o--B------B-----X-------------------
-------------------------------------B-X-----------B------T---------B---X------X-----o------------------B---------BB-B---------B----B----B-M-X-----???X-B---X-----X-B-BM--o--T-----XX----------------B--
---------------------B---------?------------------B-------|-------------------T----------B---------T----X-B-XBBBBBBB----------B--B-o-X----Bo---X------BM---T----X--T---X--o--|-------------X---------B--
--M----------------------------------X--------------T-----|-?-----------------|-----------------B--|---X-X-----M-----T---B--T-----Bo-------X----X-T--XXXTX?|X------|X-------X|XXXXX-B-------------------
----------------------?----B-------------M----------|-----|-------------------|??--T---------------|-------X---X--o--|------|--B-B--XB-M-X-------X|--B--|X-|X----B-|-------?T|---X------o-----T-X-----o-
--------------------------------------------X--M----|-?---|-------------------|B---|---------------|-----------------|-----X|-B----XXX---XTB----XX|-XB--|-X|X------|Bo---XM-||-----T?---X----B|-------Xv
------------------------B----------------X--------X-|-----|o---T---------X----|-X--|------X--------|---------Xo------|-B--XX|--?B--XXXX--X|X---XXX|-----|XX|XX-----|X---XX-X||-X---|------B--B|--------f
------------------------------------------B------B--|-T---|----|--------X-----|XX--|---------------|----------------X|XXXXXX|B------XXXX-X|XX-XXXX|-----|XT|X------|XX-XXXB-||X----|----------|-T------f
------------------------------X---------------------|-|--X|----|???????-------|XX--|----M-----T----|----------------X|--XXXX|------?XXXXXX|XXXXXXX|B---X|X||X?-----|XXXXXX-X||----X|----------|X|-B--X-f
--XXXXXXXX-------T-------------------------------T--|-|---|----|------X-----XX|XX--|----------|----|--X--------------|-XXXXX|-XB--?BXXXXXX|XXXXXXX|---XX|X||X-X----|XXXXXX--||--MXX|----X-----|-|------f
---XX------------|-----------------X-------------|--|-|--X|----|B--------T--XX|XX--|----------|----|-----X------X----|XXXXXX|--X----XXXXXX|XXXXTXX|--XXX|X||X---X-M|XTXXXX--||--XXX|T--XXX----|-|------f
---XXX-----------|----------X--------------------|T-|-|---|----|----X----|-XXX|XX--|B-----XXXX|X---|X----X-B--X------|XXXXXX|-o-----XXXXXX|XXXX|XX|-XXXX|X||XBB----|X|XXXX--||-XXXX||-XXXXX---|-|------f
m--XXXX----------|---E-X-B---------E-------E-----||B|-|-E-|----|--E------|XXXX|XX--|----B-----|----|-----E----------X|XXXXXX|X--EEo-XXXXXX|XXXX|XX|XXXXX|X||XEMX-XX|X|XXXXX-||XXXXX||XXXXXXXE-|E|------X
XX-XXXXX-XXXXXXXX|XXXXXXXXX-------XXXXXXXXXXXXXXX||X|X|XX-|----|XXXXXBBBB|XXXX|XXXX|XXXXBBBBBB|X---|---X------XX---XX|XXXXXX|X--X---XXXXXX|XXXX|XX|XXXXX|X||X--B-XX|X|XXXXXX||XXXXX||XXXXXXXXX|X|XXXXXXX
