-------o-----o-------------o-----o------o------------o--------------------------------------X---------------XB---------------------------------B----X-----B-B---------o--X---o--------------------------
-----o--o-------------B--BoB-o--o-------------X-B---o-------E-------------o--o---o--------------------o-o------o--------------------B----B---------------------B-----o----------------------------o-----
--------------------Bo--B-------B----Bo----------o-----BoB-E--------B-----------------X-----o---o------oo-------------BB-------Xo-----B-o--oB--oo--o-----------o--------X-B--------------------B-B------
------------X--B--o-----o-----o-B--o----oo------o-----------X------------o-o----------X--o--BB--------------o-----X----------B-----o-Bo--------------B----------o-------o--o----X-o--B-------oX-------oo
--------oB-o------oX----o---------oB-o-X--o-o--------o------B--X--oo----o---o-o-o---o-----X------X-----------oo-----oE---------------------B-o--o---X---B----BB-B-B------o-o-X---X------------oo----o---
B---------------o------------BX-B-------B-o-----X------oBo-----o--Bo------------o----oX-----------------o---XX-------X----------o----------Xo-------o---B-oo---------X-o--X-----o--X--o------o--------B-
----o-o-------------o--X---------oo---oB---B----------------B--X-----B-B-----?-------o----o----o-----E-----------B-----X--o-X---o-----------------Boo--B-------------o---o--o---o-o-----o------oX-o---o-
---o------------X----o------o----o--o-Bo-o--o--------------------Bo-------B--------X-------------------------o--X-o-o-------------o--X------X--------------o------------------oo-E-Bo----------------B-v
---B----o-Boo---o-------o--BX---------B---o--o----o-BB---------B-----B--------o-----o----X----------X--------B---B----------B--------B-----------oB---------------B--B----------------------------B--B-f
--o----------------oo-----o---------------o--------------E---o---o---o-----o-------o--oo---X-------E---------B-------------o-E-o--o-o--------B-----------X-----BX---------BB-------oB-oo-----B---------f
-------X--------o--X------------------------o----oB--------o-o------------------o-----o--------E-----------o-----o---o-------o----------o---o----o--------oE------------o--------o-------------o----X--f
B-----------o------------o------o------o--------------------o-----o----o---------------------------XBo---------oo------B---X-------o--o-o----X--o----------------------------X------------o----o------of
B---------o-Bo---B---------o------B-----o-----------------o---------o---B-o-----o----------o---B---X------------------o------------------o--BX-o--o-----------------------BX---o--------o-------------Bf
-oo------B---------------------------------o--o------o--o-------oo----------E--B-o-o-o----------oo-o-----------o------o---o-o----------B---------o---------------o-------B-------------------X---------f
m--------X---o-----------B----X----B----------------------------B-o-B------------X---o-B--EBB---X-X-o---o---o-o--X--oo------------B----oo-o--X----o--X---Bo-----o--------o-B--B----B-o-----------B-----X
XXXXXXXXXXXXXXXXXXXXXXXXXXXXXXXXXXXXXXXXXXXXXXXXXXXXXXXXXXXXXXXXXXXXXXXXXXXXXXXXXXXXXXXXXXXXXXXXXXXXXXXXXXXXXXXXXXXXXXXXXXXXXXXXXXXXXXXXXXXXXXXXXXXXXXXXXXXXXXXXXXXXXXXXXXXXXXXXXXXXXXXXXXXXXXXXXXXXXXXX
