-----B---------------------------o---B---------X------------------o--o--o--------B------------------o--------o-----------------------B-----------------X------------B-----------------o----------B------
---B-o-o--------------o-o--------------------------------B----------o-------------o---o----------------o-------o-------oo------B------------------------------o----B------o-----o----B--oX------------o-
-----B------B---------o----------------------------------B-E-o----BB--o--B-------B-----o--------o-----------------------X---E----------------X----------B--------B-------B-----------------------o-----o
---o--------o--o-B------o-------------------o--o---B--Bo-----------X----o---X------------------------------B----------------B------------o-B-o----------------o------------------o----X------o-o------o-
---------oB----------------------o----o----o--------------------------------o---------B-B--E--o---oB-B-----------o----------o-----------B---------------------B------------X------B---B----------------o
-------------o-------------o-o--o--oB---o------B-----------------o---B-B---o--------------oo--B------------------oB--------------o---B--------o-----o-o----X----------------o---o--------B-------o------
--X-B---------B---------Bo-o-----o-B-----------X----X-EX---o---------oo--------B---o--oX-------o-------o--BBo--o---------XX-------B-----o-B-----------B------o-B--------------ooB----B---E--o-----------
------------------------------BB----X--o-----o--o------X----B-B-o---B---B----o----B-------------o---------B----X-----B---------o--X---o---------------oo---o---------B--B-----X------o---X-------------v
----B--------------------------ooo--------o---------------------B------------oB------------------o----------oo-------------------o--Bo--o---------------------o---------------B-o-------B--o------oo---f
------------BX------o---o-----------o--B---Bo-o--------E-------------oB------B--------------------B-----------------o---------------------------oo--o----o-X--------------------B-------o-------X------f
----o---o-o----oo-o-o----B-------------X------o----o---B--o--------X-BB---------B-----X-------o-----------------------B---o---o---o-E-----o----------B-----X------B--o------------o------X-------------f
---------------------------------oo--?---------o-------B--o----------B----------B-X--B---B----B------------o----o-B----X--o-------E-o---oo----X----B--o-X---o----------BX----------------XE---B-----o--f
--o------------------oooX---o---o---------o--B-B----o------o-----------B-----------o-----B------------Bo---------B--------B-----------o---o-o------B----o---X-B--o-----X-o-B--------X------------oB-o-Bf
---oB-X-------------o---o-----o-------B-BBX-o---o-------------------B------o-B--o---------B---B--o----------o--o-o---------o-B--o----X--X----o-----o-----o-o------o---X-------o----o--o--------oB--o---f
m-BB-X--------oX-oB--o--o---o------Xo-o-o--XB----B-------X------E------o--------o-------------B---oo----------o-------B-o---o----X--------o--o-------Bo--o------oB-o--o---B--o---------oo------o-------X
XXXXXXXXXXXXXXXXXXXXXXXXXXXXXXXXXXXXXXXXXXXXXXXXXXXXXXXXXXXXXXXXXXXXXXXXXXXXXXXXXXXXXXXXXXXXXXXXXXXXXXXXXXXXXXXXXXXXXXXXXXXXXXXXXXXXXXXXXXXXXXXXXXXXXXXXXXXXXXXXXXXXXXXXXXXXXXXXXXXXXXXXXXXXXXXXXXXXXXXX
