-----------------M----o---------------------------------------------------------------------------------------------------------------------------------------------B-----------------------------------
--------------------------------------------------------------------------------------------------------------------------------------------------------------------------------------------------------
-------------------M------------------------------------------------------------------------------------------------------------------------------------------------------------------------------------
---------XX--------------------------------X------------------------------------------------------------------------------------------------------------------------------X----------------------B------
--------------?----------X------------------------------------------------------------------------------------------------------------------------------------------------------------------------------
------------------------XX-----------------------------------------------------------------------------------------------------------------------------------------XXXXXXXT-------B--------------X------
-------X--X------------XXX------------------------------------------------------------------------------------------------------------------------------------------------|--------M---B-------B--------
----------XX-------B--XXXX-XXXXXX-----------------------------------------------------------------------------------------------------------------------------------------|----------------------------v
----------XXX------??XXXXX------------------------------------------------------------------------------------------------------------------------------------------------|--B--------------o----------f
----------XXXX------XXXXXX-------------------------------X----------------------------------------------------------------------------------------------------------------|----------------------------f
----------XXXXX----XXXXXXX-------------------------------XX---------------------------------------------------------------------------------------------------------------|---------------------X------f
----------XXXXXX--XXXXXXXX-------------------------------XXX--------------------------------------------------------------------------------------------------------------|----------------------------f
----------XXXXXXXXXXXXXXXX-------------------------------XXXX--------------------------------------------------------------------------------------------------------XXXXX|XX------B-----------BBBBBB--f
----------XXXXXXXXTXXXXXXX-------------------------------XXXXX------------------------------------------------------------------------------------------------------------|---------X------------------f
m-------E-XXXXXXXX|XXXXXXX-------------------------------XXXXXX------------------------------------------------------------------------------------------------------E----|-----------X----E---E------XX
XXXXXXXXX-XXXXXXXX|XXXXXXXXXXXXXXXXXXXXXXXXXXXXXXXXXXXXXXXXXXXXXXXXXXXXXXXXXXXXXXXXXXXXXXXXXXXXXXXXXXXXXXXXXXXXXXXXXXXXXXXXXXXXXXXXXXXXXXXXXXXXXXXXXXXXXXXXXXXXXXXXXXXXXXX|-----------X---------XXXXXXXX
