---------------------------------------------------------------------------------------------------------------------------------------------------------------------????????---------------------------
--------------------------------------------------------------------------------------------------------------------------------------------------------------------------------------------------------
--------------------------------------------------------------------------------------------------------------------------------------------------------------------------------------------------------
---------------------------------------------------------------------------------------------------------------------------------------------------------------------------------------------o----------
-?------------------------------------------------------------------------------------------------------------------------------------------------------------------------------------------------------
--------------------------------------------------------------------------------------------------------------------------------------------------------------------------------------------------------
--------------------------------------------------------------------------------------------------------------------------------------------------------------------------------------------------------
-----------------------------------------------------------------------------------------------------------------------------------------------------------------------------------BB------------------v
-------------------------------------------------------------------------------------------------------------------------------------------------------------------------------------------------------f
-------------------------------------------------------------------------------------------------------------------------------------------------------------------------------------------------------f
-------------------X-----------------------------------------------------------------------------------------------------------------------------------------------------------------------------------f
------------------XX----------------------------------------------------------------------------------------------------------------------------X------------------------------------------------------f
-----------------XXX---------------------------------------------------------------------------------------------------------------------------------B-------------------------------------o-----------f
----------------XXXX--------------------------------------------------------------------------------------------------------X--------------------------------------------o-------------------------o---f
m-E------BBBBBBXXXXX----------------------------------------------------------------------------------------E--------------XX---?----------------------------E-----------------E-----------------------X
XXXXXXXXXoXXXXXXXXXXXXXXXXXXXXXXXXXXXXXXXXXXXXXXXXXXX----XXXXXXXXXXXXXXXXXXXXXXXXXXXXXXXXXXXXXXXXXXXXXXXXXXXXXXXXXXXXXXXXXXXXXXXXXXXXXXXXXXXX-----XXXXXXXXXXXXXX?XXXXXXXXXXXXXXXXXXXXXXXXXXXXXXXXXXXXXXX
