---B----o-----------X------B---o----------------------------B--o-----------------------------o--o------------------------------------------------------B---o----X-----------------X---------------------
--------------o------o-X----BB---ooo-----------B--------------o------o----o-------o-----B----oBB--------Xo----B--------------------o--------------X-B---------B--o-------o----B--------BBB--------------
--B-oB----o--------Xo--------------o----B-------------------B-----------------o------o---X--------------B----o--------X------o----X----------B---B-E-BB---oBB----E-----------oo-o--o------o-------------
-----------?----------------B--EX--------X---X-B-------X-B-------X-------------------o----------------o--o--------M-------o--oo------X---X-------o---o-------o-----------------B-------B-oB-o---------o-
----------------------------o-oo-------B-----------------oB----oB-o-oo---B----o----------o------------B---o-----------B--o----o-----o----------o-o-------o----o---X-------o--o----------------X-B-------
-B----o-------X-o---o-------B---------------o------oo-----BB-EB-----------o-o--BB--B---o-----XoB-o-------------EB--B---------------X-o--o----XB---------------B-o----X------B-o-X-----o----B-B----------
-----Bo-----------B------B------B-o-B-o---------BB-----------------o--------o-X---------X-------------o----------o-----o--o----o------------------o---------------------------------------------Boo----B
------B----B---o--o-B----B-E-o------o---B-X--B------------------o---oB-------------o----o------B-o-----o---------------XX--------o------o----E-----B----------o------oo-B---oB---------E-X----BX---o---v
--BX-----B------o---X-------BXoo------E-------o-o-----B---o-X----X-Xo--X---------BB-o----o-B-------------B--o---------------B-o--oo--------o--o---------o---------B-----------o-----o-XX----B----------f
---o-o--o---------o--B---------X-o----o-----------B----------B----------o-B---------------------B---------o-------X---o-----------o--o--E-B-------oo-----B--o------o--B----------B-B-o-------o------o--f
--B----o-------------X---B----------o----X----B-------------------o------B---B--------XB-----X---B-------o----oo-------------o----o------B-o--B---o---X--------------X-----oX-----------o----o-----B---f
-----------o-------------------------X----------E--X-----------X---o----Eo--Bo----------B-------XoB-----o---o-------o--o----------------M-B--o-----o--E------o---oo-------------o-o-X--------------X---f
------------------XB--------o---X-oBoo-----ooX---------o------B-Bo--B-B---B--o-X--o-oo-X-----oB------B---X-o-o----B---o-X--------B--oB---o-------------------o-oB----X------------o--B---------BB-Xoo-Xf
--Bo--B-o-o-X-B---BE--oo---o-o---B--B--B-------------B------B------------o-------X-X-------XXoBB---o---------X--X-----------------------o------o-----------X-o-o------oX-Bo-------o---B----B----B-----Xf
mB------o-X--------X---o---oXB-------B-B-o------------o------B----------XX-------BB-----Xo-------o--B--------B---------o----B------B-o-B-B-o-o----B--B----B--o-----------B--X-o-----B-B-B-------------oX
XXXXXXXXXXXXXXXXXXXXXXXXXXXXXXXXXXXXXXXXXXXXXXXXXXXXXXXXXXXXXXXXXXXXXXXXXXXXXXXXXXXXXXXXXXXXXXXXXXXXXXXXXXXXXXXXXXXXXXXXXXXXXXXXXXXXXXXXXXXXXXXXXXXXXXXXXXXXXXXXXXXXXXXXXXXXXXXXXXXXXXXXXXXXXXXXXXXXXXXX
