------B--B---o--o----------X--B--o---X-X------o-----------o----o--B--B----------------------o-----------o-oX---B-------X-------B-o-o-----------B-------------o----------------------X-B--------B----o--B
-------------B-o-o-------------o-o--oB------X----B-------B-B--B--X-----o-o-o---------Eo----o----oo-X---B-----B-o-----o-oEo------B-------B-o--o------------o-B----B---------B-B---B---oo------B-B--o-----
---------------------o--B----B-B-B---X---------o-------o-o----------------o------o-------X-B-----------o----o----o--Bo--------o---------o-BoB-BX-oo-----o-----------B-B---------o-o-----oB-XX---Xo------
------X-------o-Bo----o----BXB--o--o---o----oo----------E---------X-------o----BB-----------------o---X----o--oBo------------B-o--B-------B---oBBB---------o----o---o--B--oT-B-oo-oo--o----------oo-E---
o----------------B------B---------------X-o--oo--B------B-------Eo---BB---B--------X-----------o---o-----------------EB---------X-----B---o--X-------o-o------------o---E--|--B--------------B-------Xo-
-oX-o----BB---E---T-X----X-----Bo-------o-Bo--o----------XB----o-o-o------------------o-----Xo---oB---?---o---B------BB-B--o-o--o---------o----------------------B---------|--ooX--------T--------------
---------o-T--XE--|-------X--o------B----o--------o-o---X---o------------B--o?---o-o------o---------B----------------o----------B---BBo-----B---B---------o---o---X-X--o-o-|-------oo----|--o--X--------
o---B--B---|-o----|--B--o------oB--o--X----B---B----o-------X--B--B------o--E--B----X-X-------B------o-o-----B-?---B----o--o---Xo----o--------BB--X---------BB-----------B-|-------B-B---|-------------v
----B--B---|---E--|--TBX--o--X-X---------BBB-o--B--oX---B--XEoB--Bo-T-------o-----B-----------B-o-------------------------------B-o-X-----------B--B-B----o--------------X-|-o---X-----X-|-o-----o---B-f
---o-EX----|-oB---|--|----E---oB--o--o----o-B---Xo--------oBB-Xo--o-|--o-------X-------E--o-------oT--B--o-X---B----o---X-----oo-B--o---------------------o-B---B-B--o-----|-B----B----B-|-------------f
-oo-B-o----|-----B|--|---oB--o---X-o--oB----------Bo-o--B-----------|------Bo-B-o----B-B--B--X-X--o|--o-----o-------?o-------Bo----------------B----X-----------X----------|--o------X---|-------------f
--X--o---B-|------|--|---------T--X-----o---oo---X---o-B--o-------o-|--oo----X-oX-o-----------o---o|----B-o-o----------XX-----o--------Xo-------o-----o-o--o--X---------X--|----------T--|--o-------E--f
o-------Bo-|-oE---|--|---o-----|-------o-o-oo-------B-o---oX-B------|-o-B--B-----o--o-X-----o------|----o-o-E--B---oB---B-----o--o--o-----o--o-B------------BB--------o----|-o-BB--X-o|--|---------o---f
X--------B-|----o-|--|-Bo------|------B----o--B----------------B-X--|--o--------------o------------|-----ooB-----o--B---------B---Xo---o--------o-E--o----------o----------|----Xo----|--|----o----B---f
m-o--o----o|---E--|--|----X----|-E----E-E--X------E-----------E-o---|--o---------Eo----o-B----B----|----------o-B--o-o---------o--o---------X-----B--o----E-----oo-BEEoE---|---E---X--|--|--M----o---B--
XXXXXXXXXXXXXXXXXXXXXXXXXXXXXXXXXXXXXXXXXXXXXXXXXXXXXXXXXXXXXXXXXXXXXXXXXXXXXXXXXXXXXXXXXXXXXXXXXXXXXXXXXXXXXXXXXXXXXXXXXXXXXXXXXXXXXXXXXXXXXXXXXXXXXXXXXXXXXXXXXXXXXXXXXXXXXXXXXXXXXXXXXXXXXXXXXXXXXXXX
