-----o---o------o-----------------o---------------X-o------o-----------X------------o------o-------B--------o--X---------X-------------------X---o-----------------------------------B----B----------BX-
----------o--X---X--o-----------B-----------o---------------------M-o-------------X----o---o-----------------------o-------o---------X--B--oo-o--o-----B-------------o-B---o------o------E--o-B------o-o
--BX---------------?---o------------X-------o---B-o-----o--------------------------X--oo-----X---B-BX-------o-B---B------------B--------------o-------o--X--------B-------o------------------------o---o
---B-o-----X--o-?-----------o-B-o-o-----------B-------B-------------B----o----------oE-B-X-------o---B-----B-Xoo--Xo----------o-------------X-B--X--------oB---------Xo-o----------------o--------------
--o----------------------o---------------oBB-o---o---------o-----BX---oo------------------o---BB---------------------------------------B-o------------o--oBB-E----B----B--o-----------o---------o-------
------o---X-------X-----B--o-X---o-ooX--o-----Xo------------Bo------------oo-o-o-E----o-B--o-----------oo-----B----BB-------B--------B--oo-o----------o--B-----------B---------X-----------o-BX------X--
-----o-B--X----------X-X----B---------------o----------E----------------X-------B----------------B-------o-oB--o--X-oB---------------B-----oo-----o--B---------------o---EB---X----B--------------------
------------------E-------------B--------o-o--------o----------------o-o--------------------------------------------------o-------B-X----------B---E-----Bo--------o-------B--B------------X-Xo--------v
-----------------BX---------B---B---------------oo----o-o----XXBo-o---------------------------------o----o----------E-oo--------------------X------------o-----B----------B-o--o-------oo---B--X----B--f
--------B---------o-------o-----o--oBo--Xo------------------------------B-------B---o----B-X----o----B---B---X-----B-------oB--X-B---------------B---------B-o----o-----o--------------------B---------f
--o---o----X-------o---o---------o----------------B---o-------------------------------------o-B---B-------------------o---o-----o-o-o-B-o-B-oXoo----B---o--o--------B----------------------B----------of
---------B------------B--B----------------o-----B---MB--o--o-----------o----o---o-o--X-----o-------------X--------Xo------o-----o-X------------o--o------B---B-o-------o---------B-----o---X---------o-f
-----B-o--X---X-o-------B----------o-----o--oX--------o-B-o----X-o----B--X-----X-------------------o----X-o---B---X-o----------------o-o----oo----oB----X---o---B-o-------o---o-o-o--o----------B--B---f
----------X-----------o-----B-oB--------o---B-----?---o--------o---BX-B----B-o-B--o---------oo-----X--E-------E-o---o-----------BB--X-----XX---B-----B-B----B--------------B-----o------o----B---------f
mo--------EoB------X--------BB----B-o------o-oB-----B-------------o-o-----o----------o-X-----o--B-X---B----o---o-----------o----B--o-oo-------B--Bo--------X--o-B----------B-Bo---X---B-----E-o----B---o
XXXXXXXXXXXXXXXXXXXXXXXXXXXXXXXXXXXXXXXXXXXXXXXXXXXXXXXXXXXXXXXXXXXXXXXXXXXXXXXXXXXXXXXXXXXXXXXXXXXXXXXXXXXXXXXXXXXXXXXXXXXXXXXXXXXXXXXXXXXXXXXXXXXXXXXXXXXXXXXXXXXXXXXXXXXXXXXXXXXXXXXXXXXXXXXXXXXXXXXX
