--------------------------------------------------------------------------------------------------------------------------------------------------------------------------------------XXXXXoXXX---------
------------------------------------------------------------------------------------------------------------------------------------------------------------------------------------------------X-X-----
-----------------------------------------------------------------------------------------------------------------------------------------------------------------------------------------B--X------X----
-----------------------------------------------------------------------------------------------------------------------------------------------------------------------------X---------------------?----
----------X-------------------------------------------------------------------B-----XXXXX------------------B---------------------------------------------------------------------------------------X----
---------------------------------------------------------------------------------------------------------B--------------------------------------------------------------------------------------o-------
--------------------------------------------------------------------------------------------------------------------------------------------------------------------------------------X---------M-o-----
----------------------------------------------------------------------------------------------------------------------------------X--------------------------------------------------------------------v
--------------------------------------------------------------------------------------------------------------------B------------------------------------------------------B------------------B--------f
--------------????------------------------------------------------X---------------------------------------------------B------------------------------------------------------------------T----TM-------f
------------------------------------------------------------------XX-------------------------------------------------------------------M----X-----------------------------------------X--|----|--------f
------------------------------------------------------------------XXX--------------------------------------------------B---------------------B-X-----------------------------------------|----|------o-f
----------B-------------------------------------------------------XXXX-------------------------------------------------------------------------XX----------------------------X-----------|M---|--------f
-------------X----------------------------------------------------XXXXX----------------T------------------------------------------------?--XXXXXXX----------------------------------B----|----|--------f
m-----------E-----------------------------------------------------XXXXXX---------E----E|----------------------o------------------X--M----------XXXX--------------------------------E---E-|----|BE--E---X
XXXXXXXXXXXXXXXXXXXXXXXXXXXXXXXXXXXXXXXXXXXXXXXXXXXXXXXXXXXXXXXXXXXXXXXXXXXXXXXXXXXXXXX|XXXXX----XXXXXXXXXXXXXXXXXXXXXBXXXXXXXXXXXXXXXXXXXXXXXXXXXXXXXXXXXXXXXXXXXXXXXXXXXXXXXXXXXXXXXXX?|????|?XXXXXXXX
