--------------------------o------------------------------o---B-----------------------------------------------------------------------------------------------------B------------------B-----------------
-----------------o--------------B---------------------------o----oX--------------o-----------o------------B----oo---------------o-------o---------o-----------B------E----------------------------------
--------o--X-------o----BB---------o-o-------------B-----o-o----------X-----------X-----------X----------------B------------o-----------------B----X----B--o-------------?BB-----oo---------------------
-----o-----------X------o----------o------------------------B----X-----------B--X-------------BB---o--------------B-B--------o------------X------XXB-------------------o--X----------o---X------------o-
---------X------B---------------------X--------o-------------B----oo--o----o---------o--o------BB----------------------------o-------------oo-----B--------------o-------------o---X--------------------
------------------------------Bo-----------B------B----------B---o-------------------oX-------------o-----------X-----------------------o--------------B-B--B--o-----B----o-o---oX----------------B-o---
------B---B---------B---B-------o----X----------o---o--------o-----o-------------------------------X-o---o----B-----B------o-------XB--------E-----------------------X---X--------------------B---------
----------------------------o-------------------o--Bo-o----B------o------oo------------------X---------------------------B---o-----------------------------------------------o---o-------------------o-v
-----------B---E------------o------oo---B-----------Bo--o--Xo-------------ooX--------o--o-o------------oo--o----------o---------------B--------------------B-----o----o---o----X-----------o---B-------f
---B-o------o--o--------------o--o-o------------------------------------------B-B----------------X-----o-----o-B-----------------------oo----o--------------o--B-----------o-------------------------X-f
-------------------o-------------------------------B------------o-----o----------B----o-----o---------------B------------Bo-----o---------------------------o--B----o-----------o------XB--------------f
--o-------------------------oo---B-o-----------B---------------oo-----o---------------------B--X---?-o---o------o---------------------------?X----------B---X--------------------B------B--------------f
---------o--X----o----------------oB------------------------Xo---------------o-----o-------X---------------o-----oo-------o-o----------B---o-----------oB--o-B-------------o-----------------BB--------f
-oo--------B------------X-----o------o-----------B--------o------o------B--------------o---------X-o-B-B--Xo-------------------o--B-----o---E---------X-o-----------------oX----------o---------X----BEf
m-----o---------B----B-------B---------------------o-----E----o---o------X---------B------o-----------------X---B----o------X----------------B-X--X-o------X------------B-----B---o-B----------B-o-----X
XXXXXXXXXXXXXXXXXXXXXXXXXXXXXXXXXXXXXXXXXXXXXXXXXXXXXXXXXXXXXXXXXXXXXXXXXXXXXXXXXXXXXXXXXXXXXXXXXXXXXXXXXXXXXXXXXXXXXXXXXXXXXXXXXXXXXXXXXXXXXXXXXXXXXXXXXXXXXXXXXXXXXXXXXXXXXXXXXXXXXXXXXXXXXXXXXXXXXXXX
