-------------------------------------------------------------------------------------------------------------------------------------------------------------------------------------------------X------
----------------------------------------------------------------------------------------------------------XXXXXXX---------------------------------------------------------------------------------------
-------------------------------------XXXXXXX------------------------------------------------------------------------------------------------------------------------------------------------------------
----------------------------------------------------------------------------------------------------------------------------------------------------------------------------------M---------------------
--------------------------------------------------------------------------------------------------------------------------------------------------------------------------------------------------------
--------------------------------------------------------------------------------------------------------------------------------------------------------------------------------------------------------
-----------------------------------------------------------------------------------------X----------------????------------------------------------------------------------------------------------------
-------------------------------------------------------------------------------------------------X--------------------------------X--------------------------------------------------------------------v
------------------------------------------------------------------------------------------------XX-------------------------------XX--------------------------------------------------------------------f
------X-----------------------------------------o----------------------------------------------XXX------------------------------XXX---T----------------------------------------------------------------f
----------------------------------------------------------------------------------------------XXXX-----------------------------XXXX---|----------------------------------------------------------------f
---------------------------------------------------------------------------------------------XXXXX----------------------------XXXXX---|----------------------------T-----------------------------------f
--------------------------------------------------------------------------------------------XXXXXX---------------------------XXXXXX---|------------------------M---|-----------------------------------f
------------------------------------------------------B-?----------------------------------XXXXXXX--------------------------XXXXXXX---|----------------------------|-------------X---------------------f
m-------------------E---------------------------------------------------------------E-----XXXXXXXX----------------------E--XXXXXXXX--E|----E----M-----E------------|-------E------------E--------------X
XXXXXXXXXXXXXXXX--------XXXXXXXXXXX--------XXXXXXXX-XXXXXX-------XXXXXXXXXXXXXXXXXXXXXXXXXXXXXXXXXXX--XXXXX------------XXXXXXXXXXXXXXX|XXXXXXXXXXXXXXXXXXXXXXXXXXXX|XXXXXXXXX-XXXXXXXX?XXXXXXXXXXBXXXXXX
