--------------------------------------------------------------------------------------------------------------------------------------------------------------------------------------------------------
--------------------------------------------------------------------------------------------------------------------------------------------------------------------------------------------------------
------------------------------------------------------------M----------------------o--------------------------------------------------------------------------------------------------------------------
--------------------------------------------------o-----------------------------------------------------------------------------------------------------------------------------------------------------
---BBBB-------------------------------------------------------------------------------------------------------------------------------------------------------------------------------------------------
--------------------------------------------------------------------------------------------------------------------------------------------------------------------------------------------------------
-------X------------------------------------------------------------------------------------------------------------------------------------------------------------------------------------------------
-------------------------------------------------------------------------------------------------------------------------------------------------------------------------------------------------------v
-------------------------------------------------------------------------?-----------------------------------------------------------------------------------------------------------------------------f
-------------------------M---------------o--------------------------------------------------------------------------------------------------------------------------------------BBBBBBBB---------------f
-------------------------------------------------------------------------------------------------------------------------------------------------------------------------------------------------------f
----------?--------------------------------------------------------------------------------------------------------------------------------------------------------------------------------------------f
-----------------------------------------------------------------------------T-------------------------------------------------------------------------------------------------------------------------f
-----------------------------------------------------------------------------|-----------------------------X----------------------------------o--------------------------------------------------------f
m-------------------E---------------------------------------E----E-----------|----------------------------XX-----------E---------------------------------------------------------E---------------------X
XoXXXXXXXXXXXXXXXXXXXXXXXXXXXXXXXXXXXXXXXXXXXXXXXXXXXXXXXXXXXXXXXXXXXXXXXXXXX|XXXXXXXXXXXXXXXXXXXXXXXXXXXXXXXXXXXXXXXXXXXX-----XXXXXXXXXXXXXXXXXXXXXoXXXXXX-XXXXXXXXXXXXXXX-----X---XXXXXXX--?????XXXXXX
