--------------------------------------X-----------------X-----------------------------B-------X--------------------X------------------------X--------------------B-X---------------------X--------------
-------------------------------------------------------X-------------------------------------------B--------------------------------------------------B------------------B---------------X--------------
------------------------X-----------------------------------------------------------BBX---B-------------------------------------------------------------------------------------------------------------
-------------------------------------------------------------------------------------------------------------X--------------------------------X---------------------------------------------------------
---------------X-------------------------------------B---B---------------------------------------------------------X--B---------B--------------------------B-------------------------B--X---------------
--X--------------B--------------------X---------X----------------------X--------------XB------B-X----X----------------B---------------------------------X-----------------------------------------------
-------------X------------------------------------------------------------------------------------------------------------------------------------------------------------------------------------------
------------X---------X-----------------------------B--X----------------B--------------------------------------------B----------------------------------------------BB--X------------------------------v
------------------B--------------------------------------------------------------------------XB------------------------BB-------B-----------------------------------------------X----------------------f
----------------------------------------X-------B-----------X------------------------------------B---------------------X------------------X-------------------------------B----------------------------f
-------------------------B-----------B---------------------------B------------------------------------X--------X------------X---------------------------------------------BB----------B----------------f
-------------------X-----------------------------------------X--------------------------B------------------X-------BX---------------------------------------------------X-X----------------------------f
----------------------------------------------------X---------------------------------------------B-XB-----------------------X----------------XB-------------------------------------------------------f
-----X--------------------------------------------------------------------------------------------X-------X--------------B----------X--------------------------------------------------------------X---f
m---------------------------X-------------------X---B-----------------------------X-X------------------------------B------------------------------------X----------------------------B------B------X---X
XXXXXXXXXXXXXXXXXXXXXXXXXXXXXXXXXXXXXXXXXXXXXXXXXXXXXXXXXXXXXXXXXXXXXXXXXXXXXXXXXXXXXXXXXXXXXXBXXXXXXXXXXXXXXXXXXXXXXXXXXXXXXXXXXXXXXXXBXXXXXXXXXXXXXXXXXXXXXXXXXXXXXXXXXXXXXXXXXXXXXXXXXXXXXXXXXXXXXXXX
