----------------------------------------------------------------------------------------------------------B----------B----------X------------X---BBBBBXXoXXX--X-X----B--------X-----o??????-------------
--------------------------------------------------------------------------------------------o---------B-M-----BBBBB---Bo-B-----B-------B-X-B-BB-X--o---B-X-----B------B---o--------XX----B---------X----
----------------------------------------------------------------------------------------------X--------X---?B--?--------Xo---X--B---------BM--?B--B----X----B--B---B--B-X--B----B----X?XXXXX-??M???---B-
-------------------------------------------------------------------------------------------T--B------------------X----T----M-----o------------------T-----BBBBXBBB-?-------X----X-?---X-BBBBBBBBXBX--B--
----------------------------------------------X------------------M-------------------------|------------XXXXXXXXX-----|----XX--X--XB---------XB-X-X-|---T--B-oB----X--XT----B---B-TB---X----X-T-X--XX---
----------------------------B-------------------------------------------B-M----------------|---B--XX------XX------B-TB|X--X----B-----T-BBXBXBX------|T--|T--------B--XX|--?X--B--X|X--?MX--XXT|?B-XXTT--
-------------------------------------------------------------X------------X---------B------|----------oB-XXX------BX|M|--B---T-XB----|---XXX--XXXXTX||--||----?TT---XXX|---XX----X|XXTXX--XXX||-oXXX||--
--------------------------------------------------------------------------T--------------T-|-----B--B-T-XXXX---BB-X-|B|-BB---|------?|o--TXXXo----|T||BX||-X-T-||--XXXX|---XXXBBBX|XX|XX-XXXX||-XXXX||?v
----------------------------------------------------------B------------B--|-B------------|B|-X--?----X|XXXXX-----XXX|-|-BB---|-----BX|B-X|XXX-XX--||||T-||XXX|-||?XXXXX|-X-XXXX--X|XX|XXXXXXX||XXXXX||Xf
--------------------------------------------------------------------------|--------------|-|-----X----|XXXXXBXB---XX|-|oT-X-T|---X--X|-XX|XXXX-XT-|||||B||TXX|T||XXXXXX|XXXXXXXX-X|XX|XXXXXXX||XXXXX||Xf
--------------------------------------------------------------------------|--o-----------|-|-----XTX-X|XXXTXXXX-B-XX|X|-|B--||---XX-X|XXX|TXXXXX|X|||||-|||XX||||XXXXXX|XTXXXXXXXX|XX|XXXXXXX||XXXXX||Xf
---------------------------------------------------------------------?----|--B----X------|-|-----X|XXX|XXT|XXXXXo-XX|X|-|-M-||---XXXX|XXX||XXXXX|X|||||X|||XX||||XXXXXX|X|XXXXXXXX|XX|XXXXXXX||XXXXX||Xf
--------------------------------------------------------------------------|---???XXX-----|-|--B-?X|XXX|XX||XXXXTX-XX|X|X|--?||---XXXX|XXX||XTXXX|X|||||X|||XX||||XXXXXX|X|XXXXXTXX|XT|XXXXXXX||XXXXX||Xf
---------------------------------------------------------------------X----|-------XXX----|X|--B--X|XXX|XX||XXXX|TXXX|X|X|---||--TXXXX|XXX||X|XXX|X|||||X|||XX||||XXXXXX|X|XXXTX|XX|X||XXXXXXX||XXXXX||Xf
m---------------------------------------------------------E---------XX----|--EE---XXXX-E-|X|---E-X|XXX|XX||XXXX||XXX|X|X|XBB||E-|XXXX|XXX||X|XXX|X|||||X|||XX||||XXXXXX|X|XXX|X|XX|X||XXXXXXX||XXXXX||XX
XXXXXXXXXXXXXXXXXXXXXXXXXXXXXXXXXXXXXXXXXXXXXXXX----XXXXXXXXXX-----XXX----|--XXXXXXXXXXXX|X|XXX-XX|XXX|XX||XXXX||XXX|X|X|XX?||--|XXXX|XXX||X|XXX|X|||||X|||XX||||XXXXXX|X|XXX|X|XX|X||XXXXXXX||XXXXX||XX
