--------------------------o-----------------------o----------------------------oB--------------------------------------------------------oo----------------------X-----------------------------oB-------
-----X----------o-------------------E---Bo----o--B------o--X--B---B-o---o-o-?---o----------------o------------oE-XB------------------------BB-----o---o---X-------------B----------------------E---o-X--
--------B----X--o-----o-B-B--------------------o------------------------------------X-B--B----o---o--o-----o------o--o-o-----------o-o-o---o------------X---------------------o-B------------o-----XB---
-------EXo---o-Xo---------o--------X-o---o-------------B--X-----------B-o------------o----------X--------o-----BX---------oo----o--B-----------o--X------B-oo----Xo-------o---------------------o-------
-----oo--BB--------------o--o-X--B-------ooo------------o-----------o-o---X---o------------B-----oX--oB-------B---------------X---o---------------------o----o-------o--oE------o---------E--o----------
-o---B----------o----------o--o------------B--------------X------------B--------oB-----o------Bo---------------o-o---------?-o------o----------------BB-------oB-o-------o--B----------o-X------o-------
-----B--X---o---------------B------oo---o------o-------------------------o--X--o------------------o--------o------Eo-B------o---B----Bo-B---------o-----------o-B-B--B?--o-------o-------------X--------
------------------------X-------------E-X---------------o------------------XX------------o------------o---oB----------------o-------------oo-E---B-----o-o--E------o-----o----------o------B----B--B---v
-----------o---X-o-X--o---------o--o--X-B-o-o--------X------------X--o----X-BB-----B--B-o-o-------ooo---------------------------------o-o--o----o-----X----B-----o-----o--o---oX-BooB-B---------o----XBf
---o---X------------B------o----X----B------------X----------------XEo-o--B--o--X---o-o-----o------------------o-------B-----------------o-X--o--------------BB-------o-------B-------------------B----f
---------oo---------B-------X--------------BoX-------------o----B-----Bo---------o-----o------o-----oB--Eo------o----o-E--o--B---B---o----------------------------o----------o--B--------o--X-----o----f
-------------------oo-------B--------o---------B-----B------------------E---o-------------B--o--B-------------B--o----------oo-B----B-------------o-X-?-----B-------oX-?---o-----------------B-------X-f
---oB-----------------oo-o--XB------B--B------------o---------o----B-------o----------B--o-o------X---o--o--o----o-----------------B--B-B-X----------------B-----o----o------------X----o--------o-----f
------------o----------------o-o-------B-X-oo-B-------------oo--------------Eo---------------o-----X---?-----------------B--X-------------o-------------B------o------B--------o--X-B------------Bo---of
m-----B--o-o-o----B---o--------B--oX---X------o--------o------------B--ooo-B----o-------B--------o-----------------o--X-o-B-----o-------------------B-----B---X-----B-oo--B-----B----B-B-o--B---------XX
XXXXXXXXXXXXXXXXXXXXXXXXXXXXXXXXXXXXXXXXXXXXXXXXXXXXXXXXXXXXXXXXXXXXXXXXXXXXXXXXXXXXXXXXXXXXXXXXXXXXXXXXXXXXXXXXXXXXXXXXXXXXXXXXXXXXXXXXXXXXXXXXXXXXXXXXXXXXXXXXXXXXXXXXXXXXXXXXXXXXXXXXXXXXXXXXXXXXXXXX
