--------------------------------------------------------------------------------------------------------------------------------------------------------------------------------------------------?????-
---------------------------------------------------------------------------------------------------------------------------------------------------------------------------------------------------?----
-------------------------------------------------------------------------------------------------------------------------------------------------------------------------------------------X-------B-X--
------------------------------------------------------------------------------------------------------------------------------------------------------------------------------------------------------B-
-------------B-------------------------------------------------------------------------------------------------------------------------------------------------------------------------B-------------X--
-------------------------------------------------------------------------------------------------------------------------------------------------------------------------------------------------X------
-------X-----------------------------------------------------------------------------------------------------------------------------------------------------------------------------------------XX-----
-------------------------------------------------------------------------------------------------------------------------------------------------------------------------------------------------XXX---v
---------------------------------------------------------------------------------------------------------------------------------------------------------------------------------------M---------XXXX--f
--------------------------X---------------------------------------------------------------------------------------------------------------------------------------------------------------B---XBBXXXXX-f
----------------------X------X-------------------------------------------------------------------------------------------------------------------------------------------------------------M-----XXXXXXf
-----------------XX-----------------------------------------------------------------------------------------------------------------------------------------------------------------------B------XXXXXXf
-------------------------------------------------------------------------------------------------------------------------------------------------------------------------------------------------XXXXXXf
-----------------------------------------------------------------------------------------------------------------------------------------------------------------------------------------TBB-----XXXXXXf
m----------------------------------------------------------------------------------------------------------------------------------------------------------------------------------------|-B-----XXXXXXX
XXXXXXXXXXXXXXXXXXXXXXXXX----XXXXXXXXXXXXXXXXXXXXXXXXXXXXXXXXXXXXXXXXXXXXXXXXXXXXXXXXXXXXXXXXXXXXXXXXXXXXXXXXXXXXXXXXXXXXXXXXXXXXXXXXXXXXXXXXXXXXXXXXXXXXXXXXXXXXXXXXXXXXXXXXXXXXXXXXXXXX|XXXXXXXXXXXXXX
