--B-----o--o---B----BB-X-------oo-o------------B--o--o---------o---X---X-o-----o-------o----o-----X--o--------oB---B---X-oo-------o-o-----B---------B----B-o-B-------B--B---------o---X----------o-----B
---------oB----B-----------------B-----o--X--o-----X------Xo---oB-oo-----------------o--o-o---------o--o----Bo---o-X----o---o--------o---E----?-o--oo-------o---o-B----o----------B--X------Xo---o--B-oo
--X-B--------oo---X---BB-o-o--------o--------o---Bo-----------B---o---o-------o-Bo----------B--Boo-B-oB--o---o----------B-----------X---BB--o--o--------B-B-----------o-----X----o---B-----o-?-----o----
-o---B---o--B--BE------oX---oX---------o------------------oo-?--B---------B----o--X----B----X-------oXB-----X-----o-------B--BB----B---------B-----------------BB------o-X--------X-----------X--------o
---X-o----------B-oo----B---o------B------Bo--B-?-o------------B-----o-----------Xo--o-oo-B-X-Xo-------o------------o-----------oB--X-----B-X--------B---------------------o--o-ooo--o-B------X-----o---
---o---o---------o---BB---B----B-?-----oo------------B-o-X---o---o--BBX--X--------o-X--X--o---------------o------o-o----Bo---------o-B-oB---X--o---B----T-X------o-o--o--o----XE-B--o----X--------o-----
---o----oE------X--B-o-------B-o--o-----B---o--B--X---o------o----------X----o----B----BB-----o----oB-----BE---BB---------------o--o----o----o-B--------|----B--B-----oo-------B---o-------------Bo--X--
------o--XT---oX--o-oo?o----------XBoo---B--------B---B-------o----X-------------o-o----X----------o-------XB--o------o------------X-o-----B--o-B-B-----|---X---o--X--------------BB---B-----B---------v
----o-o---|--X-B--------B--------?B--B--B--------------Bo---X--------X----X--B----X-------B----X-------------o-XB-----o------o----o-------------XB----o-|------o-o-------X--------B-B--------o-----B---f
--B-------|--o---------o--oX--X---------B-XB--?B----------o--X-----B---o--B--B-X----X---o---------X----X-o-------------o-----o--X----B-----------B-----o|-XB--------o----ooo---o----oX------------X--X-f
-o------X-|-------o-B-o----?----B--------------B--------XX-----o--X-Bo---X---o-oT----o---BB-----------o-------X----------oBo------XB----B--------------o|------B-------Bo-------o-----------o---o------f
------o-o-|---X----------o-----B-B---------oo--------------o---------B----B-B---|----o---oB------o--------------o------B----------o----------------oB--B|--o-------------B------o-----------B----------f
------X---|------o------------X----------------------B-Bo----o----------------o-|--o----X-------------o----B---o-B----------------------o------B-----o--|------BX----------E----o----BB--Xo------o--X--f
------X---|--o-o--------o-----o--B-E--o------o------o-oB---o----o----------T--X-|-X-E-----------o---o----o------------------o-------------o-------o--X--|-B------------B-------------o-o----------B--B-f
mB------o-|-----------o----B-------B---------o-B----BB--------o-XB---------|-BB-|--XB---EB--o---------o-------Xo----B-X-o--------E-----E--------o-------|------B-------------EX----oo---o-----B-o---B--X
XXXXXXXXXXXXXXXXXXXXXXXXXXXXXXXXXXXXXXXXXXXXXXXXXXXXXXXXXXXXXXXXXXXXXXXXXXXXXXXXXXXXXXXXXXXXXXXXXXXXXXXXXXXXXXXXXXXXXXXXXXXXXXXXXXXXXXXXXXXXXXXXXXXXXXXXXXXXXXXXXXXXXXXXXXXXXXXXXXXXXXXXXXXXXXXXXXXXXXXX
