----------------------------------------------------------------------------------------------------------B----------B--------BBBB-----------X---BBBBBXXXXX---------------------------------------------
--------------------------------------------------------------------------------------------o---------B-M-----BBBBB---Bo-B-----B-----X-B-X-B-BB-X--o---B-X-------------------------X---------------X----
-------------------------------------------------------------------------------------------------------X---?---?--------Xo---X--B---X-----B---?B--B----X----B-----------------------------------------B-
-------------------------------------------------------------------------------------------T--B------------------X----T----M-----oB------X----------T-----BBBBBBBB------------------------BBBBBBBBX--B--
----------------------------------------------X------------------M-------------------------|------------XXXXXXXXX-----|----XX--X--XB---------XB-X-XX|---T-------------------B----------X----------------
----------------------------B-------------------------------------------B-M----------------|------XX--------------B-TB|X--X---BB-----T-BBXXXBMM-XX--|---|T------------------------------------------TT--
-------------------------------------------------------------X------------X---------B------|----------oB---X------BX|M|--B-----XB---X|---XXX--XXXXXX|---||-----------------------------X----M-------||--
--------------------------------------------------------------------------T--------------T-|-----B--B-T--XX----BB-X-|B|-BB---?------X|oT-TXXXoXXX--T|BXX||-X-------------------------------------???||?v
----------------------------------------------------------B------------B--|-B------------|B|-X--?----X|--XXB-----XXX|?|-BB---X-----BX|X|X|XXXXXXX--||XT-||XXX---------------------------------------||Xf
--------------------------------------------------------------------------|--------------|-|----------|--XXXBXB---XX|-|oTBX-T---BX--X|X|X|XXXXXXT--||X|B||XXXX---------------------------B----X-X?--||Xf
--------------------------------------------------------------------------|--o-----------|-|----------|--XTXXXX-B-XX|X|-|B--|----XX-X|X|X|TXXXXX|X-||X|-||XXXXX----------------------B-------X------||Xf
---------------------------------------------------------------------?----|--B----X------|-|----------|-XT|XXXXXo-XX|X|-|-M-|----XXXX|X|X||XXXXX|XX||X|X||XXXXXX-------------------X-o----------B-X-||Xf
--------------------------------------------------------------------------|---???XXX-----|-|--B-???---|--||XXXXTX-XX|X|X|--?|----XXTX|X|X||XTXXX|XX||X|X||XXXXXXX------------------------X----------||Xf
---------------------------------------------------------------------X----|-------XXX----|X|--B-------|--||XXXX|TXXX|X|X|---|X--TXT|X|X|X||X|XXX|XX||X|X||XXXXXXXX----------------------------------||Xf
m---------------------------------------------------------E---------XX----|--EE---XXXX-E-|X|---E--E---|EX||XXXX||XXX|X|X|XBB|-E-|X||X|X|X||X|XXX|XX||X|X||XXXXXXXXX---------------E-------E--o----E-||XX
XXXXXXXXXXXXXXXXXXXXXXXXXXXXXXXXXXXXXXXXXXXXXXXX----XXXXXXXXXX-----XXX----|--XXXXXXXXXXXX|X|XXX---XXXX|XX||XXXX||XXX|X|X|XX?|--B|X||X|X|X||X|XXX|XX||X|X||XXXXXXXXXXXXXXXXXXXXXXXXXXX-------XX------||XX
