---------------------------------------------------------------------------------------------------XX---------------------------------------------------------------------------------------------------
-----------------------------------------------BBB------------------------------------------------------------------------o-----------------------------------------------------------------------------
-------------------------------------------------------------------------------------------------------------------------------XXXXX--------------------------------------------------------------------
------------------------XXXXX--------------------------------------------------------------------------------------------------------------------B------------------------------------------------------
-------------------------------------------------------------------------------------------------------------------------X-------------XXXXXX-----------------------------------------------------------
--------------------------------XXXXXX------------------------------------------------------------------------------------????--------------------------------------------------------------------------
--------------------------------------------------------------------------------------------------------------------------------------------------------------------------------------------------------
------------------------------o---------------------------------------------------BBBBBB---------------------------------------------------------------------------------------------------------------v
----------------------------------------------B------------------------??------------------------X--------X-B----------------B-------------------------------------------------------------------------f
-------------------------------X---------------------------X-------------------------------------------------------------------------------------------------------------------------------------------f
----------------------------------------------------------XX-------????-----------?--??????--------------------------------------------BB--------------------------------------------------------------f
------------------------------X----------------------????XXX?------------------------------------------------------------------------------------------------------------------------------------------f
-----------------------------XX-------------------------XXXX--------------------------?---------------------------------------XXXXXXXX-----------------------------------------------------------------f
----------------------------XXX------BBBBBBB---------T-XXXXX-------BBB-------------------------------???????-------------------------------------------------------------------------------------------f
m--------------------------XXXX--E--??????----o---E--|XXXXXX-------------??-------E------------------------------------E----E-----X--------------------------E-----------------------------------------X
XXXXXXXXXXXXXXXXXXXXXXXXXXXXXXXXXXXXXXXXXXXXXXXoXXXXX|XXXXXXXXXXXXXXXXXXXXXXXXXXXXXXXXXXXXXXXXXXXXXXXXXXXXXXXXXXXXXXXXXXXXXXXXXXXXXXXXXXXXXXXXXXXXXXXXXXXXXXXXXXXXXXXXXXXXXXXXXXXXXXXXXXXXXXXXXXXXXXXXXX
