X---o---o--B-----------o---o----BB---o--o--------X------o----o-----X----B---X---B---o-------XB------o---o---B---------BB---o---B--------------o-------oB---B----------B-----o------o---B----T----o------
---o-o--oE--X---B-BB----B--B----oB-B---Bo-------ooo-----X-oB---o-oB------o---X-o---X---o---o---o----------?----------------B----X--o---------oB--------------B---Bo-----o-B------o--X-B-----|-------o---
------------------X-----o------X---B----B----------------------------oo--o----o--o-------oB--B-o-----o---o----------XBo--o----o-o---ooX-----o---o---BB-------X-----o--X-----------B-oB----B-|-----------
X--o--X---X---o--X---oB---X-o-----oo-o------B------X----o-B----------B-------oB---oB----------o---------o-------o----B-----B----o-----X-o-------B--------EB---------B--------B---X-----oo---|-o---------
-----------------------o-B---X---o-XX----BBoo--B---B----------o--B----------o---------o-------E-o---X---------B--XBo---X--B-oo--oo--o-o-----X----o----Bo-BX------o-----o---------o-----X----|------X----
-T---o-o---------o-o-BB-o-----?-Bo-o---o----------B------Bo---------------X---o---o---o--o------B--------------------o----oX------B-----oB----B-----o-BoBB------B-BB-oo----o--X---X------o--|--oT---B---
B|-----X--o-----------o-o-B----B-o-BX------o-B---o-----o--BB-o------------o--BX---B-ooX------B--o--o-o--------o--B-----------------o-o------o---B-------o-B------B---B-----------------o----|-o-|-----o-
-|----B--o-----------X----------X---o-B---------o----------oo--------oE------B--B-o----------------------o---XoB-o--B---B-------o---o-B---o-------oB--o----B------o---B-----------X---------|---|------v
B|----X---X--T---o-B-B---o--------X--------B-----Xo-----------B--------o------B-o----o----E-B----------o--Bo---oo-X--X--------------o-o-------?-B--X--Xo-------Xo-o----B-------B-----o------|---|------f
-|--B--------|--X--------o--------------------------XB-----o-o---o----o-----oo----o--X-----B---oB----o-----B------------B----X-----------------B-------oX--B-o-------------o----------------|---|-----Xf
o|------oo---|----------B-o-?--B-o---------B------------B------B---------------o--------oE--BB------B------B-----B--o--BE---B------------------X----------B-----------o-B---o---o-----------|---|---o--f
-|-----X-----|----X-----B---------o-------o---X----------o-o--------------------o-------BX-oo-----------o--BX--------Xoo-B---o-o-o----oo-------------------------------B------------oo------|---|--B-B-f
-|--EoXB---oo|-o-------------o----------o-EX------------------------BX------o--B-o-o---X----------------o-o---T--oBE--X------o-----------X-Mo----B-B--o-o-----------o--o-E---BB-----o------o|---|------f
-|-oX--------|----------o--B--------X---B-----o---------------E--E----B--------B------------oBoB--X------o-X--|----X---X-o----o----T----------------Bo----X-----oo---o-oo-----B----o-------B|---|------f
m|-------B---|----o-B-EX----------o---o---------BE--X----X--o--o---Bo-o---------------BX-------------X--Bo-X--|-oo--oEoBBEXo--E-BB-|---------------o--oB-E--------E--E---------------o---E--|-Eo|-------
XXXXXXXXXXXXXXXXXXXXXXXXXXXXXXXXXXXXXXXXXXXXXXXXXXXXXXXXXXXXXXXXXXXXXXXXXXXXXXXXXXXXXXXXXXXXXXXXXXXXXXXXXXXXXXXXXXXXXXXXXXXXXXXXXXXXXXXXXXXXXXXXXXXXXXXXXXXXXXXXXXXXXXXXXXXXXXXXXXXXXXXXXXXXXXXXXXXXXXXX
