--------------------------------------------------------------------------------------------------------------------------------------------------------------------------------------------------------
--------------------------------------------------------------------------------------------------------------------------------------------------------------------------------------------------------
--------------------------------------------------------------------------------------------------------------------------------------------------------------------------------------------------------
---------------------------------------------------------------------------------------------------BBBBBBB----------------------------------------------------XXXXXXXX--------------------o------BB-----
-------------------------------------------------------------------------XXXXXXXX-----------------------------------------------------------------------------------------------------------------------
---------------------------------------------------------------------------------------------------------------------------------------------------------------------------------------------B----------
--??????------------------------------------------------BBBBBBB?-------------------------------------------------------------------------------------------XXXXXXX--------------------------------------
-------------------------------------------------------------------------------------------------------------------------------------------------------------------------------------------------------v
-------------------------------------------------------------------------------------------------------------------------------------------------------------------------------------------------------f
----------------------------------XXXX------------------------------------------???-------------------------------------------------------------------------------------------------------------o------f
---------------------------------------------------???????---------------------------------------------------------------------------------------------------------------------------------------------f
--XXXXXX----------------------------------------------------------------???------------------X-------------------------------------------------------------------------------------------------------??f
---------------------------------------------------------X----------------------------------XX--------------------BB-------------------------------------------------------------X--------------T------f
-------------------------------------------------------------------------------------------XXX-----------------------------------------------------------------------------------XXT------------|-XXX--f
m-------------------------------X-----------------------------o----------------????-------XXXX-----------------------------------------------------------------------------------XX|------------|------X
XXXXXXXXXXXXXXXXXXXXXXXXXXXXXXXXXXXXXXXXXXXXXXXXXXXXXXXXXXXXXXXXXXXXXXXXXXXXXXXXXXXXXXXXXXXXXXXXXXXXXXXXXXXXXXXXXXXXXXXXXXXXXXXXXXXXXXXXXXXXXXXXXXXXXXXXXXXXXXXXXXXXXXXXXXXXXXXXXXX|XXXXX?XXXXXX|-XXXXXX
