----------------------------------------------------------------------------------------------------------------------------X--M--X---B------------------XX-B---??o?BB??M-X-X---B-B--M--B-B-X-----------
--------------------------------------------------------------------------X----------------------------B--------B------------X--XBXXX-----------BXXX---B?----B-------?---XX-------X-B---Xo-------BBBX---
-------------------------------------------------------------------------------------------------------B--------------------------BB--B--X--o---B--B---XM---X--B--------B-----------XXBBB----X--B-------
----------------------------------------------------------------------------------------------------------------X-----------------X-----????--T------------XX-BBBBX--Bo-XB-----B--X-------------------X-
-X---------------------------------------------------------------------------------------------------------XB---------------B---B----BBBBBBBBB|---------X--TBTBBB-oMX????--T-X--BMMXX--X-XX-X-X--XX---X-
-----------------------------------------------------------------------------------------------------------------BB----------X-B---MXB---X----|-M---X---BB-|-|BoB-BT------?|XX--B--X?XXXXXXTTXMXXX?-B-X-
--------------------------------------------------------------------------------------------------------------X---B-----------B---------------|-B-----o----|-|---oB|---X---|XX--X?-BoXXX--X||XXXXTo---X-
---------------------------------------------------------------------------------------------------B---------------------------X--BB--BX--M---|---BT-------|-|--BBX|---MB-X|XXX-B--BXXXXXXX||XXXX|XXX-Xv
------------------------------XXXX-----------------------------------------------------------------------------------------T---X-----o-XX-----|---B|-XoT-B-|X|X-B--|X--T-XX|XX-XBB-XXXTXXXX||XXXX|--XXXf
------------------------------------------------------------------------------B------------------T----------------XXXX-----|---B-------XXX-B--|----|BXX|X--|X|--X-X|-T-|XXX|XXoB??XXXX|XXXX||XXXX|--XXXf
---X---------------------------------------------------------------?-----------------------------|-------------------------|---?B------XXXX--B|----|-XX|XX-|X|X?---|X|X|XXX|XXX--XXXTX|XXXX||XXXX|X?XXXf
------------------------------------------------------------------------------------------------B|-----X---------B-X-------|---------TXXXXXXX-|BBBX|-XX|XXX|X|XXTBB|B|X|XXX|TTXTXXXX|X|XXXX||XXXX|XXXXXf
-------------------------------------------------------------------------------------------------|-------------------------|-XBB-B---|-XXXXXX-|-B-X|BXX|XXX|X|XX|--|B|X|XXX|||X|XXTX|X|XXXX||XTXX|XXXXXf
-------------------------------------------------------B-----------------------------------------|-------------------------|---------|BXXXXXXX|---X|-XX|XXX|X|XX|X?|X|X|XXX|||X|XX|X|X|XXXX||X|XX|XXXXXf
m------------------------------------------------------------------------------E----------E------|-----M----------E-------E|-X--B-EXE|XXXXXXXX|---X|-XX|XXX|X|XX|XX|X|X|XXX|||X|XX|X|X|XXXX||X|XX|XXXXXX
XXXXXXXXXXXXXXXXXXXXXXXXXXXXXXXXXXXXXXXXXXXXXXXXXXXXXXXXXXXXXXXXXXXXXXXXXXXXXXXXXXXXXXXXXXXXXXXXX|XXXXXXXXXXXXXXXXXXX-XXXXX|XXXXXXB-B|-XXXXXXX|X--X|XXX|XXX|X|XX|XX|X|X|XXX|||X|XX|X|X|XXXX||X|XX|XXXXXX
