--------------------------------------------------------------------o-----------------------------------------------------------------------------------------------------------------------------------
---------------------------oX---------------------------------X---------------------------------------------------------------------------------------------------------X-------------------------------
--------------------------------------------------------------------------------------------------------------------------------------------------------------------------------------------------------
----------------------------------------------------------X---------------------------------------------------------------------------------------------------------------------------------------------
--------------------------------------------------------------------------------------------------------------------------------------------------------------------------------------------------------
----X---------------------B-------------T---------------------B------o----------------------------------------------------------------------------------------------------------------------------------
----XX--o-------------------------------|---------------------------------------------------------------------------------------------------------------------------------------------------------------
----XXX---------------------------------|-----------------------------------------------------------------------------------------------------------------------------M--------------------------------v
----XXXX--------------------------------|--------------------------------------------------------------------------------------------------------------------------------------------------------------f
----XXXXX-------------------------------|------------X-------------------------------------------------------------------------------------------------------------------------------------------------f
----XXXXXX------------------------------|-------X------------------------------------------------------------------------------------------------------------------------------------------------------f
----XXXXXXX-------------------?---------|---------------------------------------------------------------------------------------------------------------------------------------------------------X----f
----XXXXXXXX----------------------------|------------------------------------------------------------------------------------------------------------------------------------------------------X-------f
----XXXXXXXXX------------------B--------|----------------------------o---------------------------------------------------------------------------------------------------------------------------------f
m---XXXXXXXXXX------------E-------------|------------------B---E---------------------------------------------------------------------------------------------------------------------------------------X
XXXXXXXXXXXXXXXXXXXXXXXXXXX?XXXXXXXXXXXX|XXXXXXXXXXXXXXXXXXXXXXXXXXXXXXXXXXXXXXXXXXXXXXXXXXXXXXXXXXXXXXXXXXXXXXXXXXXXXXXXXXXXXXXXXXXXXXXXXXXXXXXXXXXXXXXXXXXXXXXXXXXXXXXX------------XXXXXXXXXXXXXXXXXXX
