-----------------------o---------------------------------------o--------------------X------o--------------X----X---X-o-----------------------B-----------------------------o--o-------X--B--------------
----------------o--B-------X-------------B------B-------?--B---------o--------------------------o----o----B-----BX----oX------XB-o-------------------X--B-B-----------------oo-------Xo----o--B---------
-o-----o-B---B---------------o---------------------oX---------o----o------B---X-------X------B-----o----B----o------BoX----------o-----------B-Xo--B--o--------E--oo----------------------X-------o-----
----o----------X-BB----------B--o-----B--B-o----------o-B-------B-----X----------B------------------------Xo----E--B-o-------?o-----o-----X------------E-Bo---B-----X----o-------------B----B-----------
-----o----o---------------X-?--------o----X--E-o---X--------o-X----o---X-Bo------B------B---o---X-----------o---oX---------B-----oo------oo---------B----oo----o--B-B--------E----X---o---B-o---------X-
---B--X---------o----B---B------B-----o----------B----X-----------------------------------------B----E------X---B-------o----X---------------------------o-o------B-------o--o-B--------------B---------
---o--------X--o------o--------o-----X------------B--------o--------o-----o----------------------B-X--X-------B----oX-o---------------------o---------o------B---oX----------------oo--------XB-----oB-o
-------------o-----o---o---o--------oo-----------B--o---------B--X-----------------B--o----------B-------o-B----------o----o------------X--------B--B-o---B----B-----X---------o---X-----o-B--o--o----ov
---B----o-----BB--B-B--------o------B------------o--B-------------oo--------------------X--E----o---------?---------o-B---B--o-----B---------------o---B----o---oo--B---o-B---X-------------B-------E--f
------------X-E----------------Xo----XB-----------------B-----o---BXo-----B-Eo-------------MB-------o-X--------ooo-----o-------o--o-B--o-----B-------------B----------o-o-----------X------B------B---Xf
----------------------------------------------------------B-XB--------BB---o-------X--------B------o--B-----o-B-o--------XX------------o--------o---o--X--o------o-------o-o----------------------o----f
--------------B------o----X---o---B-------------------o----B-o--X---Bo--------B---------o---oB---o-o-------o---------------oo--------o--o------------X------o-o--------o-B-------------o-------B-B---o-f
-B--------------------o----o--------------------o--oB-B----------B-----------o-o-o---o--X-----o--oo---o-B-----------BB-----Xo-o-o----X----------E--------------B-----o----------------B-o---------X----f
-----o--------o--oo--o-o-o---------------------------oo---B---------o-------------X---oo--oo-o---------oo----o------------o-----------------oo-------------B--o----------o--B----B-------------o-------f
m-----B---oB----B---------B-----B-------B-Bo-o--------o--ooBB-----o-oo--o--o------------------BBX----B---------o------BoB----B------------------------B----o----o-----------o--o--B---------o-----o--o-X
XXXXXXXXXXXXXXXXXXXXXXXXXXXXXXXXXXXXXXXXXXXXXXXXXXXXXXXXXXXXXXXXXXXXXXXXXXXXXXXXXXXXXXXXXXXXXXXXXXXXXXXXXXXXXXXXXXXXXXXXXXXXXXXXXXXXXXXXXXXXXXXXXXXXXXXXXXXXXXXXXXXXXXXXXXXXXXXXXXXXXXXXXXXXXXXXXXXXXXXX
