-----------------------------o-----------B---------B-----o----------------------------------B---B----------------------------o-------B------o-----o---------------X-B-------------X-------B----BX-----B-
--X---------X-B--------------Xoo-------B-------------------------o----B-------X-----------B--------B------------o-------o-----------o-------o---oo--------X-----o-o-----------oB-----o---X-----BE-------
----E--o----------------X-----------------o------oo--o-----X---o-----o--X-B--Bo----o-----ooB--B-------o-------------B--------Bo---------B----------Bo-------o-------B-B--------------------B---------o--
--------o------oo-----o-----o-------------------------oB------X-----------B---------------X-----------BB--o--oB--B--X-B--B--o--o--------------Bo---------------o-o---o----------o--------X------------o-
----E-o--o-o------o------o------X-------X---BB-------------------Bo------B-X---B-B------o-------o---o--o--------o------B----------o------o-----XB--B-------B-oo--o-o-------o--------o---------X---------
-X------------X?------o-B-X-------------------o---ooo-------ooo---------B----------o-----------B--o------o-------B-------o---o-----------B-B-------o----B-------------B---XB-o--o---------------B-------
--X----------------o------------------oB--X---B--oo--------o----o--------------------o--oX----------Boo---BB---------------------o-B---X--------------oo----------Bo-----B-B-------B-Bo-----o---o---X---
---------------B--B--------B------B---M--o-----o-------B------------------------------o--B--B---B-------------o-B----o-B-B--o----------B-oo--------------------------o------oX------------------B---B--v
-------o----o--B-------BB-o----B---------------oo--o------BB-X--------o----------B----------B-------------o----------o-X-----B-X----------oB---------------oX-------o------o-----XXX---oo-B---B-------Bf
-o------B---o-----------o-------o---B---------------------o-------o----------------B--------------B--o--o--------B-oB------------o-B-Bo--B--------E--oB----BB-----B-----B---o----------------B------o-Bf
-------o----ooo-------------B--oo-----o----X----------X--o-----------X-o----oB--o-----oo-----------ooB---o---X---o---------------oo--------------o--B--o--X-----o-B------o--oB-----X---o-oX-------X-o-of
--o-------oo-------o-o---------B----B----X-------------------B---o-oo-----Xo-o-oB---o--o--o---o--XB---B-------------o-------o------o----B-BB-----oo--B-----------o----------BoB------B--------o------o-f
-X------o------o---------X-----------o---XB--------o---X-o--B--BB-------B--o--B-X-B--o-----o-------B--------o-----------o---o---oo-------B--Xo-------B---B---o-X--------o--------o----oBoo----o-----XXXf
----o--------o-------------o---------B-o--?-----------B----o----o-----M-------o-------------BXo-------oo---------o---o----------o-----------------------B--------o---BB-X-o-oBXo---Bo--------------B--Xf
m--B---B--------------------o-------B-o-----o--------oo-B-----E----B-----B--------------------X-----------------------o---------o------B-o--o---XB------Bo----B---------o---------oB-----o--o-B--B-----X
XXXXXXXXXXXXXXXXXXXXXXXXXXXXXXXXXXXXXXXXXXXXXXXXXXXXXXXXXXXXXXXXXXXXXXXXXXXXXXXXXXXXXXXXXXXXXXXXXXXXXXXXXXXXXXXXXXXXXXXXXXXXXXXXXXXXXXXXXXXXXXXXXXXXXXXXXXXXXXXXXXXXXXXXXXXXXXXXXXXXXXXXXXXXXXXXXXXXXXXX
