-----------------------------------------X--------------------------------------------------------------------------------------------X-----------------------------B-----------B--------B--------------
--------------------------------------------------------------------------------------------------B-------------------M----M--X-X----o----?---BX----------------B-----------X-----X---------------------
----------------------------------------------------------------------------B----------------X------X--------------------------------X-------X------?------X-----X----?--B---------X-B--X---------------
-------------------------------------------------------------------------------------------------------------------o------T-B--B----o?--X-----B------------------------------------------------X--------
------B-----------------------------------------------------------------------------------------------------------------X-|B-BBT---BB----X--X-----X?????X??--?--------T-----T-----X-----B-------------B-
-----M-----------------------------------------------------------B---------------X-------------------------------------XX-|B-T-|---X-B----------X---------T-------XX--|--?--|-X-------------------------
-----------------------------------------o----------------------------------------oB--T----B-------------------B----B-XXX-|--|-|---------------BBB---B----|----------B|----B|-XX-BB------------------X--
--------------------------------------------------------------------------------------|---------X-------------X?---B-XXXX-|--|-|----?---B-X-T--X---XBXXXXB|----------?|-----|-XXX-------B--------------v
--------------------------------------------------------------------------------------|--BB-------------B--X-------XXXXXX-|--|-|--B--B------|BXX----------|-X---------|---X-|-XXXX--------------T----B-f
----------------------------------------------------------------------------------B---|-----B--------------XX------XXXXXX-|--|-|------------|XXX------T--T|--B-T----T-|---BB|-XXXXXX??????------|------f
--------------------------------------------------------------------------------------|---------X-----BT---XXX----XXXXXXX-|X-|-|---BB-XB----|XXX-T----|--||----|----|-|-----|-XXXXXXXX----------|--X---f
--------------------------------------------------------------------------------T-----|-------------B-X|-??XXXX?-XXXXXXXX-|XX|-|-----------X|XXXX|----|X-||-B--|----|-|-----|-XXXXXXXX-BB-------|------f
------------------X-------------------------------------------------------------|-----|----------------|---XXXXXXXXXXXXXX-|XX|B|----B--X-XXX|TXX-|B--X|X-||XX--|X---|o|-----|-XXXXXXXXX--B------|------f
--------------------------------------------------------------------------------|-----|---------o------|---XXXXXXXXXXXXXX-|XX|X|-T---oXXXXXX||XX-|--BX|X-||-XXX|XX--|X|--X--|-XXXXXXXXXX--------|B-----f
m----E------------------------------------E-------------------------------------|-----|----------------|---XXXXXXXXXXXXXX-|XX|X|-|---XXXXXXX||XX-|--XX|XE||-XXX|XXX-|-|-XX--|-XXXXXXXXXXX------B|B----EX
XXXXXXXX----XXXX------XXXXXXXXXXXXXXXXXXXXXXXXXXXXXXXXXXXXXXXXXXXXXXXXXXXXXXXXXX|XXXXX|XXXXXXXXXXXXXXXX|XXXXXXXXXXXXXXXXX-|XX|X|X|X-XXXXXXXX||XX-|XXXX|XB||XXXX|XXXX|X|XXXXX|BXXXXXXXXXXXXXXXXXX|XX--XXX
