----------------------------------------------------------------------------------------------------------B----------BX-------BBBB-----------XB--BBBBBXXoXXX--X-X----B-------oX-----o-------------------
--------------------------------------------------------------------------------------------o---------B-M-----BBBBB---Bo-B---X-B-----X-B-B-B-BB-X-Bo---B-X-----B----XXBXXXX--------XX----B---------X----
-----------------------------------------------------------------------------------------B----X-BB-----X---?B--?--------Xo---X--B---X-----BM--?B--B----X----B--B-B-BB-B-X-XB-XXXBXXX-X?XXXXX-??M???---B-
-------------------------------------------------------------------------------------------T--B------------------X----T---BM-----oB?-----X----------T-----BBBBXBXXX?XX---X-X------?---X-BBBBBBBBXBX--B--
----------------------------------------------X------------------M-------------------------|------------XXXXXXXXX-----|----XX--X--XB---------XB-X-XX|---T--B-oB----X--XT----B---B-TB---X----X---X--XX---
----------------------------B-------------------------------------------B-M----------------|---B--XX-M----XX------B-TB|X--X---BB-----T-BBXXXBMM-XX--|---|T-XXXX---B--XX|--?X-BB--X|X--?M---XXT??B-XXTT--
-------------------------------------------------------------X------------X-----T---B------|---X----M-oB-XXX------BX|M|--B---TTXB---X|---XXX--XXXBTX|---||------T---XXX|---XX----X|XX-XX--XXX|--oXXX||--
--------------------------------------------------------------------------T-----|--------T-|-----B--B-T-XXXX-B-BB-X-|B|-BB---||-----X|XTBTXXXBXXX-|T|BXX||-X-T--|--XXXX|---XXXBBBX|XXXXXXXXXX|--XXXX||?v
----------------------------------------------------------B------------B--|-B---|--------|B|-X--?----X|XXXXX-----XXX|?|XBB---||----BX|X|X|XXXXXXX-|||XT-||XXX|X-|?XXXXX|XXXXXXX--X|XXXXXXXXXX|BXXXXX||Xf
--------------------------------------------------------------------------|-----|--------|-|----------|XXXXXBXB---XX|-|oT-X-T||-BXo-X|X|X|XXXXXXT?|||X|B||XXX|T-|TXXXXX|XXXXXXXX-X|XXXXXXXXXX|XXXXXX||Xf
--------------------------------------------------------------------------|--o--|--------|-|------TX-X|XXXTXXXX-B-XX|X|-|B--|||--XX-X|X|X|TXXXXX|X|||X|-||TXX||-||XXXXX|XTXXXXXXXX|XXXXXXXXXX|XXXXXX||Xf
---------------------------------------------------------------------?----|--B--|-X------|-|------|-XX|XXT|XXXXXo-XX|X|-|-M-|||--XXXX|X|X||XXXXX|X|||X|X|||XX||X||XXXTX|X|XXXXXXXX|XXXXXXXXXX|XXXXXX||Xf
--------------------------------------------------------------------------|---??|XXX-----|-|--Bo??|XXX|XX||XXXXTX-XX|X|X|--?|||--XXTX|X|X||XTXXX|X|||X|X|||XX||X||XXX|X|X|XXXXXTXX|XTXXXXXXXX|XXXXXX||Xf
---------------------------------------------------------------------X----|-----|-XXX----|X|--B---|XXX|XX||XXXX|TXXX|X|X|---|||-TXT|X|X|X||X|XXX|X|||X|X|||XX||X||XXX|X|X|XXXTX|XX|X|XXXXXXXX|XXXXXX||Xf
m---------------------------------------------------------E---------XX----|--EE-|-XXXXEE-|X|EE-E-X|XXX|XX||XXXX||XXX|X|X|XBB|||-|X||X|X|X||X|XXX|X|||X|X|||XX||X||XXX|X|X|XXX|X|XX|X|XXXXXXXX|XXXXXX||XX
XXXXXXXXXXXXXXXXXXXXXXXXXXXXXXXXXXXXXXXXXXXXXXXX----XXXXXXXXXX-----XXX----|--XXX|XXXXXXXX|X|X--BXX|XXX|XX||XXXX||XXX|X|X|XX?|||B|X||X|X|X||X|XXX|X|||X|X|||XX||X||XXX|X|X|XXX|X|XX|X|XXXXXXXX|XXXXXX||XX
