-------------------o------------------------------------------------------------------------------------------------------------------------------------------------------------------------------------
-----------------------------------------------------------------------------------------------------------------------------------------------------?--------------------------------------------------
----------------------------------------------------------------o---------------------------------------------------------------------------------------------------------------------------------------
--------------------------------------------------------------------------------------------------------------------------------------------------------------------------------------------------------
------------------?--------------------------------------------------------------------------------------------------------------------------------------------------------------o--------X-------------
----------------------------------------------------------------------??????-------------------------------------------------------------------------------------------------------------XX----------T--
----------------------------------------------------------------------------------------------------------------------------------------------------------------------------------------XXX----------|--
------------------X------------------------?-------------------------------------------------------------------------------------------------------------------------------------------XXXX----------|-v
-----------------XX------------------------------------------------------------------------------------------X------------------------------------------------------------------------XXXXX--------XX|Xf
----------------XXX-----------------------------------------------------------------------------------X------------------------------------------------------------------------------XXXXXX----------|-f
---------------XXXX--------------------------------B-------------------------------------------------XX-----------------------------------------------------------------------------XXXXXXX----------|-f
--------------XXXXX-----------------------------------------------------------------X---------------XXX----------------------------------------------------------------------------XXXXXXXX----------|-f
-------------XXXXXX-----------------------------------------------------------------XX-------------XXXX-----------------------------------------------------M---------------------XXXXXXXXX----------|-f
------------XXXXXXX-----------------------------------------------------------------XXX-----------XXXXX--------------------------------------------------------------T-----------XXXXXXXXXX----------|-f
m----------XXXXXXXX-----------------------------------------------------------------XXXX---------XXXXXX------------------------E-------------------------------------|----------XXXXXXXXXXX----------|-X
XXXXXXXXXXXXXXXXXXXXXXXXXXXXX-------XXXXXXXXXBBBB--XXXXXXXXXXXXXXXXXXXXXXXXXXXXXXXXXXXXXXXXXXXXXXXXXXXXXXXXXXXXXXXXXX----XXXXXXXXXXXXXXXXXXXXXXXXXXXXXXXXXXXXXXXXXXXX|XXXXX----XXXXXXXXXXXX-XXXXXXXXX|XX
