--------------o--o------o---o--o---------o-------BX-------oB-B--o----oo-X-B-------------------o--B--------B-B--o------B--o--Bo-B--B-B--B-o--B-------o-o--B-------ooo-----X---------B---------BB-oX------
------B------------B----B------X-----o----oo----o-o---------------B----BB---o----o---B-X-----------X-Bo---o-o-------o----o---------o-o-T--------B------o-----X--X-o-----o-o----------X---oB----------XB-
-----B-----B---o--------------BB-o-------o------B-BX---B-?-------------------B-------B--B--X-o------B--BXX----------o------o-BoE-X-----|---E----------------------B--B-----------B--------X-----o-----o-
-----B------BoE-o---------------------oB-o----------o----------o-E-B--oo----Bo-B-----------B-o--o---------------------B--------B----o-B|---B---------X--X--ooo----------B-------o---------oo-oB-------oo
--B-----------B---o---o----------T------o-----o------B-B-o--B---oXX----B-o--------o---B-o----------------B------T--o-----o--B----B-B-o-|-o--o-----o-o-----------------------------B---B--o-----------o--
--------BB---------------o-------|---------X----o--------o-o------o-oB--------------------B----B--B----o---B-o--|------------------oBB-|--------o-----------------o------------o-oo---B-BBB-o--o--BB-o--
-----------BB----X-------B-o-o---|-------oo-----E-----Bo-----B------------------------BB--o-ooBoo--o---o---o----|-----o-----o--o-B---o-|--o--o----B-----------------o-----------oo--o-----B---------E---
-----BBo----------oB---o---------|-B---E--------B-------B-T--X--X------o--o--T-B---B-o----o--o--B---------B----B|-o---Bo-oo---oo-------|--o---oo---o--------------o-o----Bo-------------------------Xo-v
----------------------X---o------|----BB--o-X--------X-BEo|---X--------------|-------o--o----------o-----o--Boo-|----------------o---BB|-------X-o--X-BB---B--o-----B-------------------o-o-----B---o--f
----X-------------X-------o--B--X|-Bo----B-XBE--X------X--|---X---------Bo---|-X------o-------oXX----------o--oo|-o---------X-B--o-Boo-|--oB-B-------o------X----o------------------XB--o-B------BX----f
B------X---X---o--BB----o---o--X-|-B---------X---------B--|--------------X---|--B----------------------o--------|-o-o-o-o-o-----oo--o--|-------Xo---B---B----X-------o-oo--?-----BoX-----o------o-----of
-T------------o---oBX------B-----|--o-------B-------------|-o-B------B-B-----|--oo----B--B--o---X-------------oX|------------o---X-----|---B-B---------B--Xo-----------------------o-----o---E---------f
-|-o-----o-B----------B----X---o-|------------------------|--B--BB-o---B-----|---X----o------o-B-o-----------o--|-------------o--------|---o--X-------o--------o-o-------B---------B--o--B---B-B----o--f
-|--oB---------o--o-B------------|--------o--------------B|-o-------o-X-o----|---------------o--------oX-----oB-|----------o-------o---|-o-------o---o--B--o--o-------X---------o-------oB-o-B-----o---f
m|----oo-------B---B--------o---X|-----X--o-o----Bo--o----|--B-E---ooB-------|---X-B-B---------o----E--oE--o--B-|-------EB--E--o-------|------E---oX--------o---E--E-E--o---X-B-----Bo--E------B-----o-X
XXXXXXXXXXXXXXXXXXXXXXXXXXXXXXXXXXXXXXXXXXXXXXXXXXXXXXXXXXXXXXXXXXXXXXXXXXXXXXXXXXXXXXXXXXXXXXXXXXXXXXXXXXXXXXXXXXXXXXXXXXXXXXXXXXXXXXXXXXXXXXXXXXXXXXXXXXXXXXXXXXXXXXXXXXXXXXXXXXXXXXXXXXXXXXXXXXXXXXXX
