--------o---------X-------B--------X-----Bo------o--X---------B--------B------o-----------------------B-------B-o---o----o-----o--------------------B------------o---o---B-----------X---------------B--
----X---------------------o----------------BB----o-------------o------------B-----?------B------o---------o------o-o---------------------o------B-------o-----o-----------o----------X---B------o-X-----
--Bo-----o--B---------B-B--------------------o-----------------B---o----B---o----------o-------------B---B--B------------BE---o-X--------------X----o--oB--------o-----B-------------B------------B-----
----o---oo----o---B-oo------------o--o-o--------B-------------------o-----------o--XB--X----B-o--------B---------------B----------------------------o-B---------BB-B------o-X------?--------o----o---o--
-----------o-o---------B-------o----o----o-B------X--oo--------B---oo-------------B-------------B-----o-E----o-X------X--X--------------------------o----o------------X-------------------B------o----X-
----B---B---X-----o---B----X--o-B--------------o--X--------o-B-----BBo-----o---B-----M---B--o---X-----------------------------?---------B-o--o-------------------------o-------X--B----------o---X--B---
-----B--------------------X---o-------o-----o--oo-----------o----B-ooB-B-Eo-X---------o--X-------B-----B-o---E--------o-----------oB---------BB---------------------------o-X----o---B----o----o-Bo-----
--B-----------o----E--o-o----------------X--------B-----B------B-o-----E------o-X--------------E-----B-------o-BoX-----o----------------------B-o--B-----o--E-B-------o--B---Bo--X--------B-----X---o--v
----o--------------X------B-o-o----E------------------B--------o-------------------oB-----B---------o-BB----------BE-------Xo-----BX-----------------------o---------------X---ooo------o--E----X-o---of
-----B-o---o--Boo----B-------o-------B---------------------o--o---------B--X-----------B-------------o--------o-----------------------X---B--------BB------o----X-----o-o------------------B----Bo-----f
---B-----o----o--o--------------o-------o-----------o-------------o--------B--------B-o---oB---X----B--------X-B-----oo-B---o--o---E--oBoo---------------o-XBo--X--B-oo-------------------------E-----Ef
-------o--------B-------oo----B--X--X-o-B---B------------------B--------X-oo-o---o--o------------------o-o----o-------------------o--B----B----B----BX--------o--o-----oB-------B---E----B------oo--o--f
----------BB-----B-------B------------o-B------------o----B-o--o-----------X-o---X-X---o----o--B-------------oo-o--B---B--------B------Bo------B------------X---------o--------B----B---------o-o-----of
-B--o------B--o----B?----------------BEo-o-------o---------o---B----------------------o-----o--o-X-------o--oX------o-----X-------BB-------B---o--o-----B-------------------X--oE-----------o------o---f
mX------o--oo-------------X------B-EoX--o---o-X-B---------------o--B------------------B-B------------BX-------------oX-------o-----------B-----------X-X-B-o-o--------o-X-E--ooXo------oX-B-B-----o-----
XXXXXXXXXXXXXXXXXXXXXXXXXXXXXXXXXXXXXXXXXXXXXXXXXXXXXXXXXXXXXXXXXXXXXXXXXXXXXXXXXXXXXXXXXXXXXXXXXXXXXXXXXXXXXXXXXXXXXXXXXXXXXXXXXXXXXXXXXXXXXXXXXXXXXXXXXXXXXXXXXXXXXXXXXXXXXXXXXXXXXXXXXXXXXXXXXXXXXXXX
