-----------------------------------------------------M-----------------------------B---------M----------------------------------------------------------------------------------------------------------
--------------------------------------------------------------------------------------------------------------------------------------------------------------------------------------------------------
-------------M------------------------------------------------------------------------------------------------------------------------------------------------------------------------------------------
------------------T--o-------------------------------------------------?-T---------------------o---------------------------????-------------------------------------------------------------------------
------------------|------------------------------------------------------|------------------------------------------------------------------------------------------------------------------------------
-----------?------|--------------T-------------------------------X------X|----------------------M-------------------------------------------------------------------------------------------------------
------------B-----|--------------|----------------------------------T---X|------------------------------------------------------------------------------------------------------------------------------
------------------|-X------------|----------------------------------|---X|X----------------T-----------------------------------------------------------------T---------------------------------------T-v
---------X--------|-XX-----------|----------------------------------|---X|XX-------------??|?X?--------------------------------------------------------------|--------------------------------------X|-f
----T---XXXX------|-XXX----------|----------------------------------|---X|XXX-----------X--|XX---------------------------------------------------------------|-------------------------------------XX|-f
----|?---XXX------|-XXXX---------|----------------------------------|---X|XXXX-------T--XXo|XX--T------------------------------------------------------------|------------------------------------XXX|-f
----|----XXXX-----|-XXXXX--------|---------------------------o------|---X|XXXXX----TB|-oXXX|XX--|------------------------------------------------------------|-----------------------------------XXXX|-f
----|----XXXXX----|-XXXXXX-------|----------------------------o-----|---X|XXXXXX---|-|--XXX|XT--|------------------------------------------------------------|----------------------------------XXXXX|-f
----|----XXXXXX---|-XXXXXXX------|-----------X----------------------|---X|XXXXXXT-X|X|--XXX|X|--|------------------------------------------------------------|---------------------------------XXXXXX|-f
m---|----XXXXXXX--|-XXXXXXXX-----|----X-E-B--XX---------------------|--XX|XXXXXX|XX|-|EXXXX|X|--|X-----------------------------------------------------------|--------------------------------XXXXXXX|-X
XXXX|XXXXXXXXXXXX-|-XXXXXXXXXXXXX|XXXXXXXXXXXXXXXXXXXXXXXXXXXXXXXXXX|---X|XXXXXX|XX|-|XXXXX|X|XX|XXXXXXXXXXXXXXXXXXXXXXXXXXXXXXXXXXXXXXXXXXXXXXXXXXXXXXXXXXXX|XXXXXXXXXXXXXXXXXXXXXXXXXXXXXXXXXXXXXXX|XX
