-----------------------------------------------------------------------------------------XXXXXX------------?X??----------o?--M--?X???????X--?--?----B---------------------------------------------------
---------------------------------------------------------B----------o--B----------------?----------------------?----XBo--B-----M--B-o------B-------o----------------------------------------------------
-----------------------------------------------------------------o--------B-----------XXXXXXX--------B-o-------XooXXXX---o-----B----BMBB-----o----------------------------------------------------------
--------------------------------------------------------------T----------T--T-------------B----o----B------------T-T-o------T---BTBTBBBTMo--oXXX--MX?------------------------------------------------??-
--------------------------------------------------------------|----------|--|----T---T-------T----?-----T-BBBBBB-|-|T-TX----|--T-|-|BoM|-TM--?XTBTBoB-M-------------------------------------------------
---------------------------?----------------------------------|----------|--|X--?|---|o-?----|-----T--X-|--X?----|T||?|XTT-?|--|X|X|???|X|---XX|-|X--------------------------------------------------o--
--------------------------------------------------------------|----------|--|XX--|---|---BBB?|o?---|-oTX|MXT--M-o||||T|X||TX|--|-|X|BBB|X|XXXXX|o|XX??B-o-----------------------------------------------
--------------------------------------------------------------|----------|--|XXX-|---|-------|-----|??|X|XX|M--T-||||||X|||X|--|T|X|X-T|T|XTXXX|X|XX---------------------------------------------------v
--------------------------------T---------------o-------------|---------X|-X|XXXX|---|-------|---X-|-X|X|XX|-B-|-||||||X|||T|XT|||X|XX||||X|XXX|X|XXT--??????------------------------------------------f
--------------------------------|-----------------------------|--M-----XX|-X|XXXX|BB-|----X?-|BoBXX|TX|X|XT|--T|?||||||X|||||X||||X|XX||||X|XXX|X|XT|X-------------------------------------------------f
------T-------------------------|-----------------------------|-------XXX|XX|XXTX|X--|-------|-B-XX||X|X|X||B-||-||||||X|||||X||||X|XX||||X|XXX|X|T||X-------------------------------------------------f
------|T------------------------|-----------------------------|------XXXX|XX|XX|X|XX-|-------|---XX||X|X|X||XX||X||||||X|||||T||||X|XX||||X|XXX|X||||XXX-----------------------------------------------f
------||------------------------|T----------------------------|-----XXXTX|XX|XX|X|XXX|--?o---|---XX||X|X|X||XX||X||||||X||||||||||X|XX||||X|XXX|X||||X-------------------------------------------------f
------||--------BBB-------------||-------X------------------X-|----XXXX|X|XX|XX|X|XXX|----X--|X-oXX||X|X|X||XX||X||||||X||||||||||X|XT||||X|XXX|X||||X-------------------------------------------------f
m-----||------------------------||??????XX-------------????XXE|---XXXXX|X|XX|XX|X|XXX|X--XX--|X-XXX||X|X|X||XX||X||||||X||||||||||X|X|||||X|XXX|X||||XX-------------------------------------------E----X
XXXXXX||XXXXXXXXXXXXXXXXXXXXXXXX||XXXXXXXXX-----XXXXXX----XXX-|--XXXXXX|X|XX|XX|X|XXX|XXXXXXX|XXXXX||X|X|X||XX||X||||||X||||||||||X|X|||||X|XXX|X||||XXX-XXXXXXXXXXXXXXXXXXXXXXXXXXXXXXXXXXXXXX-------XX
