-------X---------------------------------------------------------------------------------XXXXXX-------------X---BB-------o?--M--?XXXXXXX-X--------------------------------------------------------------
---------------------------------------------------------B-----------------------------------------------------?----X-o--B-o---M------------------------------------------------------o--------------X--
--------------------------------------------------------------------------B--------------------------B-o-------XooXXXX---o--?------oBBBB------o--------------------------------------------------B------
-----------------------------------------------------------------------------------M------------------------------oT-oT-----T-----------Mo--oXXX------------------------------------------------X-------
----------T------------------------------------------------------------------------------??--T---------o---o-------|T-|o----|-BT---T--M--X----X----------------------------------------------M---T----B-
----------|----------------------------------------------------------------------------------|--------X-----------T||?|-TT--|--|X-X|-X--XX---XX---------------------------------B----------------|-X-oB-
----------|-------------------------------------------------------------o--------------------|--------XX---TX-M-oT|||T|-||T-|--|-XX|XX-XXXXXXXXBBXBBBBB---------------------------------o--------|----X-
---X------|----------------------------------------------------------------------------------|--------XXX--|XXTT-||||||X|||-|--|TXX|XXTXTXXXXXXXXX-----------------------------------------------|----Xv
---XX-----|-------------------------------------o--------T-----------T-----------------------|----BBBBXXXX-|--||-||||||X|||T|--||XX|XX|X|XXXXXXXXX--------------------------------------BB-------|X---Xf
---XXX----|----------------------------------------------|-----------|-----------------------|--------XXXXX|--||-||||||X|||||-X||XX|XX|X|TXXXXXXXX-----------------------------------------------|XX--Xf
---XXXX---|----------------------------------------------|-----------|-----------------------|--------XXXXX|B-||-||||||X|||||XX||XX|XX|X||XXXXXXXXX------------------------------------------T---|XXX-Xf
---XXXXX--|----------------------------------------------|-----------|-----------------------|--------XXXXX|XX||-||||||X|||||XX||XX|XX|X||XXXXXXXXXX-----------------------------------------|X--|XXXXXf
---XXXXXX-|----------------------------------------------|-----------|-----------------------|--------XXXXX|XX||-||||||T|||||XX||XX|XX|X||XXXXXXXXXXX--X--------------------------------o----|XX-|XXXXXf
---XXXXXXX|------------------------------X---------------|-----------|------------XXXXXXXX---|--o-----XXXXX|XX||o||||||||||||XX||XX|XT|X||XXXXXXXXXXXXXX-------------------------------------|XXX|TXXXXf
m--XXXXXXX|-----------------------------XX---------------|-----------|--E-----------XX-------|--------XXXXX|XX||X||||||||||||XX||XX|X||X||XXXXXXXXXXXXXX-----------------------------------E-|XXX||XXXXX
XXXXXXXXXX|XXXXXXXXXXXXXXXXXXXXXXXXXXXXXXXXXXXXXXXXXXXXXX|XXXXXXXXXXX|XXXXXXXXXX---XXX-------|XXXXXXXXXXXXX|XX||X||||||||||||XX||XX|X||X||XXXXXXXXXXXXXXXXXXXXXXXXXXXXXXXXXXXXXXXXXXXXXXX----|XXX||XXXXX
