--------------B--------B-------?-----------------------M-----------------B---------------------------------------------------------------------------------------------------------------------------B--
-------------------------------------------------------------------------------------------------------------------------------------------------------------------------------B------------------------
-------------------------------o-------------------------------------------------------------------------------------------------------------------------------------------------------------X----------
-----------------------------------------------------------------------X--------------------------------------------------------------------------------------------------------------------------------
----------------------------------------------------------X----------------------------------------------------------------------------------------------------------------------------------???????----
--------------------------------------------------------------------------------------------------------------------------------------------------------------------------------------------------------
--------------------------------------------------------------------------------------------------------------------------------------------------------------------------------------------------------
-----------------------------------------------------------------T-------------------------------------------------------------------------------------------------------------------------------------v
-------------------------------------------------X---------------|-------------------------------------------------------------------------------------------------------------------------------------f
-------------------------B----T----------------------------------|----------------------------------------------------------------------------------------------------------------------o-------------Bf
-----------------X--T---------|---T------------------------------|---------------X---------------------------------------------------------------------------------------------------------------------f
-----------------XX-|---------|---|----B-------------------------|---------------XX-------------------------------------------------------------------------------------------B------------------------f
-----------------XXX|---------|---|------------------------------|----o------T---XXX-------------------------------------------------------------------------------------------------------------------f
-----------------XXX|---------|---|--------------B---------------|-----------|---XXXX------------------------------------------------------------------------------------------------------------------f
m------------E---XXX|X--------|--X|---E-E-EE------------E---EX---|-----------|---XXXXX--------------------------------------------------------------------------------------------------E--------------X
XXXXXXXXXB-X--X-XXXX|XXXXX-XXX|XXX|XXXXXXXXXXXXXXXXXXXXXXXXXXXXXX|XXXXXXXXXXX|XXXXXXXXXXXXXXXXXXXXXXXXXXXXXXXXXXXXXXXXXXXXXXXXXXXXXXXXXXXXXXXXXXXXXXXXXXXXXXXXXXXXXXXXXXXXXXXXXXXXXXXXXXXXXXXXBXXXXXXXXX
