-------?X------------------------------------------------------------------------------B--------------B----X---o-o--------B-------B------X-X-o---------------XMBXXXXX------------------M--X---BBB-------
---------------------------------------------------------------------------------------------------------------o------B--B-----------------X--------o---o---oX------o-X------------------------BX-------
-------------------------------------------------------------------------------------------------------M---------------------B-X-X------XBX-----BBBBB-X-----Xo-----B--X---------X-----------------------
----X---------------------------------------------------------------------------------------------------------------------------B-o-----?-Xo-T-X-X--T---BBBBB----------BB-B------X----------------------
----------------------------------------------------------------------------------------------------------Bo-------o-----X-X--?M---o?--------|----T-|---------o------X-----X----------------------------
-----------------------------------------------------------------------------------------------------------------????-----X----XBB--------B?B|o-X-|-|--M-T-----X-B-BB-------T-B----------------B--------
-------------------------------------------------------------------------------------------------------------X-T--o-------XX?--XX---X--T---B-|-BB-|-|M-BX|----XX--XXXXX--XXB|----XXXX---oBB-B-----------
----------------------------------------------------------------------------------------------------BBBBB-B----|----------XXXX?XXX-XB--|--BXo|B-BX|B|BB--|--oXXX----XX--XXX?|--------B------oX---o?----v
------------------------------------------------------------------------------------------------------o--B-----|X---BX--B-XXXX-XXXXX---|---XX|T-BX|-|-o--|T-XXXX---XXX--XXXX|-----BBBBBBBB---XX--X-----f
--------------------------------------------------------------------------------------------------------------T|----XX--o-XXXXXXXXXX?X-|---XX||--X|X|----||XXXXX--XXXX-XXXXX|-X--------------XXX-----XXf
------B----------------------------------------------------------------------------------------------------B-T||---XXX----XXXXXXXXXTXXX|B-TXX||-TX|X|-X--||XXXXX-XXXXXXXXXXX|XXX-------------XXXX-----Xf
------------------------------------------------------------------------------------------------T--X-TX--T---|||--XXXX--X-XXXXXXXXX|XXX|-B|XX||X|X|X|XXXX||XTXXXXXXXXXXXXXXX|XXXX-B-----o---XXXXXXXX---f
------------------------------------------------------------------------------------------------|--XX|XX-|---|||-XXXXX----XXXTXXXXX|XXX|X-|XX||X|X|X|XX-X||X|XXXXXXXXXXXXXXX|XXXXX----XXXXXXXXXXXXX----f
------------------------------------------------------------------------------------------------|--XX|XXX|---|||XXXXXX---BXXX|XXXXX|XXX|XX|XT||X|X|X|XXXX||X|XXXXXXXXXXXXXXX|XXXXXX------X---XXXXXXX---f
m--E----------------------------------------------------------------------------------E-----E---|--XX|XXX|E--|||XXXXXXBBBoXXX|XXXXX|XXX|XX|X|||X|X|X|XXXX||X|XXXXXXXXXXXXXXX|XXXXXXX--EEXXE--XXXXXXXX--X
XXXXXXXXXXXXXXXXXXXXXXXXXXXXXXXXXXXXXXXXXXXXXXXXXXXXXXXXXXXXXXXXXXXXXXXXXXXXXXXXXXXXXXXXXXXXXXXX|XXXX|XXX|XXo|||XXXXXXX---XXX|XXXXX|XXX|XX|X|||X|X|X|XXXX||X|XXXXXXXXXXXXXXX|XXXXXXXXXXXXXXXXXXXXXXXXXXX
