-BBXXXX-------------------------------------------------------------------------------------------------------------------------------------------------------------------------------------------------
---------------------------------------------------------------------------------------------------------------?????------------------------------------------------------------------------------------
-----------------------------------------------------------------------------------------------------------------------------------------------------------------o--------------------X---------------X-
-BBBBBBB-------------------------------------------------------------X-----------------------------X--------B-------------------??????------------------------------------------------------------------
------------------------------------------------------------???????---------------------------------------------------------------------XXXXXXXX---------------------------------------BBBB-------------
-----------------------------------------------XXX------------------------------------------------------------------------------------------------------------------------------------------------XXX---
---------------------------????-------------------------------------------------------------------------------------------------------------------------------------------------------------------------
---????XXX----------------------------------------------??M?????----?-------------o--------------------X--------------------------------------------------------????-----------------------------------v
----X------------------------------o-----------------------o--------------------------------o----------------------------------------------------------------------------------------------------------f
-----------------------------------------------------BBBBBXXXX-X--------------------XXXXX--------------------------------------------------------------------------------------------------------------f
--------BB????????--------------------------------------------XX----------??????????-------------o-----------------------------------------------------------------------------------------------------f
----------------------B--------------------------------------XXX-------------BB---T---------------------------------------------------------------------------------------------------X----------------f
---T--------BBBBBBB-----------------------------------------XXXX------------------|-------B---------------------------------------------------------X----------------------XX--------XX----------------f
---|---------------------------B---------------------------XXXXX------------------|-----?---------------X-------------------------------------------XX------------------------------XXX----------------f
m-E|-----------------BB---------------o------------------XXXXXXX-------------E---E|--------------------XX-------------------------------------------XXXBB--------------------------XXXX----------------X
XXX|XXXX--XXXXXXXXXXXXXXXXXXXXX?XXXXXXXXXXXXXXXXXXXXXXXXXXXXXXXXXXXXXX--XXXXXX----|XXXXXXXXXXXXXXXXXXXXXXXXXXXXXXXXXXXXXXXXXXXXXXXXXXXXX------XXXXXXXXXXXXXXXXXXXXXXXXXXXXXXXXXXXXXXXXXXXXXXXXXXXXXXXXXX
