-----------------X-----------B-------------------------------------------------------------------------------------------------------------X-----------------------------------------------------B------
--------------------------------------------------------------------------------------------------------------------------------------------------------------------------------------------------------
--------------X---------------------------B--------------------------------------------------------------------------------------------------B--------B-------------------------------------------------
--------------------------------------------------------------------------------------------------------------------------------------------------------------------------------------------------------
-----------------------------------------------------------------------------------------------------------------------------B--------------------------------------------------------------------------
--?-----------------------------------------------------------------------------------------------------------------------------------------------------------------------------------------------------
---------------------------------------------------------------------------------------------------------------------------------X---------------X------------------------------------------------------
-------------------------------------------------------------------------------------------------------------------------------------o----------XX-----------------------------------------------------v
------------------------B------------------------------------------------------------------------------------------------------?----X----------XXX-----------------------------------------------------f
-------------------------------------------------------------------------------------------------------------------------------------X--------XXXX-----------------------------------------------------f
------------------------------X---------------------------------------------------------------------------------------------B------?---B-----XXXXX-----------------------------------------------------f
--XXXXXXXX----------------------------------------------------------------------------------------------------------------------------------XXXXXX-----------------------------------------------------f
---XX------------------------------------------------------------------------------------------------------------------------------B-------XXXXXXX-----------------------------------------------------f
---XXX----------------------------------------------------------------------------------------------------------------------B---------X--BXXXXXXXX-----------------------------------------------------f
m--XXXX---------------?--B--------------------------------------------------------------------------------------------------------oB-----XXXXXXXXX-----------------------------------------------------X
XX-XXXXX-XXXXXXXXXXXXXXXXXXXXXXXXXXXXXXXXXXXXXXXXXXXXXXXXXXXXXXXXXXXXXXXXXXXXXXXXXXXXXXXXXXXXXXXXXXXXXXXXXXXXXXXXXXXXXXXXXXXXX------B-XXXXXXXXXXXX------XXXXXXXXXXXXXXXXXXXXXXXXXXXXXXXXXXXXXXXXXXXXXXXX
