-B----B--B----XBoo------------B------o---o---?o---o------------------ooB-------B--?---B---o---B---------------------------o-oo--o-o-----B---o--B--X--------o---o-o----o--o-o--X-o-----Xo---B------------
-oo---X------X-----------B------o-------------X------oo---------BoB------B---BB-----o-B---------------B---------o-----E----BB-B-----T---------XBX-ooo----B--------------------o--o-B--E-----o-o---------
---o-------B---------o---o-o--oB--X----o-----o-B----B----o---o?------o---X-BoB---------------------Xo-X-----------o---B----B--B-----|-----B---?---------B-------o-o-----X--------X----XB-----o----------
-------------B--------Bo---------X--------Xoo------X---T------------X------------T--o-----X-------oooX-----B---o-----X--o----oB-----|-------o-----------o-----o----o-------------X---X---o-?---o-----B--
-B----------------------------------o--B--o-B--------B-|--------B----o---------o-|-------B--------o------------X-o-----------E------|----o-o-----------B----B---------o-------oo---B---------X----------
---oo----------B------B---Xo--B---o-B----B-o----o------|-o-E------------------o-o|--o----Bo---o-----o----E-oo--------------o-Boo---B|-oX----oB----oo-X------E-----BB--------oBB--o-B--------o---B----o--
B-oB----o-o------------o----X---------ooX-B----o-o-B---|---B-B---------o-------?-|-o--B----B--B--X-------B----------X---------Bo--o-|-Eo-----B---oB--------oB---oB-----o---X-o------X---oo--------o-----
---o----X-----o--B----Boo--------------------o------o--|--B----o-----B-----o-----|----X-----X-XBB---------------B---o-----Bo--BoX---|-X--BXEoB---BBo--o-------o-B-----B---B--X---BB-----o-----------B--v
o--------o-o--B--B----------o--B-o--------------o----oo|--o-oo-B-X-----------B---|-X----------X------X-----B-----o-B------B---------|---B--B-----------------BBo--oo-----BBXo---o----------------------f
--X----B----o----B------XB------B--oo----E-XB------X---|-----X----B----B-------X-|---X-----Bo--o----------------B----?---B-o----E---|----BXoXo--o--XooX-oo-------o--Bo------o------B-----B------XBBo---f
-------o-B----X--------o---o-oo---B------B-Bo----------|--------------B-o--------|-o-B-oX-o--------------o----Bo-------BB--o----BX--|--o------------B----------------B---o------B---B---------?-B---oo-f
----B--------------o---------o--o--------?oo-----------|-----B------o---B-------o|-B----------o--o------B--oBB------o----o-o----o-BB|----o-o-B-----T--BXT----B-----B--B-----------------------------B--f
---o------B--X--BX--Bo---Bo-------B---o-o-o------------|---oo-o--X-----------?-o-|----oo-X-B-B---B----------o---XBo--o--------------|-----o--------|--o-|------o-o---------B---------X--B--o-----o-----f
---------B--o---oB---B--------------B--o-X---Bo--------|------o---B--------------|-----------------o-----X-----B--o---o-o-------o?--|--X---T-----?-|----|-X----Bo----X----------B-B-------Boo---X----o-f
mB------------o-B---E--X-----------o------------o-o-o--|------------------B----E-|-E--o------X--X---o---o---E---EBE--E--o-oX--------|------|------E|-B-B|--B--o------------EoEoo--EE-BoE-o-E--------o-oX
XXXXXXXXXXXXXXXXXXXXXXXXXXXXXXXXXXXXXXXXXXXXXXXXXXXXXXXXXXXXXXXXXXXXXXXXXXXXXXXXXXXXXXXXXXXXXXXXXXXXXXXXXXXXXXXXXXXXXXXXXXXXXXXXXXXXXXXXXXXXXXXXXXXXXXXXXXXXXXXXXXXXXXXXXXXXXXXXXXXXXXXXXXXXXXXXXXXXXXXX
