----------------------------------------------------------------------------------------BB--?????------------XXXXXXXX--------------------?--------------------------------------------------------------
----o--------------------------------------------------------------------------------------------------????????--BB--------------XXXXXXX----------------------------------------------------------------
----------------------------------------------------------------------------------------------------------------------------BBBBB-----------------------------------------------------------------------
-------------------------------------------------------------------------------------------------------------XXXXXXX---------------------????-------------------------------------------------------XXX-
-------------------------------------------------------------------------------------------------??-----------------------------BB----------------------------------------------------------------------
-------------------------------------------------------------------------------------------------------------------??-----BBBB-------------------o--o---------------------------------------------------
-------------------------------------BBBBB---------------------------------------------------------------------------XXXX-------o-----------------------------------------------------------------------
--------BBBBBBBB-------------------XXXX-------------------------------------------------------???????----------??--------------------------------------------------------------------------------------v
-------------------------------------------------------------------------------------------------------------M--B---------?--------X-?????-------------------------------------------------------------f
-------------------------------------------------------------------------------------------------------------------------XXXXX--------------------------------XXXXXXXX-------------------????????------f
---------------------------------------------------------------------------------------------------------------???---------????----------------------X-----------------------------XXXXXXXX------------f
-T--------------------------X------------------------------------------------------------T----------------------------------------------------------XX-------------------------------------------------f
-|-------------------------XX------------------------------------------------------------|-------------------------------------------------BBBBBBB-XXX---------------X--------------------------------Xf
-|------------------------XXX---------------------------------------------------XXXX-----|-----?????----------------------T----------------------XXXXX---------------XX------?????---------------------f
m|-----E-----------------XXXX-----------------X-----E------------------------------------|-------------------------------X|XXXXXX---------------XXXXXX---------------XXX------------E------------------X
X|XXXXXXXXXXXXXXXXXXXXXXXXXXXXXXXXXXXXXXXXXXXXXXXXXXXXXXXXXXXXXXXXXXXXXXXXXXXXXXXXXXXXXXX|XXXXXXXXXXXXXXXXXXXXXXXXXXXXXXXX|XXXXXXXXXXXXXXXXXXXXXXXXXXXXXXXXXXXXXXXXXXXXXXXXXXXXXXXXXXXXXXXXXXXXXXXXXXXXX
