------o--B--o----o---------B-------o----B-------B-------------B-----o-o-o---o-----B---o---oB-----o--X----X--------B----o-B-o-----------X--XB-B-Bo---o-----o-EB---XB-B-----oB---o--BX----B---------------
B----XXo-X------o-----BX-o-B-----BoB-------o-o----B-------o-------BB------B------o-B--------------B-------------E--o-----o------------o--X------------------X-------------o----o-BB---B------o--o---o---
------B-B-----o-o---BoB------------B---X-B-o-------o----oB-----o---o-oB----------o------o-------Bo-E-------oo---X----X-----o-----o--X-----o-----o--------X-o-----o---o--o--T--------B-B----------B------
--o----o----B-------o-o-----------------oo---------X-------o---E-------ooX--------------X--------B-X--o--o----B----B--------------o-oB---B--X-------o--o--ooXB-------------|-X--B-------o-o--B--oX-----o
------B-------------oB--B---BB-o---B--------------o-B---------BBB---?---o--oB----------oo-o-----X---------?-XB--B-----oo--------------T------B---B-----o----B-o-B-------Bo-|--------?B-oBo--------------
-o---E------B------o--B-oo--o------o--o---------------BB--o---o----B-----------o-------B----oB-oo------------------X-o----o---o--B----|--oo-------------oX-B-------X-o----o|----------oBo-------X----oB-
-o---B---o---B------------E-----------B-B------------o-?-----o----T-----o-o-o----E--B--------Bo---o---B--B-o-----o--------B--B-------B|-----------B---Bo---o------o--oBo--X|-------X-B-------o---B------
-o---o---o-X------ooB-----B----X-oo---B--------o-BB--o--BB--------|------o----oB-B-------------o--------o-o--o----o-----------o-------|--oB-o--X----B------------oo---ooBo-|---B-o---Bo---o-----------ov
o------Bo---o---------B---o----o--o----o-o-----------------------B|-oB-------o---BX-X-E-----BX-Bo--o------------------X-----------o---|------o-X--oB----o--B---------B-----|--B--oo---------B----------f
---------------B--------------------X-o---o----B------------------|----------o--B-----B---o------------o------o-X-B----ooX--------E---|-----oBB-------B--o-o-------X---o---|------B--o------------X-B--f
-oB----B-B------B------------o-o----o----B--o-BE-----------B--X---|---X---X---------oo-X---------------B-----X------?--o----------B---|-----------------------B-o----------|--------oT----oE-----oB----f
-------X----oB--o----B--------o-----X-----B----BB--o------------B-|---o-B?B--o--o------o---oB--o-BB--o-------------X-------o-----o-BBB|---------B----o----------o-------X--|-------B-|-----B--------X--f
--o-----X---------o-----------o--oo------B--X-oo-X-o--------X---B-|--B---------o-------------------oo-----o--------oX-----------------|-B---o------Boo-------BBB--o--------|---------|--B--o--o-X------f
-o----------ooX---o--B---Bo-----------------B------Xoo--------oB--|--------o-Xo--------X------o--o------------------------------BB--o-|-o--o-Bo-----------o----XB--------BB|-------B-|---o--X---B----B-f
m---B-------E----------E-----EE----o-----------E----X-----------E-|---------------o-X-o--E---E----o-B--BBoo-Eoo---ooo-----B-----------|------oo---------X--o-E--------o----|-----oX--|--B--o---o-----B-X
XXXXXXXXXXXXXXXXXXXXXXXXXXXXXXXXXXXXXXXXXXXXXXXXXXXXXXXXXXXXXXXXXXXXXXXXXXXXXXXXXXXXXXXXXXXXXXXXXXXXXXXXXXXXXXXXXXXXXXXXXXXXXXXXXXXXXXXXXXXXXXXXXXXXXXXXXXXXXXXXXXXXXXXXXXXXXXXXXXXXXXXXXXXXXXXXXXXXXXXX
