--------B--o-------------------B----B--------------------o---------------B--o------B-o------------B--------X-o-----------------------B-o---o------BB--o---B----o-o-o-------------X------------B---oo---o
----o-----------X--------o--oo---o----------o--B-------XB--oo-X-------o-----------------B-----------------o----B---------------B--o-------E--X---oEB-------------B--o--o---B-------------oXX------------
----------BX-------------B---------o----o--Xo------o-oB---o--o-Bo---o----B--B--B-BBo-----B-------B--------o------------B--------X---------X-B----o--oB--ooB----o---Eo-----o-----X---------o-B-----------
------oo----oB--------B---B-o-------------E-----o-------------ooo--o------------------X-o------o---B------XB--------oo-----X----o-------o------oo-------oB---B----o---------o-------X--------------XB---
--o--X-B---o----o-----o---------X----o--------o-----X------------B-o----------o---o-------------------o----X----------B--o--------Xoo------B-----o---------B-------B---X----------B---------------------
-o---o-----------Boo----B-o---------o------B--o---BX--B----B--------EX-------o-B--------BBB----BB---------------------B---o----------B-X--B-------o------X---------o-------------E---o----B----o------o-
o----------o----------oo--o-----oB-o-----B----o-------B-oB--Bo---------o--------------B-X-------B-o-B----o---------B------T---B---o----------o---o---B-------------o-------o----o---B------------o---B--
o-----o-------E---o---B-B-----X-----B-X-------o---------o-------------B--------o----o--------B-B----------X-E-----B-o-----|--oB------------B---oo----o--B------B---o--------o----X------o-------o--o---v
-o-XB---------B----o-o--Xo-------------------oo--o------X---o---------------------o-X--o---o-------------BB------o-----B--|----X--B--------o----------o-----?-E-------o--Eo----Bo-------------o-------Bf
------?--------E---------o----X-X--B--o-----------o-------------------------o----------------B---o---o-----o----X------XB-|---E---------Bo----B-B-------o----B-------Bo--X----o-------------oB---B-----f
---T---B-------o--o----------------o-----o---------------B-oX--------B--oo-----B-----o---o-B---B-o---ooXBo------o---o--o--|-----o-o--B----B-o----------E----Bo-------o----------BB------X---B-X-----o-Bf
---|---------o-B--------ooE-ooo-----Bo---Bo-------B-----------X---------------------B---BX-oo-Boo--------B--------B--o----|-----X----B------------------------o-----B----BB-o-oE--------------B--------f
B-B|-o-------oXB---------------X-E---B------------o-----------o--B----oX-----o-----o---------------------o------o---------|---B--o------------o-----o---------------B-o---------o----------B----X------f
o--|----X-------o-o----B---o-oo--B--oo-B--X------o---------------B------B--E-----B--o-----o------E-T---oBB------o------ooo|-------------o--X-BE----------B----------X----------X-----B-------o-XEX-----f
m-o|--B------------XoB---------oX----Eo-o----B---B----------------X----o---X---o-B--E----B-o----o--|-Eo--B---X-B---B------|---X------------------oo-------o---X-----B------E---X----B---------Xo-----E-X
XXXXXXXXXXXXXXXXXXXXXXXXXXXXXXXXXXXXXXXXXXXXXXXXXXXXXXXXXXXXXXXXXXXXXXXXXXXXXXXXXXXXXXXXXXXXXXXXXXXXXXXXXXXXXXXXXXXXXXXXXXXXXXXXXXXXXXXXXXXXXXXXXXXXXXXXXXXXXXXXXXXXXXXXXXXXXXXXXXXXXXXXXXXXXXXXXXXXXXXX
