------------B------ooB------oB-------------------------------X-------------------X-X----------------------B-------B-------------Bo--B------B----X--------------------B-----------?----B-o---------------
-----------------------------------B------o----------------Eo-XX------o----X--o-X--------------Xo--------------------o--------Bo-o-X------X-------oX-------o---oB----------------E----o----o-------o----
-------o-o-B-------Bo--o-X----Bo-B----o---o------------------X----X--------o--B-o-----o--o---------------------------X-X-Xo---------------------X--X-------------------o-X----oo--------------B-B--o----
--------o-------X-------BB-----------------B----o---oB-------------o---B------o----E-B---------B--o-B----B---o-----------B--?--o--o----o---oo-----------------o-----------BB--------o-B---X--B?-B-------
------Bo---X------o--o--o---------o---B--o-----o---------Xo--BXB------o---B-o--oX------------------o---o-----Xo--B----o------B---------------------o-o---------o--o------B--------o-B-----B-E---oo------
-oB---o---------X--o-----------o------oB-X--oBX---------B--o------------o----B--------B----oo--o-----o----------o------Bo-----------B---B------o---X-------o-----------o----X-------o----X------B-------
----E----------o--------o----o---o?---o-o-X--------------o----BB-----XB------o--B-----------o-o---o------oB---o-------------------X-------o-------XX--X------------------o-B------o-------B-----o-------
---------------------X------------------o--B-o----B-X-------------------------------------------BX--------oXB-----------B-X--B---------------B-BB--B-B-B----X--o----o-----o-----X----------B---B-------v
-------------Bo-----------------------------BX--B---B-------------o-o---------o-o--B----o-------------B------B------o------------------o---------X-o-o----------------o----B--B-o----------B-E------o--f
----oEXB------B-------X-------o--B------X--B-------B---------o-----------X--o--o--B-----o-----o-----------------B--X---------o----oo----X-----o--X------B--------------o-XB--X---o----------o---B------f
----oo-o--------o------B-----o-------------o-------B-B--Bo---------X-------B--o--o-o-o-o----B-------BBo----o-------------XB-B--o--------B--B---o-o-E-----Bo---o----o-------o-o---------o------------B--f
----oo?--X-X--X?-B-----X-Boo---oB-X--------------Bo--------B--B---------o-o-o------X-X-----B----------X--X---o-------------o--------o---o------------oo---o-B---B---------------o----------B--B------Xof
---o------------------------B--o--B---X----o-Bo-----o----B-B--------E---o---B-------------B---------B-oBX----o-----o---oo------o----ooo----------BE------X-BB-------XB-----Bo------oo-----------B--o---f
----B---XB----------B-------X--B-----X--------------oo---------X--------------o-X--BB-BB----------?-----o--o---------oX-------BX------------B---o----o----E-B--------XB-o-------o--------------o-----XXf
m----o------o------B--o-------X-X----B----o-----------B-B--o-------B--------E----------------------o-oo--B----------Bo-o-------B-oo---------B--B----Eo-----------E-----B-B--o--------------E--X-------XX
XXXXXXXXXXXXXXXXXXXXXXXXXXXXXXXXXXXXXXXXXXXXXXXXXXXXXXXXXXXXXXXXXXXXXXXXXXXXXXXXXXXXXXXXXXXXXXXXXXXXXXXXXXXXXXXXXXXXXXXXXXXXXXXXXXXXXXXXXXXXXXXXXXXXXXXXXXXXXXXXXXXXXXXXXXXXXXXXXXXXXXXXXXXXXXXXXXXXXXXX
