-----------------------o----------------X----o----o-X-------------o--------------------------o-------o----------------------------X--o---B---o-----------o-B----B----o---o-----------------B------------
--------o-------B-----o-o---o--------B--------o--B-B----------------B---------------------------------------------------------E-----------------------o-------XBB----X---B----------B-----oX-o----------
------o---B-B----------------Bo-----------------o------------B---------------Bo--X----------o----------B-----oo---o---------X-B---------------B---oB-------------------X---B----------E-------------E---
---------o-------B-----o---B-o------o--------B-B-o--B--B---o---X----o---B---------------X-oB--B-----------X---o---B-----o--------------B------B-------------------E-------------------------o----B------
--o-X------------X--------o-oB-o----------o-o------------o---------E----o-------X-B-----B--B-o----------------------o---------o--o----B--o----Bo-------Bo------o---o-----------------X----------B--B----
--B-o---------B--o--------Xoo-----B----oo----o--B------------B---o-----o--------o---------------------------------------------------B------------B------------------Xo-B-----o-----------------X-----o--
----B--X------o---oB-------------X-o---B-----X---oo-----------o-----o---o--X-o-----o--o-o-----------------B----o-------XoX--o--B-o-------o---oB-------o---------E------o------------ooo------o--o-X-B---
--o------o------o-o--------------o-o------------------o---------E--------B------XoB----B----B-o--X------------Xo------------------------X-o-B----o-----o---o---o----o----?-------B-E-----o--o----BB-o--v
---------------------o-X-B----B--B--------o------------Xo-B--------o----BB----------o-------X-Bo---o--X----------B--X-Xoo-------------B-----o-B--Xo---B----o----------------------------------------oo-f
---------o------------o----o-----B------X-B--o---X-----------------------o--X-----------------------------X-o----------------------------------E-----------o----X--------o-B---o--------X----X-B-------f
----o-----o-X-Xo----oB-o--o----o-------X-o------B--B---o----------o----B-----------oBo----------------------Xooo--o-----Bo-----B------o---------------o------B-o-------X--------B----------BB--------X-f
-------------o--------------------o---------o-------------o----X---B-------o--------oo----------------o---------E---o--------------------oX-B--o---B-----o----------oX--o---o------------------------o-f
---------o-o------------------X--o-o-o--o--------X-----------o-o---------B-B------Bo------B-----E-X-----o--------------------B------B----------o---------o---B--------X----------B--B--o---------B---BXf
--o----Eo------o--X---X-B-o-o---oX-oB-----o---------B------------------------B--B------------o--o-B----o-o-------BB--oo-----X--o-----o---B------o----oX---o----E----o--o-------------oB--o----------o--f
m-----o-------o--------------B-----XX------B-----B---B----o-----o-------B----------B--B---o-----------B----o-B--B-------X-----------------------------B------o------BB-------o---------Bo-------------BX
XXXXXXXXXXXXXXXXXXXXXXXXXXXXXXXXXXXXXXXXXXXXXXXXXXXXXXXXXXXXXXXXXXXXXXXXXXXXXXXXXXXXXXXXXXXXXXXXXXXXXXXXXXXXXXXXXXXXXXXXXXXXXXXXXXXXXXXXXXXXXXXXXXXXXXXXXXXXXXXXXXXXXXXXXXXXXXXXXXXXXXXXXXXXXXXXXXXXXXXX
