----------------------------------------------------------------------------------------------------------------------------X--M--X---B----B-------------XM-B---??o?BB??----------B-----B-X-X--X--------
--------------------------------------------------------------------------X----------------------------B--------B------------X--XBXXX-----------BX-----B?----BB------?--------------B----o---X---BBBX---
-------------------------------------------------------------------------------------------------------B--------------------------BB-----X--o----------XM-B-X--B----------------------B-B-------B--B----
----------------------------------------------------------------------------------------------------------------X-----------------X-----????---------------XX-BBBBX--B-----------------X---X?B??------X-
-X---------------------------------------------------------------------------------------------------------XB---------------B---B-??-BBBBBBBBB-----T----X--TBTBBB-o?X????----X--B--BX--XBXX-?-X---X-T-X-
-----------------------------------------------------------------------------------------------------------------BB----------X-B---MXB---X---------|----BB-|-|BoB-BX--------XX-----X-X---XXTXXMXX-?-|-X-
--------------------------------------------------------------------------------------------------------------X---B-----------B-----X-----------B--|--o--XX|X|-BooB--------XXX-----Bo--X---|-XXBXTo-|-X-
---------------------------------------------------------------------------------------------------B---------------------------X--BB--BX--M-------B|------X|X|-BBBX----M--XXXX------?---X--|-X--X|XX|-Xv
------------------------------XXXX-----------------------------------------------------------------------------------------T---X-----o-XX-X--------|-XoT-BX|X|X-B--------XXXXX----------XX-|-XX--|--|XXf
------------------------------------------------------------------------------B------------------T----------------XXXX-----|---B-------XXXXX-------|BMX|X-X|X|--X-X--T--XXXXXX?X??XBo?X-XXX|XXXXB|--|XXf
---X---------------------------------------------------------------?-----------------------------|-------------------------|---?B------XXXXXX------|-XB|XXX|X|X?----X|XXXXXXXX----------XXX|-XXXT|??|XXf
------------------------------------------------------------------------------------------------B|-----X---------B-X-------|------X--TXXXXXXXXBBBXB|-XX|XXT|X|XXTBBBB|XXXXXXXX-T-----B--XXX|XXXX||--|XXf
-------------------------------------------------------------------------------------------------|-------------------------|-XBB-BXX-|-XXXXXXXX----|BXX|XX||X|XX|--XB|XXXXXXXX-|--------XXX|XXXX||XX|XXf
-------------------------------------------------------B-----------------------------------------|-------------------------|------XXX|BXXXXXXXXX---|-XX|XX||X|XX|X?-X|XXXXXXXX-|--------XXX|XXXX||XX|XXf
m------------------------------------------------------------------------------E----------E------|-----M----------E-------E|-X--B-XXX|XXXXXXXXXXX--|BXX|XX||X|XX|XXXX|XXXXXXXX-|-EBEX---XXX|XXXX||XX|XXX
XXXXXXXXXXXXXXXXXXXXXXXXXXXXXXXXXXXXXXXXXXXXXXXXXXXXXXXXXXXXXXXXXXXXXXXXXXXXXXXXXXXXXXXXXXXXXXXXX|XXXXXXXXXXXXXXXXXXX-XXXXX|XXXXXXXXX|XXXXXXXXXXXX-|XXX|XX||X|XX|XXXX|XXXXXXXXB|XXXB----XXX|XXXX||XX|XXX
