------------------------------------------------------------------------------------B????----------B-B------------X-X---?B--B---------X-----B-----o---BB?????---XB------------o--------?-----------X----
-------------------------------------------------------------------------------B---------------------?-------B------------o-B---------X----------------X---o----B---B-M--?---------------XXBXXX--X------
-------------------------------------------------------------------------------------XXXX----------------------------X----X-X--------X-X---o-B-B-o-M---X-----?------B------B-------X-------BBBB---------
--------------------------------------------------------------------------------------------X-------B-----oXXXXXXXo-------B---o--B--------------?-----oX-------------X-?----------o--B------------------
---------------------------------------------------------------------------X----------X---X--------X---T--X--?---BXX-------???---X-BB--XBXT--TX--------B-T---------X-T---XX-----------B--T-----------o--
--------------------------------------------------------------------------------------X--XX------X-----|-Xo-XX-------T--XX-X-B-X--X------X|--|-X-M--B---B|-X------XX-|--XX--TX-B--B------|--------------
--------------------------------------------------------------------------------------o-XXX---------B--|-XTT---XBBXBT|B-----BX-BBBXBBB--XX|--|-X---------|---XX--XXXB|-XXX--|TX-X-X-?o---|--T----BB-----
---------------------------------------------------------------------------------------XXXX-------B-X--|X-||B-X----X||---o--oXX--B-----XTX|--|--XBBBT----|X-XXB-XXXX-|XXXX--||X---XX-----|--|------B---v
------------------------------------------------------------------------------------X-XXXXXB-----------|--||---o??T?||-------TXX------XX|X|X-|X---B-|XXXX|XXXX-XXXXXX|XXXX-?||---XXXX----|--|-??????B?-f
------------------------------------------------------------------------------------XXXXXXX---X--------|--||-X---T|-||-X-XXX-|XXX--B-XXX|X|XX|------|B--B|XXXXXXXXXXX|XXTXX-||----XXXX---|X-|----------f
--------------------------------------------------------------------------------X---XXXXXXX--XX-T-----X|?-||-----||?||BXXBXB-|XXXX--XXXX|X|XX|-o----|X---|XXXXXXXXXXX|XX|X--||-X-TXXTXX--|X-|------B-B-f
-----------------------------------------------------------------------------------XXXXXXXXXXXX-|-----X|--||--B-B||-||-XXXTXX|XXXXXXXTXX|X|XX|XXXXXX|XX-X|XXXXXXXXXXX|XX|X-B||TB-|XX|XXTX|X-|----------f
--------------------------------------------------------------------------------X-XXXXXXXXXXXXX-|-XX-XX|--||X--B-||B||XXXX|--|XXXXXXX|XX|X|XX|XXMXXX|XXXX|XXXXXXXXXXX|XX|X-X|||--|XX|XX|X|X-|-------X--f
------------------------------------------------------------------------?-------XXXXXXXXXXXXXXX-|T-XXXX|BB||BBBBB||-||XXXX|X?|XXXXXXX|XT|X|XX|XXX-XX|TXXX|XXXXXXXXXXX|XX|XX-|||--|XX|XX|X|X-|----------f
m---------------------------------------------------------------------------X---XXXXXXXXXXXXXXX-||-XXXX|-B||?X-Eo||-||XXXX|XX|XXXXXXX|X||X|XX|XXXXXX||XXX|XXXXXXXXXXX|XX|XXX|||-E|XX|XX|X|XB|E---------X
XXXXXXXXXXXXXXXXXXXXXXXXXXXXXXXXXXXXXXXXXXXXXXXXXXXXXXXXXXXXXX-----XXXXXXXXBBBXXXXXXXXXXXXXXXXX-||XXXXX|B-||XXX-X||X||XXXX|XX|XXXXXXX|X||X|XX|XXXXXX||XXX|XXXXXXXXXXX|XX|XXX|||--|XX|XX|X|XX|XX---XXXXXX
