------------------X----B--------------------------------------------------------------------------------------------------------------------------------------------------------------------------------
----------------------B-------------------------------------------------------------------------------------------------------------------------------------o-------------------------------------------
------------?----------------------o-B----------------X--------------------------------------------------------------------------------------------------B------------------------------o---o-----------
----------------------------------X---o------------------------------X--X------------------------------------------------------------------------------------------------X------------------------B-----
-----------o----------B--------------------B--B-----------------------------------------------------------------------------------------------------------------------------------?X--------------------
--------------------------------X--o-------------BX-------------------------------------------------------------------------------------------------------------------------------?---------------------
----------B---------------------B--------------------------------------------------------------------------------------------------------------X--------------------------------------------------------
------------------------------------------------B-------------------------------------------------------------------------------------------------------------B----------------------------------------v
-----------------o--X-------------B--B----B----X--------------------------------------------------------------------------------------------------------------------------M----------------???------X--f
-----------------------------------------------------------------------------------------------------------------------------------------------------------------------BBBBBB--------------------------f
------------------------------X-B----B--------X----------------------------------------------------------------------------------------------B---------------------------------------------------------f
----------B---T------------B-X----------------XX----X-------------------------------------------------------------------------------------------------------------------------------------o------------f
--------------|--B-X------------X----B--------XXX--------------T---B-------------------------------------------------------------------------------------------------------B---------T-----------------f
--------------|B----------------------????----XXXT-------------|--------------------------------------------------------------------------------------B------X----------------B------|-----------------f
m------------E|----------E-----E--E-----------XXX|X------------|----------------------------------------------------------------------------------------------------------------o----|-----------------X
XXXXXXXXXXXXXX|XXXXXXXBXXXXXXXXXXXXXXXXXXXXXXXXXX|XXXXXXXXXXXXX|XXXXXXXXXXXXXXXXXXXXXXXXXX----XXXXXXXXXXXXXXXXXXXXXXXXXXXXXXXXXXXXXXXXXXXXXXXXXXXXXXXXXXXXXXXXXXXXXXXXXX--X--XXXXXXXX|XXXXXXXXXXXXXXXXXX
