------??????--------------------------------------------------------------------------------------------------------------------------------------------------------------------------------------------
--------------------------------------------------------------------------------------------------------------------------------------------------------------------------------------------------------
--------------------------------------------------------------------------------------------------------------------------------------------------------------------------------------------------------
-------BBBBBBB-------------------------------------------------------------------------------------BBBBBBB--------------------------------------------------------BBB-----------------------------------
-------------------------------------------------------------------------XXXXXXXX-------------------BB---------------------------------------------------------------------------------------o----------
----XXXXXXX------------------------------------------------------------------------------------------------------BBBBBBB--------------------------------------------------------------------------------
--------------------------------------------------------BBBBBBB?----------------------------------------------------------------XX-----------------------------BB------------------------------XXXXX----
--B----------------------------------------------------------------------------------------------------------o-----------------------------------------------------------------------------------------v
-----------------------o-------------------------------------------------------------------------------------------------------------------------------------------------------------------------------f
---------------------------B-------X--------------------------------------------???--------------------------------------------------------------------------------------------------------------------f
----------------------------------XX--------------------------------------B--------------------XX---------------------X--------------------------------------------------------------------------------f
--T--------------------T---------XXX---------------------------------------------------------X-----------------------XX----------------------------------------------------------------------?---------f
--|-T-B----------------|--------XXXX---------------------X----------------------------------XX------X---------------XXX--------------------------------------------------------------------------------f
--|-|------------------|-------XXXXX------------------------------------------------XXX----XXX---------------------XXXX------------------------------------------------X-------------------------------f
m-|-|E----------------E|------XXXXXX----------------------------X--------------????-------XXXX--------------??????XXXXX---------------------------------------------------------------------E----------X
XX|-|----XXXXXXXXXXXXXX|XXXXXXXXXXXXXXXXXXXXXXXXXXXXXXXXXXXXXXXXXXXXXXXXXXXXXXXXXXXXXXXXXXXXXXXXXXXXXXXXXXXXXXXXXXXXXXXXXXXXXXXXXXXXXXXXXXXXXXXXXXXXXXXXXXXXXXXXXXXXXXXXXXXXXXXXXXXXXXXXXXXXXXXXXXXXXXXX
