----o---oX-----B----B--o-------o---BB--X--------------X--------------------BBBX--B--Bo-----oo-Xo-----B------X-XB----oB-----------o-o-----X--B-B--B-----oo-----B---o------o-----o----------B-------Boo--X
-B-----B-----B-----oX-B----------------------X--------------B---X-B-E-B-o-----X--------X--------Bo---T-----------B------oo-B-o----B-----oB------------o--Bo--o---oB----o---X----B-----X------BB-o-------
?----------ooB---B--o------o------o----o--o---X------o--------o----BB---------o--X----------X---o-B--|---------X------o--B---------------oo---X--------------------------B------o---oo-------B-B--------
-B---------------------o-----------oX---X-B--o----oo----o------BB---B-----o--B------------B-----o----|--T------Bo----o---------o--B--------------B--X------o--o------------------o--------X--BX---------
---B-o---------o---B----B-X---------------o-----X----------o-BT---ooo------o--o-o-o--X---oo----oXBXo-|--|----------o------o----BB-----?----BX-----------B------B----------B----------------X------oo----
----------BX----BB---------o---X-X------------------o-------X-|--o----o------------o-----------o-o---|--|-o-E---B---------oB-------o------B---------BB----B-B--o----------------B----o------B-------B---
---B--------X--o-------B----o-o-o-------o-B--B-----B------T--o|-?---------o-o-X--oX-----------BoXo---|--|---B----o-o-B-----------------o---------o-B---o----------------oo----X---B--o---X---XX----X----
--o------X-----o-----o---o--T---B------o-----o----o------o|-o-|---B----------ET--o---X------Boo----B-|-E|----X-o-----BX---o-------B------BB-B-o-----BX-------X---Eoo-o-o-o--B-------o-----------------ov
oo---oo-----------------o---|-----X-o------------B-o--?-B-|---|-o--BX-o-o----B|----X----BX--------B-o|-B|----B-----------B-------o---o----X--oo-B----------------X-Bo--------------B-------Bo------o---f
-------XB----B--o--B--------|---T---------X---------------|---|------X--------|----o-XB-----o--o-----|-X|----o-B----------B---X-o-Xo---------X----B-----------o--o-?-o---------------EX------------o---f
----------------------X-X---|---|---o---o---------o-------|---|-o----o---X---o|------o-----o----BXX--|--|-oo--B-------B-----B-------o-----------B--X-------------------X----o------o-XX---X--BB-------Xf
o--o------------o---B--oBB-o|---|-B----B---o----oooBo---T-|---|---------X-----|----X-----X-B-oBX-----|--|-Bo-----o------------X--oo-o---------B----X--------X-----oo----------B----------BB-o---------of
-o-E-----o-o-X------o-----B-|---|-----X-----E--BXB--o---|-|---|--o-------?----|--X-BBB---------------|--|--------B--B----o--------o--------o---Bo------?o----o--------BB--------oXo--oo-------o--o-----f
--XB---o---o-o-o-----------X|---|---Bo------BB-BB-X-----|-|---|---B---X-------|-----B-------------B--|--|---------oo-----oB---o---oo---------------------B------o----B---X---------o---------------X---f
m-oo------B---o---B---------|---|-B--o--B-oo-----oB----X|-|-o-|-X-----o---E---|-oB-B---B-E-o-X-------|--|-Eo--o---B--E----o-E--o---------------------------oo-oo---o--o--o---o---o-E--o----B-----------X
XXXXXXXXXXXXXXXXXXXXXXXXXXXXXXXXXXXXXXXXXXXXXXXXXXXXXXXXXXXXXXXXXXXXXXXXXXXXXXXXXXXXXXXXXXXXXXXXXXXXXXXXXXXXXXXXXXXXXXXXXXXXXXXXXXXXXXXXXXXXXXXXXXXXXXXXXXXXXXXXXXXXXXXXXXXXXXXXXXXXXXXXXXXXXXXXXXXXXXXX
