---------???----o-----------------------------------------------------------------------------------B-----B--B--------BM--------X-------B-------------------------------------------X-----X-------------
-----------------------------------------------------------------------------------------------------------------------o--X------------?--X?BXBB----X-----------------------------------------------X---
--------------------------------------------------------------------------------------------------------------B-----?-B--B----------B-----B------M-------------------------------------------------X----
---------------------T------------------------------------------------------------------------------------------------------------B-----------TT--?-----------------------------B-----------------------
---?--T--------------|----------------------------------------------------------------------------?------B----TX-----------------------B------||--------------------------------------------------------
------|--------------|---------------------------------------------------------------------------------T------|X---T---X---------o------XB----||------------------------------------------------------B-
------|--------------|----------------------------------------------------------------------X-----B----|-M-X--|---B|B-XX----MB------------Bo--||B--------------------------------------X-------------X--
-----o|--------------|-------------------------------------------------------------------------------B-|--XX--|----|-XXX---X-------X-----X--X-||-------------------X------------------B--------B-------v
------|--------------|---------------------------------------------------------------------------------|-XXX--|----|XXXX---XXB--X--------XXXX-||------------------------------------------X-----------Xf
------|--------------|---------------------------------------------------------------------------------|XXXX--|----|XXXX---TXX-B---Bo----XXXX-||-X----------------------------------------X----------XXf
------|--------------|---------------------------------------------------------------------------------|XXXX-B|---X|XXXXBBB|XXX----------XXXX-||--------------------------------------B-----------B-XXXf
------|--------------|--------------------------------------------------------------------------------X|XXXXXX|XTXX|XXXX---|XXXXT---X--BXXXXXX||-------------------------------------------X-------XXXXf
------|--------------|-------------------------------------------------------------------B----------oXX|XXXX--|-|XX|XXXX-X-|XXXX|B-XXB-XXXXXXX||------------------X------------B-----B-----XX-----XXXXXf
------|--------------|------------------------------------------------------------------------------XXX|XXXXBB|X|XX|XXXX--T|XXXX|XXXX-XXXXXXXX||--X------------------------------------B---XXX--oXXXXXXf
m-----|E-------------|-----------------------------------------------------------------------------XXXX|XXXX--|X|XX|XXXXEE||XXXX|XXXXXXXXXXXXX||X----E-----------------------------B-----E-XXXX-XXXXXXXX
XXXXXX|XXXXXXXXXXXXXX|XXXXXXXXXXXXXXXXXXXXXXXXXXXXXXXXXXXXXXXXXXXXXXXXXXXXXXXXXXXXXXXXXXXXXXXXXXX-XXXXX|XXXXXX|X|XX|XXXXXX||XXXX|XXXXXXXXXXXXX||XXXXXXXXXXXXXXXXXXXXXXXX--------XXXXXXXXXXXXXXXXXXXXXXXX
