--------------------------------------------------------------------------------------------------------------------------------------------------------------------------------------------------------
-----------------------------------------?--------------------------------------------------------------------------------------------------------------------------------------------------------------
--------------------------------------------------------------------------------------------------------------------------------------------------------------------------------------------------------
------------------------------------------------------------------------------------------------------------------------------------------------------------------------------o-------------------------
-----------------BBBBB----------------------------------------------------------------------------------------------------------------------------------------?-----------------------------------------
--o-----------------------------------------------------------------------------------------------------------------------------------------------------------------------------------------------------
------------------------------------------------------------------------------XXXXXX---------------------------------------------------------------------------BXXX-------BBBBB---X---------------------
-----------------------------------------XXXXXXXX------------BB--------------------------------------------------------------------------------------------------B-------------------------------------v
--------------------------------o----------------------------------------------------------------------------------------------------------------------------BBB---------------------------------------f
---------------------------------------------------------------------------------------------------------------------------------------------------------------------------------X-----XXXXX-----------f
------------------------------------------------------------------------X--------------------------------------------------------------XXXX-------------------------------------XX---------------------f
------------------------------------------------------------------------XXXXX--------------------------------------------------------------------------------------------------XXX---------------------f
-------------------------------------????????--------------o------------------------------------------------------------------------------------------------------------------XXXX-------------T-------f
---------------XXX----------BBBB-XXXXXXX-----------X----------------------X----------------------------------------------------------------------------------????-------XXXXXXXXXX-------------|-------f
m--------------------------------------------------XX---o-------???????-----------------------------------------------------------------------------------------------------XXXXXX-------------|-------X
XXXXXXXXXXXXXXXXXXXXXXXXXXXXXXXXXXXXXXXXXXXXXXXXXXXXXXXXXXXXXXXXXXoXXXXXXXXXXXXXXXXXXXXXXXXXXXXXXXXXXXXXXXXXXXXXXXXXXXXXXXXXXXXXXXXXXXXXXXXXXXXXXXXXXXXXXXXXXXXXXXXXXXXXXXXXXXXXXXXXXXXXXXXXXXX|XXXXXXXX
