--------B--------------B---------------------------------------------------------------X-------------------XB-o---B--?-B???X-------XBoXXBoXB-XXXXXX----------------------------------X-----B------------
--------------------------------------------------------------------------------------B-X-M------B---------M----------X---X-------B-----X-B---X-----B-----------------------------B--X-X--X-----X-----?-
---------------------------------------------------------------------------------------------------------X-----X---X---B--???----B--XB-M---------------------------------------------B-----------?------
----o-------------------------------------------------------------------------------------------B---B-BX-X-B-B--BT-XX-X-X-TX-B-T-ooB--BB--------------????-----------------------B-o-----X-X---X--BB----
--------------------------------------------------------------------------------------------M--X-X-XB--X---TB---B|--X--BXB|XBBX|----B--X------------------------------------------B---o---X-MB-----T--X-
-------------------o-------------------------------------------------B-----XB-----------X---------XX-----o-|--BXB|-XX--BXB|-B--|XX--TX-----X---------XX-------------------------------X---XX-o----o|--X-
------------------------------------------------------------------------------------------B-B---MXXXB------|-----|XXX-X---|X--B|XX--|------------T--XXX-----B---------------------o-X-XX---XXXXTXXX|-XX-
--------------------------------------------------------------B-----------------------B-X-----B-XXXX-----XB|----B|XXXX---X|----|XXX-|XoXX-----B--|-XXXX-------------------------T-----XXX--XXXX|-XX|XXXv
---T-------------------------------------------------------------------------------------TX----XXXXX-TX----|----X|XXXXX-X-|XTXB|XXXX|-T----------|XXXXX-------------------------|-----XXXX-XXXX|XXX|XXXf
---|-----------------------------------------------T---------------X--------T-----------X|XX--XXXXXXX|BBBBX|--XXX|XXXXTX-T|X|XX|XXXX|-|-------XB-|XXXXXX------------------------|--X-BXXXXXXXXX|XXX|XXXf
---|-----------------------------------------------|---------------XX-------|--B---oX--XX|XXXXXXXXXXT|T-oXX|B-XXX|XXXX|XX||X|XX|XXXX|X|-------X-X|XXXXXX----------------------B-|-----XXXXXXXXX|XXX|XXXf
---|-----------------------------------------------|---------------XXX------|------------|XXXXXXXXXX|||XXXX|XXXXX|XXXX|XX||X|XX|XXXX|X|-------XXX|XXXXXX------------------------|---X-XXXXXXXXX|XXX|XXXf
---|-----------------------------------------------|---------------XXXX-----|----------BB|XXXXXXXXXX|||XXXX|XXXXX|XXXX|XX||X|XX|XXXX|X|X-----XXXX|XXXXXX------------------------|-----XXXXXXXXX|XXX|XXXf
---|-----------------------------------------------|---------------XXXXX----|-X-----B--BB|XXXXXXXXXX|||XXXX|XXXXX|XXTX|XT||X|XX|XXXX|X|XX---XXXXX|XXXXXX-----------------------B|B-T--XXXXXXXXX|XXT|XXXf
m--|-----------------------------------------------|---E-----------XXXXXX---|--E-E--B-XE-|XXXXXXXXXX|||XXXX|XXXXX|XX|X|X|||X|XX|XXXX|X|XXX-XXXXXX|XXXXXX------------------------|--|--XXXXXXXXX|XX||XXXX
XXX|XoXXXXXXXXXXXXXXXXXXXXXXXXXXXXXXXXXXXXXXXXXXXXX|XXXXXXXXXXXXXXXXXXXXXXXX|XXXXBXX----X|XXXXXXXXXX|||XXXX|XXXXX|XX|X|X|||X|XX|XXXX|X|XXXXXXXXXX|XXXXXXXXXXXXXXXXXXXXXXXXXXXXX-|XX|--XXXXXXXXX|XX||XXXX
