------X--------o---------------oB----o---o-o---o--o------------B---------ooB--------------------------X------X--------o-------------------o-----o---X--o-------X----X-----oB---------o----X-------o-X---
-------o-------o------BB-------------------B---------B------------B---o----B-B-o------oo---------------------o-----B-B------o------o--B-X---BB-Xo---------B--B--------o----o---o------X---B--o-----o----
----o----o---------o-----B---Bo-----o-----B--o-Bo---B---X----o--o-o-------B----------o------------------E----------------B-------X-Bo------------------------------o-------------oBo----o---------------
------B----------o------------o----Boo---BXo---------------o-X--o-------B--------------------X-------o-B------------B-o----X----------------o---o------------------------oo----B----------B----o---o----
-----oBX-----B--B--X---B-------EX-oB--B----------------B--o-o-------B--o-Bo-----o------E----o--o--BB-o---Bo---oo--------------o-----oB------B----B------o------oB------Bo-o------B----------oo----------
----o--------o------------o-----------oo--X-----o------Bo--o----B-------------X-----B--------o-o-oBXX-------------oo-------o-o-----B--X--------o------o--XB------------------oo---o-X------o----B-----o-
--------------Xo-o-o------B-----------o-----oo-----oo------o---B---B------Bo------------o-o--------oo-----------B-----------B--------------------B----o-------o----o-oXo-----X------B--o---BX--B--------
---------B-------------o--o-X-----------?B-----------------oo---o----o--------oXB-X------------------B--B--o-B-o--o-----o--o--B---o-------------------B---B-o----oB-------------o-------------oo-oB----v
--o---B-------B--B-------------B-----B---oBoo-----B------o-B--o------B-B----------X--B---------o-----------ooE--o--o--oX---------------o----ooB-o-------B---o---E--ooB------B-------------oB----o----o-f
-----o-----------o-B--E----B----B----o----o--o--B------------o-------------------X----X---------B------Xo--oo------o--------------o---B--oB---B--------X--B--o----Boo--o---------o---------------XBo---f
--o-------o----B-o--------Bo---o------E-o--B-------B---------E----o-----X----X------------B--o---------o-----------o----------X--o-X---------o------B-------X----BX---o------------o--B----oo-?-o------f
---o------o-----o---------o-B---Bo-----------o--------------------o---B-oX--o-----o------------------------------o---o--Eo--------o----B-----o---o--B-------------B?---o------o-oo---oo---------oo-----f
------X--------oB-BX--B--o-B----X-o---X---------------------------X-------B-o--oo------------o-----------------X---------B--B-oB----o-B-------B-------o-----o-----B---------o-X-o-----------B--B-----XXf
-X----------X--o---X-------B-------------BB-----------Bo---B---B--o--Xo---oo-B---o-----B----------o--X--XB-----------BXB-o---o-------X----------X-X--------o-----BB------B-----------------X-----XB--X-f
m--E-o-----o-----Bo--B----B-oB----oB-B-o--BB-o--B--o-B----o-o-----------------o----o-o------------B-oBoE--B---------o-------B-o-----X-----B-----o-----B----o-o-----B---------X-B----------oX-o---B-----B
XXXXXXXXXXXXXXXXXXXXXXXXXXXXXXXXXXXXXXXXXXXXXXXXXXXXXXXXXXXXXXXXXXXXXXXXXXXXXXXXXXXXXXXXXXXXXXXXXXXXXXXXXXXXXXXXXXXXXXXXXXXXXXXXXXXXXXXXXXXXXXXXXXXXXXXXXXXXXXXXXXXXXXXXXXXXXXXXXXXXXXXXXXXXXXXXXXXXXXXX
