--o--X-----o-----------X--------------o-------o-----------------------o-----------o-o--B---Bo-o---B---X--B------B----o---------B-B--B----o---B-----------B-----o----X-o----B---o--------o-----B------o--
-o-------o--o----o--oB---o----------Bo---------B----X-X-----B---------------------B-X-oB----------------o--oXB------B-----oooo-o-o------o--oo-------BB---o--B---------o------------X-o----o--o-----B----
-----X--oo-------------o----------oB--BEo-o---------------B-------------------o-------o-------B--B-------------Xo--o-----Eo-X--------------------------------B-----o-E-o--o-X------X--B--------B--------
B---o---E----------B----o--------E---B-----oB--B---?----B-o--------B-o-------------------X-o---B------o-X------o---------X------BXB-----o-------------o-----B------------o---B---oB-----------o---oX----
--------X--Xo-o----o-----o-Xo--o-------------B-o---------------B-o-X-------o-------o------oX-o--o--B---X-----o-----B---------B-o----o----------------B-----o--------------X--o---o--o-X-B---------------
-----B-----B-----o--------o-o-B-BB--o---o-----o--o-X------oB-----------o------B-Xo------B-----B--o---B---X--oo---ooB--B-------oo------X-----------o---o-------B----------------o-oo--B----B---------oX--
---------------------?---E-----X-B----------B-------B--oo---E----X---B---XBB-----?---X----B--Xo------o---Xo-------------B-T-------oo--------------B------XX--o---BB----o---B---------oo--------o--------
-X---------o------------o----o----B---------o-o-----------X-----------------B--oo-oX----XB---Bo---------------------B-----|-o----------B--o-------o---o------oo-----X--------oo----------o---Xo-----o--v
X------X---X-o--------------B------------------oX---o---B--B-X----------o---o---oB-----o------BE-----o--E---------X--o--o-|----------B---------------o------o---------Xo-X---------o------BB------oo---f
------------------------oB---------B-----X--------oB----o-oBo-----oo-o---------------------o---B---X----------oB----------|-oB---B----B-ooo-o--X---------------B----------BM-------B-----X---B---------f
---T-----------B--o-------------B-----X------oT--B-------X-------o------------o----o----------o-----oo--------Bo----------|----o-------------B-X-----oo--B--o--BX----o--B-------o----B--X---B--B-X----of
---|--B-B--------------X----o-o-o---X---o---o-|-------o-------oX----o--B-o----B-----o----------X----------X-B------------o|--oB--B---o--------------o------------o---B----BX-o-------o-o--oB---X-------f
-B-|--------XXB-o--o---o-------X--o------o--oo|-----o----o---------------------------B-B--oo-o------X-------X---B-----Eo--|------B-B--------BB-o-------E------B---o--B--o-o--X-o-o---o----------------Xf
---|----B------o-----Eo--o-B--o----------oo---|-o--BB---------oo--o-o-E-----o----XXo------B--------T-oo---------------B---|-----Eo-----------BooX--X---X--------o-Bo-o--B----o--o-------------o-o----B-f
m--|--o---EoB---o--oE---o---------------------|--------------------------o---B---o-------o--B--o-o-|-X---------o---------B|---E-B-------o-o------B--oB---o---o------E---X--------X-----E----------Eo----
XXXXXXXXXXXXXXXXXXXXXXXXXXXXXXXXXXXXXXXXXXXXXXXXXXXXXXXXXXXXXXXXXXXXXXXXXXXXXXXXXXXXXXXXXXXXXXXXXXXXXXXXXXXXXXXXXXXXXXXXXXXXXXXXXXXXXXXXXXXXXXXXXXXXXXXXXXXXXXXXXXXXXXXXXXXXXXXXXXXXXXXXXXXXXXXXXXXXXXXX
