--------------------------------------------------------------------------------------------------------------------------------------------------------------------------------------------------------
------------------------------------------------------------B-X-----------------------------------------------------------------------------------------------------------------------------------------
-----------------------------------------------------------o------X-------------------o----B------------------------------------------------------------------------------------------------------------
---------------------------------------------------------T--------------B-----X-B----------X--------------------------------------------------------------------------------------B---------------------
--------------------------------------------------------B|--------------------------------------------------------------------------------------------------------------------------------------B-------
-----------------------------------X------B--------------|-------------------B----X---------------------------------------------------------------------------------------------------------------------
----T----------------------------------------------------|----------------------------------------------------------------------------------------------------------------------------------------BBB---
----|----------------------------------------------------|-----X--------X------------------------------------------------------------------------------------------------------------------------------v
----|----------------------------------------------------|-------T------XX---------------B---------------------------------------------------------------------------------------------------X---------f
----|B--------------------------------------------o--B--X|-------|------XXX--------------------------B--------------------------------------------------------------------------------------XXX--------f
----|-X----------------------------------B-------X-----XX|-------|------XXXX-----------------------------------------------------------------------------------------------------------------XXX-------f
----|-----------------------------------------M-------XXX|-------|----B-XXXXX----------------------------------------------------------------------------------------------------------------XXXX------f
----|------------------------------------------------XXXX|-B-----|------XXXXXT---------------------------------------------------------------------------------------------------------------XXXXX-----f
----|--------------------------------------X----??-XXXXXX|-----B-|------XXXXX|X----X-X-------------------------------------------------------------------------------------------------------XXXXXX----f
m--E|---------------------------------------X------XXXXXX|-------|------XXXXX|XX--EXXBBB-----------------------------------------------------------------------------------------------------XXXXXXX---X
XXXX|XXXXXXXXXXXXXXXXXXXXXXXXXXXXXXXXXXXXXXXXXX-XXXXXXXXX|XXXXXXX|XXXXXXXXXXX|XXXXXXXX---XXXXXXXXXXXXXXXXXXXXXXXXXXXXXXXXXXXXXXXXXXXXXXXXXXXXXXXXXXXXXXXXXXXXXXXXXXXXXXXXXXXXXXXXXXXXXXXXXXXXXXXXXXXXXXX
