----????----------------------------------------------------------------------------------------------------------------------------------------------------------------------------------------XXXXXX--
-BBB----B----------X--------------------------------------------------------------------------------------------------------------------------------------------------------------------BBBBBBBB--------
--------------------------------------------------------------------------------------------------------------------------------------------------------------------------------------------------------
--------------------------------------------------------------------------------------------------------------------------------------------------------------------------------------------------------
----???-----------------------------------------------------------------------------------------------------------------------------------------------------------------------------BBBBBBBBBBBBBB------
----------------X---------------------------------------------------------------------------------------------------------------------------------------------------------------------------------------
------B---------------------------------------------------------------------------------------------------------------------------------------------------------------------------------------B---------
----------------BBB-----------------------------------------------------------------------------------------------------------------------------------------------------------------------------???----v
-BBBB--------------------------------------------------------------------------------------------------------------------------------------------------------------------------------------------------f
-----XXXXX----?----------------------------------------------------------------------------------------------------------------------------------------------------------------------------------------f
-------------------------------------------------------------------------------------------------------------------------------------------------------------------------------------------------------f
-------------------XXXX--------------------------------------------------------------------------------------------------------------------------------------------------------------------------------f
----------T--------------------------------------------------------------------------------------------------------------------------------------------------------------------------------------------f
----------|----------------------------------------------------------------------------------------------------------------------------------------------------------------???????---------------T-----f
m------E--|---XXXXXX-----------------------------------------------------------------------------------------------------------------------------------------------------------------------------|-----X
XXXXXX--X-|---XXXXXXXXXXXXXXXXXXXXXXXXXXXXXXXXXXXXXXXXXXXXXXXXXXXXXXXXXXXXXXXXXXXXXXXXXXXXXXXXXXXXXXXXXXXXXXXXXXXXXXXXXXXXXXXXXXXXXXXXXXXXXXXXXXXXXXXXXXXXXXXXXXXXXXXXXXXXXXXXXXXXXXXXXXX------XX|XXXXXX
