X---o------B--------o-o----o-----BB--B------o-B---------o---X-B---B---B----o---o----o------X--------o---o--------B----B----X---B--------------------------------------o---------B--------Bo-T----o------
------o--o-----oB-Bo--oo---o---E-------------------------------o--B-oX----B--X-X---X--oo-----X-------o--o---------o-B--------XooBoo-X-o----B-o---------X--BX-----o------X---X----oB-X------B|---o------X
--------------------B-B-X---X--XB-B--------BX--E--B-----------X----------o---------------o-B-B--B-------B-Xoo-------X-o---------BX-B-o--------X---------Xo---o-----------E-------oXoo--X----|---------X-
X-----B---o----o------BBo--o-----------oB--oB---B--o--XB--B--o----o--B-------B-o----B----o-B-----o-o-----------------B-----BoBo----B--X----B----B-------X-oB---B---o-X-------B----------X---|--B--------
-X-------------o-oBEo----o-------oo-Xo----B--X----o--o-B------o-------------o------X-B----B----------B----o--o-B-XB------oB---o---B-----o---X----Bo--o-oo-o-----oo-BBB--X----------------o-o|------X----
-T------BB--o----o------------?o------X-------o----oX-o-X--Bo-------B--X----------------B-ooB--------------------B-X---B-o------Bo------o---X---o---BB--------------X-----o-------Xo-----BX-|---T-------
B|-Xo-----o---B--o---B---------X---o---------Bo-Xo-oo--o--B--------o-o-----o-B----o--o--XoX-----o---o-oo-o------------B--B-B-B---oo--o---------o---o---ooo-B------o-------------B--B---X-o--|---|---oB--
-|-BX---ooo-------------X------E---B---X------Boo------B-----o--------o--o---o---B-oX----o-oB---------B---------o---B----o-----o-----------------B-B-o----B-------B--B-------o------X-------|---|---o--v
B|-----X-B---T------BB---oB----Bo---oBo--o------------BB---o---o-----------E---------B------B-----o--oo-o------B----------------------o----------o-----o-B------o-o-----B-----------------X-|---|-B--oXf
-|----o------|--XX----------o----X-----o-----o----o-B------o-----BB--Bo--------X---o--o--o-B---oB-----o------o--o------------X---o----o-------X--B-------B-----------X-B----------o---------|--B|-----of
o|-o---------|----o---X----oo---o-------o----------o----o------B---XX-----------------o------B------B----B-B----oB--oo-B----B------o--oo-oo-------EB-----oX------------B----B--o-------B----|-o-|--BX--f
-|-------X-B-|-------o--B---------------------------X----oB---o---o-X---B--o-----o----X------o--B----------B---------Xo--B--E--o----o-o---------o----o----------------o-X-----------oo----B-|---|---B--f
-|---------oo|------B-------oB?o--X-------BX-----B-------------o-----o--B--B--oBB-?X-------o------------BoB---T-------X-oX---o-----o--------o-X----B----E---B-o-----------B-X------o----E---|--B|---B--f
-|--X----o--X|-X-Bo----B-oB-o------oX---------oX-------------B----o--oB---------o--------------B---E---o----B-|----Xo---o-----o---XT---X-oo-------oBB-o---o-----oo-B-oo-o----------o-ooB--oB|---|-----of
m|---oB------|---------o-XoX-X----o--o---o---B-o---------o--o-oo---------o----------E--o---o-B-E---E-----o----|--------B-----------|--------B-----E----o--------o--B-EE------X--------------|--B|-------
XXXXXXXXXXXXXXXXXXXXXXXXXXXXXXXXXXXXXXXXXXXXXXXXXXXXXXXXXXXXXXXXXXXXXXXXXXXXXXXXXXXXXXXXXXXXXXXXXXXXXXXXXXXXXXXXXXXXXXXXXXXXXXXXXXXXXXXXXXXXXXXXXXXXXXXXXXXXXXXXXXXXXXXXXXXXXXXXXXXXXXXXXXXXXXXXXXXXXXXX
