--------------------------------------------------------------------------------------------------------------------------------------------------------------------------------------------------------
--------------------------------------------------------------------------------------------------------------------------------------------------------------------------------------------------------
------X-------------------------------------------------------------------------------------------------------------------------------------------------------------------------------------------------
-------------------------------------------------------------------------------------o------------------------------------------------------------------------------------------------------------------
-------------X------------------------------------------------------------------------------------------------------------------------------------------------------------------------------------------
----------------------------------------------------------------------------------X-----------------------------------------------------------------------------------------XXXXXXX-----------------X---
--------------------------------------------------------------------------------------------------------------------------------------------------------------------------------------------------------
------------------------------------------------------------------------------------------------------------------------------------------------------------------------------------------------B------v
-----------------------------------------------------------------------------------?-------------------------------------------------------------------------------------------------------------T-----f
----B--------------------------------------------------------------------------------------------------------------------------------------------------------------------------------------------|-----f
-----------------------------------------------------------------------------------------------------------------------------------------------------------------------------------------------X-|-----f
-------------------------------------------------------------------------------------------------------------------------------------------------------------------------------------------------|-----f
--------------------------------------------------------------------------------T----------------------------------------------------------------------------------------------------------------|-----f
--------------------------------------------------------------------------------|-------------------------------------------------------------------------------------------------------BXBBT----|-----f
m-------------------------------------------------------------------------------|------------------------------------------------------------------------------------------E--EB--------XX--|----|-E---X
XXXX----XXXXXXXXXXXXXXXXXXXXXXXXXXXXXXXXXXXXXXXXXXXXXXXXXXXXXXXXXXXXXBBBBBBBBXXX|XX--------XXXXXXXXXXXXXXXXXXXXXXXXXXXXXXXXXXXXXXXXXXXXXXXXXXXXXXXXXXXXXXXXXXXXXXXXXXXXXXXXXXXXX--XXXXXXXXXX|XXXX|XXXXXX
