----------------------------------------------------------------------------------------------------B-----?---------------------X----------------------B------B-----------------------B-----------------
-----------------------------------------------------------------------------------------------------------------------oX-XBBBB-------B?--X?-XBXXXX-X----------B-B-----------------------BB-X-------?---
----------------------------------------------------------------------------------------------------------------------B-------------X-B---B--o???M?B?---X-----BXBBB-------------------------B---M--XB---
--------------------------------------------------------------------------------------------------------------------------------------T----?---T--?-----XT-XT-B---BMB--------------------------------B--
-------------------------------------------------------------------------------------------------------------------o------------------|B--X----|--T-----X|XX|XBoXXX-----------------X-----B-B----o----X-
------------------------------------------------------------------------------------------------------?------------T------------------|-XB----B|--|-XB---|--|--T---X---X----------------?????X--------X-
-To----------------------------------------------------------------------------------------------------------------|B-------MB--------|---TooX-|-X|XXXX-X|--|X-|------XX-----------------?---------B-XX-
-|-----------------------------------------------------------------------------------------------------------------|-------X-------X--|-BX|XXX-|--|-----X|X-|--|-B--BXXX-------------------M---------XXv
-|------------------------------------------------------------------------------------------------------????-------|X------XX-----M---|T-X|XXX-|o-|X---XX|X-|--|-BT-XXXX--------XM-----------B------XXXf
-|--------------------------------------------------------------------------------------------------X--------------|---B---XXX--B--B--||-X|XXX-|-X|---XXX|XX|--|--|XXXXX-------XX---------X--B-----XXXXf
-|--T-----------------------------------------------------------------------------------------------XX----X--------|-------XXXX-------||-X|XXXX|-B|--XXXX|XX|-T|--|XXXXX------XXX-----BT----------XXXXXf
-|--|o--------------------------------------------------------------------------------------------X-XXX--XX-----T--|---?---XXXXX--X---||XX|XXXX|--|-XXXXX|XX|X||-X|XXXXX-----XXXX------|---X--o-TXXTXXXf
-|--|--------------------------------------------------------------------------------------T--------XXXXXXX-----|-X|-----X-XXXXXXBXX-B||XX|XXXX|X-|XXXXXX|XX|X||XX|XXXXX----XXXXX------|---XX--M|XX|XXXf
-|--|--------------------------------------------------------------------------------------|----B---XXXXXXX-----|-M|----X-BXXXXTXXXXX-||XX|XXXX|XX|XXXXXX|XX|X||XX|XXXXX---XXXXXX------|---XXX-T|XX|XXXf
m|--|--------------------------------------------------------------------------------------|--------XXXXXXX-----|--|o--XX--XXXX|XXXXXX||XX|XXXX|XX|XXXXXX|XX|X||XX|XXXXX--XXXXXXX----E-|---XXXX||XX|XXXX
X|XX|XXXXXXXXXXXXXXXXXXXXXXXXXXXXXXXXXXXXXXXXXXXXXXXXXXXXXXXXXXXXXXXXXXXXXXXXXXXXXXXXXXXXXX|XXXXXXXXXXXXXXXXXXXX|XX|XXXXXXXXXXX|XXXXXX||XX|XXXX|XX|XXXXXX|XX|X||XX|XXXXXXXXXXXXXXXXXXXo|XXXXXXX||XX|XXXX
