--------------------------------------------------------------------------------------------------------------------------------------------------------------------------------------------------------
---------------------------------------------------------------------------------------------------------------------------------------------------------------------------------???--------------------
--------------------------------------------------------------------------------------------------------------------------------------------------------------------------------------------------------
-------X------------------------------------------------------------------------------------------------------------------------------------------------------------------------------------------------
------------------------------------------------------------------------------------------------------------------------------------------------------------------------------------------BBBBBBBB------
------------------------------------------------------------------------------------------------------------------------------------------------------------------------------------------------o-------
--------------------------------------------------------------------------------------------------------------------------------------------------------------------------------------------------------
-------------------------------------------------------------------------------------------------------------------------------------------------------------------------------------------------------v
-------------------------------------------------------------------------------------------------------------------------------------------------------------------------------------------------------f
------------------------------------------------------------------------------------XXXXX--------------------------------------------------------------------------------------------------------------f
-----------------X-------------------------------------------------------------------------------------------------------------------------------------------------------------------------------------f
----------------XX----------------------------------------------------------T--------------------------------------------------------------------------------------------------------------------------f
---------------XXX----------------------------------------------------------|--------------------------------------------------------------------------------------------------------------------------f
--------------XXXX----------------------------------------------------------|----------------------------------------------------------------------------------------------------------X---------------f
m------------XXXXX----------------------------------------------------------|---------------------------------------------------------------------------------------------------------XX---------------X
XXXXXXXXXXXXXXXXXXXXXXXXXXXXXXXXXXXXXXXXXXXXXXXXXXXXXXXXXXXXXXXXXXXXXXXXXXXX|XXXXXXXXXXXXXXXXXXXXXXXXXXXXXXXXXXXXXXXXXXXXXXXXXXXXXXXXXXXXXXXXXXXXXXXXXXXXXXXXXXXXXXXXXXXXXXXXXXXXXXXXXXXXXXXXXXXXXXXXXXX
