----o-o----------o-o-------------B---BBB-o-Xo------o---X-------------B-------B-o-B---------o---------o--------B---------------------X------oB--o---o--B---------B----------------------o--B--oo---B--X--
-----oooo-----oBB--o---ooo-------X--XB-B---oo---------------oo------X---o-----------B---B-----------X-oXB-----o---B--o-----------------o------------o-------------o---o-----Bo--o----------B----X------o
------B--------o-------o---B-------o--Bo---T-------------o-------B----o-B-----o-------BB--X--E-----------B--o---B----B------------o---B---B--------------------------------------o--------oE----o-B--o--
---o-o-----------X-B-------------Bo-----o--|----------o----------o-o----o-XB----------------o-o------oo-X-oBB-o---B---X--o---------X-o-oB------o--------------X-o-------o----B------B---B-----B---------
-o------------o---oo--------X---X--X----B--|---E-----B-B---X---B----B--o--o-------oo-------oXo----o---oo---Xo-Bo---o---B---------------X------X-X-B-o----o----------X-oo-----------B-Bo------------BB---
?-----o-X-------o-o-B-B---B---o--B----B---o|---B-----X-X-----X--B-----o----B---------o----o-------o-------o-------o-BE------X----------Bo----o-o--------------T--o-o------------X----o-B---------oo---B-
----------oo--Xo----X---------B-o--X-o----B|--------o-X-------------o----B--o---B-BX--------------X------XX--o-----o------o---X-----o----X-------B-o-Mo-------|-----oB-o-o-------o----o--Xoo-----o------
o----------oB----X----B-----------o--B---oB|-o--------XB-----B--X--BB-------o------------B--X-?o-o------------oB-B-oo--------o-o---o--------X--X----------o---|---BX-----B-o-------X--------B----Bo---Bv
-----o-B--BoB----B-------------------------|-oB---B-BooXo--o-----oBoo------o-oBB------X---o------o---------X----------------o--------o-------------o---------X|--BB---B-----B------------o---o----B-B-Xf
---B-----------------E----o--B-----------Bo|-------------X-X---B--------------o----Xooo-----B----X---------------------------------B--------B-o---------o-----|------X-X-----o----oo-------B-o----o-o-of
o--------------o---o--B-Eo-T-----B--B-oB---|--o----------------X-X-X--B------B----o------o--oB--B----------BB---B----B-o-----o-----------B-----X----------B---|-X----B-----X-o---X-------o---------X---f
-----o-----XX---o----------|---T-----E-B--X|-XB-o--X---o----o-o---B-------B----------------o------B----Xoo--------X----X--------o---X----o-----o-o-o-o------oo|---oXo-----B--------B-----------X---B--Xf
---------oo-------oo---B---|---|---o-------|---B---BB--B-----E-o--B---Bo---oB--o----Xo--E---B--------------o-o---X-------B----o---oo--B--o--o--o--------BB-o--|-o--o-----B---X------B----------o------Ef
-X--o-------o-o------o-----|---|-o-----B--B|---------BooB--------oB-X--o---B------------o-o---B------------B--Eo-B--X-----------o---X----Bo---B--o-X-B-B------|-o----oB---------B--o---X--X---XB------of
m-----------oo-o-----------|---|--B--------|-----X-----B---B---------E-ooo-X-B----o--B---EooX-B---E---------X-B--oX-o--Bo-Bo---------B-----Xo---o--B-o-X-o----|--E-----oE--ooX--------------o-----o-----
XXXXXXXXXXXXXXXXXXXXXXXXXXXXXXXXXXXXXXXXXXXXXXXXXXXXXXXXXXXXXXXXXXXXXXXXXXXXXXXXXXXXXXXXXXXXXXXXXXXXXXXXXXXXXXXXXXXXXXXXXXXXXXXXXXXXXXXXXXXXXXXXXXXXXXXXXXXXXXXXXXXXXXXXXXXXXXXXXXXXXXXXXXXXXXXXXXXXXXXX
