--------------------------------------------------------------------BBBBB----------------------------BBBBBBB---------------------------------??????-----------------------------------------------------
----------------?----------------------------------------XXXX--------------------???--------------------------------------------------X-------BBBBB-----------------------------------------------------
--------------------------BBBB--------------------------------------------------------------------------------------------------------------------------------------------------------------------------
-----?----------------------------------------------------------??????----o------------------???------------------------------------------------------------------------------------o-------------------
------XXX-XXXX--------------------------------------------------------------------X---------------BBBBBBBB----------------------------------------------------------------------------------------------
----------BBB------------------------------------------------------------------------------------XX--------------------------------------------BBB------------------------------------------------------
--------------------------------------------------------------------------------------------X-----------------------------------------------------------------------------------------------------XXXXX-
--------------------------------------------------------------------------------------XXX---------------------------------------------------------------------------------------------BB---------------v
-------------------------------------------------------------------------------------------------------------------------------------X-----------------------------------------------------------------f
---------------------------------------XXX------------------------------------------------------------------------------------------XX--------------------------------------------------------X--o-----f
-----------------------M---------------------------------------------------------?-------------------------------------------------XXX--------------------------------------------------------XX-X-----f
-B----???XXXXXXXX--------------------------------------------------------------------------------------B--------------------------XXXX--------------------------------------------------BBBBBBXXXXX----f
--------------------------????????------------------------------------------------------B----------------------------------------XXXXX-----------------------------------------------T--------XXXXXX---f
----------------------------------------???-------------------------------------------------------------------------------------XXXXXX-------------------X---------------------------|--------XXXXXXX--f
m----------------------------------------E-------E----------B-------------?????------------------------------------------------XXXXXXX--------E---------XX---------------------------|--------XXXXXXXX-X
XXXXXXXXXXXXXXXXXXXXXXXXXXXXXXXXXXXXXXXXXXXXXXXXXXXXXXXXXXXXXXXXXXXXXXXXXXX------XXXXXXXXXXXXXXXXXXXXXXXXXXXXXXXXXXXXXXXXXXXXXXXXXXXXXXXXXXXXXXXXXXXXXXXXXXXXXXX-----XXXXXXXXXXXXXXXX|XXXXXXXXXXXXXXXXXX
