---------------------------------------------BB----BBB?BB----------XXXX--------------------------------------------------------------------------------BBB----------------------------------------------
-------------------------------------??BBBBB?-----------------------------XXXXX-------BBBBBB-------------------------------------------------------------------------------------------------------X----
----------------------------------------------------------------BBBBBBB---------------------------------------------------------------------------------------------------------------------------------
--------------------------------------------------------------B-----------------------------------------------------------------------------------------------------------------------------------------
--------------------------------o-------------------------BB???BXXXXX-------XXX-------------------------------XXX----???????----------------------------------------------------------------------------
--------X----------------------??X??---------------X---------------------XXXX---------------------------------------------------????---------------------------------------------------????-------------
--------------------------------------X--------------------------------------?BB??------------???????---------------------------------------------------------------------------------------------------
--??????--------------------------BBBBB--------X------------------BBBB--------XXX------------------------------------????--------------------------o---------------------------------------------------v
-----------------------------???????---------BXBBBBB-----------X---?--XXXXX---------------------------------------------------------------------------?????--------------------------------------------f
-----------------------------------BBBBBBB-------------------------------------------------BBBBBBXXXXXXX-----------------------------------------------------------------------------------------------f
------------------------------------------------------------??BBBBBB-----------------------------?---------------XXX------------------------------------------------------------------------------M----f
--------T----------------------------------------------------------------------??------------------B-----------------------T---------------------------------------------------------------------------f
--------|---------------------------------------X-----------------T-------------X-------------------------------------X----|---------------------------------------------------------------------------f
-XX-----|-X------------------T---XXXXXXXX-------------------------|----??????--XXXXX---------------------------------XX--XX|XX------------------------------------------------------------M------------f
m-------|XX------------------|--E---B---XX-----------------E--XXXX|X---BBBB----E-------EE--------E------------------XXX----|-----------E---------------------------------------------------------------X
XXXXXXXX|XXXXXXXXXXXXXXXXXXXX|XXXXX--XXXXXXXXXXXXXXXXXXXXXXXXXXXXX|XXoXXXXXXXXXXXXXXXXXXXXXXXXXXXXXXXXXXXXXXXXXXXXXXXXXXXXX|XXXXXXXXXXXXXXXXXXXXXXXXXXXXXXXXXXXXXXXXXXXXXXXXXXXXXXXXXXXXXXXXXXXXXXXXXXXX
