----BBBB------------------------------------------------------------------------------------------------------------------------------------------------------------------------------------------------
--------------------------------------------------------------------------------------------------------------------------------------------------------------------------------------------------------
--------------------------------------------------------------------------------------------------------------------------------------------------------------------------------------------------------
--------------------------------------------------------------------------------------------------------------------------------------------------------------------------------------------------------
----BBBBBB----------------------------------------------------------------------------------------------------------------------------------------------------------------------------------------------
--???????-----------------------------------------------------------------------------------------------------------XXXXXXX-----------------------------------------------------------------------------
------------------------------------------------------------------------------------------------------------------------------------------------------------------------------------------?-------------
-------------------------------------------------------------------------------------------------------------------------------------------------------------------------------------------------------v
--------------------------------------------------------------------------------------------------------------------------X-------BBBB--------------------------------------o--------------------------f
----------------------------------------------------------------------------------------------------------------BB-------XXX-------------------------------------------------B----------X--------------f
-----------------------------------------------------------------XXXXXXXX-----------------------------------------------XXXXX---------------------------?------------------------------XX--------------f
------XXX-----------------------------T--------------------------------------------------------------------------------XXXXXXX-------------????????-----------------------------------XXX--------------f
-----XX-------------------------------|-------------------------------------------------------------------------------XXXXXXXXX-----------------------o------------------------------XXXX--------------f
--------------------------------------|------------------------------------------------------------------------------XXXXXXXXXXX----------------------------------------------------XXXXX--------------f
m-------------------------------------|---------------------------------------------------------------BBBBB---------XXXXXXXXXXXXX-------------X------------------------------------XXXXXX--------------X
XXXXXXXXXXXXXXXXXXXXXXXXXXXXXXXXXXXXXX|XXXXXXXXXXXXXXXXXXXXXXXXXXXXXXXXXXXXXXXXXXXXXXXXXXXXXXXXXXXXXXXXXXXXXXXXXXXXXXXXXXXXXXXXXXXXXXXXXXXXXXXXXXXXXXXXXXXXXXXXXXXXXXXXXXXXXXXXXXXXXXXXXXoXXXXXXXXXXXXXX
