-------------------------------------------------------------------------------------------------------------------------------------------------------------XXXXX--------------------------------------
-------BB---------------------------------------------------------------------------------------------------------o---BBBB----------------------------------?-------------------------------------------
----------------------------------------------------------------------------??----------------------------------------BBBBB-----------------------------------------------------------------------------
-------------------------------------------------------------------------------------------------------------------------------------------------------------------------------------------XX-----------
----------------------XXXXXXXX---------------------------------------------------------------------------------------------------------------------------------------------------o------------??--------
--------------------------------------------------------------------------------------------------------------------------------------------------------------------------------------------------------
---------------------------------------------------------------------------------------------------------------------------------X----------------------------------------------------------------o-----
-----------------------------------------------------------------------------------------------------------------------------------------------XXXXXX??????--------B-----------------------------------v
---------------------------------------------------------------------------------------------------------------------------------BBBB------------------------------------------------------------------f
--------------------------------------------------------------------------------------------------------------------------------------------XB---------------------------------------------------------f
----------------X------------------------------------------------------------------------------------------------------------XXXX-----------XX----------XX---------------------------------------------f
---------------XX---------------------------------------------------------------------------------------------------T-------BBBB------------XXX----------------------XXXXXX----------------------------f
--------------XXX---------------------------------------------------------------------------------------------------|------X----------------XXXX-----------------T-------------------------------------f
-------------XXXX---------------------------------------------------------------------------------------------------|-----------------------XXXXX----------------|----------???---------B--------------f
m-----------XXXXX---------------------------------------------------------------------------------------------------|-----------------------XXXXXX---------------|-------------------------------------X
XXXXXXXXXXXXXXXXXXXXXXXXXXXXXXXXXXXXXXXXXXXXXXXXXXXXXXXXXXXXXXXXXXXXXXXXXXXXXXXXXXXXXXXXXXXXXXXXXXXXXXXXXXXXXXXXXXXX|XXXXXXXXXXXXXXXXXXXXXXXXXXXXXXXXXXXXXXXXXXXX|XXXXXXXXXXXXXXXXXXXXXXXXXXXXXXXXXXXXXX
