--------------------------------------------------------------------------------------------------------------------------------------------------------------------------------------------------------
---------------------------------------------------------------------------------------------------------------------------------------------------M----------------------------------------------------
--------------------------------------------------------------------------------------------------------------------------------------------------------------------------------------------------------
--------------------------------------------------------------------------------------------------------------X-----------------------------------------------------------------------------------------
----????????--------------------------------------------------------------------------------------------------------------------------------------------------------------------------------------------
--------------------------------------------------------------------------------------------------------------------------------------------------------------------------------------------------------
--------------------------------------------------------------------------------------------------------------------------------------------------------------------------------------------------------
-----------------------------------------------------------------------------------------------------------------------BBBBBBB-------------------------------------------------------------------------v
-----------------------------------------------------------------------------------------------------------------------------BBB-------------------------------X------------------------------------B--f
--------------------------------------------------------------------------------------------------------------------------------------------------------------XX---------------------------------------f
--------------------------------------------------------------------------------------------------------------------------------X----------------------------XXX---------------------------------------f
--------------------------------------------------------------------------------------------------------------------T----------XX------------------------BB-XXXX---------------------BBBBBBB-----------f
--------------------------------------------------------------------------------------------------------------------|---------XXX--------------------------XXXXX--------T------------------------------f
----????????--------------------------------------------------------------------------------------------------------|--------XXXX-------------------------XXXXXX--------|-------------T---------T------f
m--X----------------------------------------------------------------------------------------------------------------|-------XXXXX????????-----------E----XXXXXXX--------|-------------|--BBBBB--|------X
XXXXXXXXXXXXXXXXXXXXXXXXXXXXXXXXXXXXXXXXXXXXXXXXXXXXXXXXXXXXXXXXXXXXXXXXXXXXXXXXXXXXXXXXXXXXXXXXXXXXXXXXXXXXXXXXXXXX|XXXXXXXXXXXXXXoXXXXXXXXXXXXXXXXXXXXXXXXXXXXX------X|--XXXXXXXXXXX|XXXXXXXX-|-XXXXXX
