------o------o---o-o--o----------B-----B-o-Xo------------------------B-------B--X-----oBX-oo--oo--B--o--------B-----------Bo-----o--X-------B--o--Bo--B---------B----------------------o-XB--oo------X--
----Bo-oo------BB-------o--------X-----B---o--------X-------oo-BB---X---X-o--------BBB--------------X-oBB---------B--o-o-------------oo-------------XB------------B---o---B-Bo----o----------------B----
------B--------X-------------------o---oX-XT-X-------E--o--------B-------oo---o---------B------o--------o-------B----B--------------B-B----------------X-----------------X----o--o--------E---B-o-B-----
------B-o---------oB-------o------o--------|---------Xo---------Eo-o------BB-----o---E------o--------o----Xo--?---B-------------------ooo------oXB---------o-EX----------o-B-B-----oB---Bo---B----B-----
-o------X-----o---E-------------o--B----Bo-|---------B-B-------B----B-----o---B---o--------oX-oB----o-B-X--Xo------o-----------------X-XB---B-----B-o---oo-o-----------------o---------------oB----B----
?o--X-o------E----o----------X---B---BB----|---B-----X-M-Bo--X--B-----B--X-B---o---X-o----o--------------ooX------o----X--------B--------B--oo--------B-------T-E----B-o--------XX---o----o-X----o---BB-
---------X-o--Xo------B---------o--X-oX---B|--B---o---X-------------o----B--------B--o---B--------X------Xo-----Xo-o-B---X----------o----X------oB----o-B-B---|-----BBo-o--------------oX-oo----o-------
o---o---B---oo---X----------------o--B-----|-------------X-------o-Bo----o--o------------B--X-----------------X--oooo---------Xo---X---o----B--X----o-----oo--|---BX---B-BX----------X----o------BoX--?v
---o--E---XoB----o------X--o---------------|-oB-----BooXX--oB--B-----X-------oBB----------B----B-o-----------------------o--o-----------o--------------oB-----|--o----------o--o-----------------oo----f
---B------X---o--o---B-o--o--B----------X--|----?--X----X-------------o-------o-o--X-oo-------E--Xo------------o----B--------------X--------B-----o-----------|---BB-XoX-----o----o--------B-o----M---of
o----------X-----o---B--oo-T--------B------|-Bo--X--------o----o-BB---B------Bo----o--------oB---X----B---------------Xo-o---o------X---o----B-------o-oo-B---|-X--B-B-------o--------o---o--------X-XEf
---o-------X----oE-o-B--o--|---T------oB--X|----o--XBM-o------o--B-----------------------o-o------B----ooo------o-X-------------o-XX----B---o-B-o--o-o---B--o-|----XB-----B---B----B-------B-B-X---o--of
--o----o--o-X------o---B---|---|--oo-X-----|----------oB-----B---o----o----o---o----Bo------o-------o-----------------------------oo--X--o----Xo------o-BB--B-|-oo-o-----B---XX-----B-X----------B-oB--f
-----------Xo--------------|---|-------B--o|---------B--B---oB---o--o--o-oB-o---o-------o-----B----------X-----o-B----o---o---B-o---o-o------oB-XoBXo-----X---|-oo---oB---B-o-----------B-X----BB---B-of
m-----EE--o----------------|---|--X----EB--|-B---------Bo-----------oE-o-o-X-B--o-o--BX--B--X--o--EB------o-oB--ooXE-o--E-B-------oo----B-----o-o----------E--|--o-----o-X-o-X-X----o?---B--XBE--B------
XXXXXXXXXXXXXXXXXXXXXXXXXXXXXXXXXXXXXXXXXXXXXXXXXXXXXXXXXXXXXXXXXXXXXXXXXXXXXXXXXXXXXXXXXXXXXXXXXXXXXXXXXXXXXXXXXXXXXXXXXXXXXXXXXXXXXXXXXXXXXXXXXXXXXXXXXXXXXXXXXXXXXXXXXXXXXXXXXXXXXXXXXXXXXXXXXXXXXXXX
