---o-o--B--o-------------B-----B---o-Bo----------------------oB------o-o-----------B-o---o-B-o-o-------B-o------B--------------B-B-B---------B---B----o--------B------o-----o-------------o----------B--
-o-o-------oo---------B-Bo--B---o---------o----Bo-Bo----B--oB-----------------o----B--o-Xo-----------------o---------------------o------o---o------o--o--o-BoB--o-----oo-----------X----Xo---X--------o-
-----XB--o-BB---------o--X--X---o--B------B---B-------o---o----o-oB-------------B-o---o---o-------------B-----ooo---------o-B------------------Bo---o------BX----------B--B-----------------B----------?
-----B--o---------oB--------------------o--------------B-o--------E--o--------Bo---o--X---X-XB-B-B---Xo----B-B-----o---E--------oB--B---o-------B-----o--o----X---oo------Xo---B-o--B---o-----X-------o-
--------------------------------o-o-----------------XB-o---------oB-----X---BX----o-o-----o-----o----o--------------X--o-----o------o----B------------B-X--o----o--B--o-B-X--B----------------o--------X
o--X-----o----------o--oB--o-----------------B-------------B----X----X-----ooo--------Xo-----Bo--o---------Bo----o----------o------BE-X-----------B---B-----------------o--------o----B-o-----B-----oBo-
B--o-oX------B-o----B---------o--B------o---Bo-----oB--o----o-----o-o----o----Bo----------o----oo-------o-o-E---o-------B-T-------o---o---------oo--oo--------------X--------o-B----o------B--?---------
---B--X-----B---------------oo-B-B---o-----------------o------?---------------B-B---o-----B-B-ooBo-------o-------------o-E|-o----B-------------o------B----X-oB--------------B----BB----------Eo----X--v
--B-B-----o--o--------B-B---------X----o------B---B------------------B--o---B----o-B-------o--B------oB--o---------B-----o|------------------B---oo----------E--Bo-BE--B--------oo----------Bo------B--f
----------X--Bo----o-----o--o-----------oX-----o-----------B----------o-o-o--oB-o-B--Bo--------B---X------------o-XoB-----|------B-o------B-----o----B-------X-o-----X---B-----B------o---------X---o--f
--BT--B---o------B-B-----------BB--------B-X-BT----------o-------------------------o----------o--o---o-----o---X-o---X----|-------o---------------B----------------o--o-X----o---------oo---o--o-o---o-f
B--|-------B-----------X--o-o--X--o-----------|--o---o-Bo-----------------o---oo--o-------------B--oB--o--X--B------B-----|----o--o--Bo---o----------o---X------B----o----?-B-X-----------XBo----------f
---|---B---B-B-B------------------oo----o----B|-----B-X------------------------?---o-o-B-----o----------o----X--X----B----|-----------o-B------------------B--o-----B------B--o--o---XE----B--X--------f
---|--Bo---B-----B----B--E-B-----o---o--------|-------oB-B-----o----o-----B-B-B-----oo------B-o-o--T----------------B----E|---Boo----o--o-------------o-B------------B----------------B--B------oXo----f
mB-|--o---o---X----oo--o------------------o---|--o-------------B-ooB--X----BX---o---ME-----oB------|-------oo-----E----B--|-E--------B---X-----E-----E-----o-------B----B-o-----oX-----B--B-------------
XXXXXXXXXXXXXXXXXXXXXXXXXXXXXXXXXXXXXXXXXXXXXXXXXXXXXXXXXXXXXXXXXXXXXXXXXXXXXXXXXXXXXXXXXXXXXXXXXXXXXXXXXXXXXXXXXXXXXXXXXXXXXXXXXXXXXXXXXXXXXXXXXXXXXXXXXXXXXXXXXXXXXXXXXXXXXXXXXXXXXXXXXXXXXXXXXXXXXXXX
