--------------------------------------------------------------------------------------------------------------------------------------------------------------------------------------------------------
--------------------------------------------------------------------------------------------------------------------------------------------------------------------------------------------------------
--------------------------------------------------------------------------------------------------------------------------------------------------------------------------------------------------------
--------------------------------------------------------------------------------------------------------------------------------------------------------------------------------------------------------
----------------------------------------------------------------------------------------------XBoBBBB-XXXXXX--------------------------------------------------------------------------------------------
--------------------------------------------------------------------------------------------------------------------------------------------------------------------------------------------------------
--------------------------------------------------------------------?????-------------------------------------------------------------------------------------------------------------------------------
-------------------------------------------------------------------------------------------------------------------------------------------------------------------------------------------------------v
-----------------------------------------------------------------------------------------------------XX-----------------------????????-----------------------------------------------------------------f
----------------------------------------------------------------------------------------------------------------B--------------------------------------------------------------------------------------f
------------------------------------------------------XXX----------------------------------------------X-----------------------------------------------------------------------------------------------f
-------------------------------------------------------------------------------------------?--T--------XX------------------------------T-----?---------------------------------------------------------f
----------------------------------------------------------------------------------------------|--------XXX-----------------------------|---------------------------------------------------------------f
----------------------------------------------------------------------------------------------|--------XXXX----------------------------|---------------------------------------------------------------f
m------------------------------------------------------------------------------------??????---|--------XXXXX????--------------????-----|---------------------------------------------------------------X
XXXXXXXXXXXXXXXXXXXXXXXXXXXXXXXXXXXXXXXXXXXXXXXXXXXXXXXXXXXXXXXXXXXXXXXXXXXXXXXXXXXXXXXXXXXXXX|XXXXXXXXXXXXXXXXXXXXXXXXXXXXXXXXXXXXXXXX|XXXXXXXXXXXXXXXXXXXXXXXXXXXXXXXXXXXXXXXXXXXXXXXXXXXXXXXXXXXXXXXX
