-------------------------------------------------------------------------------------------------------------------------------------------------------------------------------------------?------------
--------------------------------------------------------------------------------------------------------------------------------------------------------------------------------------------------------
--------------------------------------------------------------------------------------------------------------------------------------------------------------------------------------------------------
--------------------------------------------------------------------------------------------------------------------------------------------------------------------------------------------------------
--------------------------------------------------------------------------------------------------------------------------------------------------------------------------------------------------------
---------------------------------------------B----------------------------------------------------------------------------------------------------------------------------------------------------------
-----------------------------M-----------------------------------------------------------------X------------------------------------------------o-------------------------------------------------------
-----------------------------?----------------------------------------------------------------XX-------------------------M-------------------------------------------X---------------------------------v
---------------------------------------------------------------------------------------------XXX-------------------------------------------------------------------------------------------------------f
--------------------------------------------------------------------------------------------XXXX------------------------------?------------------------------------------------------------------------f
-------------------------------------------------------------------------------------------XXXXX---------------------M---------------------------------------------------------------------------------f
--------------------------------------------------?---------------------------------------XXXXXX------------------------------------------------o------------------------------------------------------f
-----------------------------------------------------------------------------------------XXXXXXX-------------------------------------------------------------------------------------------------------f
----------------------------------------------------------------------------------------XXXXXXXX-------------------------------------------------------------------------------------------------------f
m--------------------------------------------------------------------?-----------------XXXXXXXXX-----------------------------E------------------------------------------------------------------------XX
XXXXXXXXXXXXXXXXXXXXXXXXXXXXXXXXXXXXXXXXXXXXXXXXXXXXXXX----XXXXXXXXXXXXXXX?XXXXXXXXXXXXXXXXXXXXXXXXXXXXXXXXXXXXXXXXXXXXXXXXXXXXXXXXXXXXXXXXXXXXXXXXXXXXXXXXXXXXXXXXXXXXXXXXXXXXXXXXXXXXXXXXXXXXXXXXXXXXX
