---------------------------------------------------------------------------------------------------B-B----------o-B-X---?---B---------X--------------------------X---------------X-----?-----X----------
----------------------------------------------------------------------------------------------X------?----------------B----?---------------------------X------------------------------------------------
---------------------------------------------------------------------------------------------------------------------X----X-X----------XB---X------M----------------B----------------------BBBB------B--
--------------------------------------------------------------------------------------------X--X----T------X------o-------B---------------------?X---B---------M------------------o--X-XX---------------
---------------B------------------------------------------------------------------------------------|-BT--X----------------------------X--X------------B-o--------B-------------------------------------
----------B--------------------------------------------------------------------------------------X-?|--|-X--XX----------X----X----X------XX---X------------X-------------------M--B-B--------------M----
----------------------------------------------------------------------------------------------------|--|-XT----XBBBBTBB----o-XX-X-------XXX-------------------------B-----------X-X--------------BB---X-
----------------------------------------------------------------------------------------------------|--|X-|-B-X-----|--------XXX-------XTXX-----------X---------X--------------X--XX------------------Xv
--------X------------------------------------------------------------------------------------------X|--|-X|------B--|--------TXXX-----XX|XXX----------XX--------------------------XXX-----------------Xf
---------------------------------------------------------------------------------------------------T|--|--|------X--|----XXX-|TXXX-B-XXX|XXXX-------XBXXX---------------T---B-----XXXX--X-------------Xf
------------------------------------------------------------------------------------------------T--||--|?-|---------|--BXBBB-||XXXX-XXXX|XXXXX------XXXXXX------T--X----|------X-TXXXXX-------B-------Xf
----------o--------------------------------------------------------------------------------XXX--|--||-X|X-|---X-X---|X-XX----||XXXXXXXXX|XXXXXX-----XXXXXXX-?--X|XXX----|--------|XXXXXX------------X-Xf
---------------------------------------------------------------------------------------------?--|--||XX|X-|---------|-XXX----||XXXXXXXXX|XXXXXXX-X--XXXXXXXX--XX|XXX----|--------|XXXXXXX-----------XXXf
----------B-------------------------------------------------------------------------------------|--||XX|X-|-X-----T-|TXXX----||XXXXXXXXX|XXXXXXXXX--XXXXXXXXXXXX|XXX----|--------|XXXXXXXX----------XXXf
m----------------------------------------------E------------------------------------------------|--||XX|XB|B-X-E--|-||XXX----||XXXXXXXXX|XXXXXXXXX--XXXXXXXXXXXX|XXX----|-----E--|XXXXXXXXX---------XXXX
XXXXXXXXXXXXXXXXXXXXXXXXXXXXXXXXXXX------XXXXXXXXXXXXXXXXXXXXXXXXXXXXXXXXXXXXXXXXXXXXXXXXXXXXXXX|XX||XX|XX|X-XX---|X||XXXXXXX||XXXXXXXXX|XXXXXXXXXX-XXXXXXXXXXXX|XXXXoXX|XXXXXXXX|XXXXXXXXXX-XXXXXXXXXXX
