-------X-----------------------------------------------------------------------------------------------------------------------------------------------------------------------------?------------------
--B----------------------------------------------------------------------------------------------------------------------------------------------------------------------------------M------------------
-----------------o---------------------------------------------------------------------------------------------------------------------------------------------------------------------B----------------
-----B-B------------------------------------------------------------------------------------------------------------------------------------------------------------------------------------------------
-----B----B--------------------------------------------------------------------------------------------------------------------------------------------------------------------X---------T--------------
-----------------------------------------------------------------------------------------------------------------------------------------------------------------------------------------|--------------
----------X---------------------------------------------------------------------------------------------------------------------------------------------------------------------X--M-----|--------------
----------XX-----------------------------------------------------------------------------------------------------------------------------------------------------------------------------|-------------v
----------XXX----B-----------------------------------------------------------------------------------------------------------------------------------------------------------B-------T---|--------X----f
----------XXXX-----------------------------------------------------------------------------------------------------------------------------------------------------------------------|---|--------XX---f
----------XXXXX----------------------------------------------------------------------------------------------------------------------------------------------------------------------|---|--------XXX--f
----------XXTXXX------o--------------------------------------------------------------------------------------------------------------------------------------------------------------|---|----T---XXXX-f
----------XX|XXXX--------------------------------------------------------------------------------------------------------------------------------------------------------------------|--o|--X-|---XXXXXf
----------XX|XXXXX-------------------------------------------------------------------------------------------------------------------------------------------------------------------|---|----|---XXXXXf
m--E------XX|XXXXXX-----------------------------------------------------------------------------------------------------------------------------------------------------------------E|X--|-E--|E--XXXXXX
XXXXXXXXXXXX|XXXXXXXXXXXXXXXXXXXXXXXXXXXXXXXXXXXXXXXXXXXXXXXXXXXXXXXXXXXXXXXXXXXXXXXXXXXXXXXXXXXXXXXXXXXXXXXXXXXXXXXXXXXXXXXXXXXXXXXXXXXXXXXXXXXXXXXXXXXXXXXXXXXXXXXXXXXXXXXXXXXXXXX-|---|--X-|B--XXXXXX
