---------------X-------B-----------------------------------------------------------------------------------------------------------------------------------------------------------------------------B--
--------------------------------------------------------------------------------------------------------------------------------------------------------------------------------------------------X-----
--------------------------------------------------------------------------------------------------------------------------------------------------------------------------------------------------------
------------------------------------------------------------------------------------------------------------------------------------------------------------------------------------B-------------B-----
----------------------------------------------------------X----------------------------------------------------------------------------------------------------------------------------------??B?X??----
---X---B-------------------------------------------------------------------------------------------------------------------------------------------------------------------------------X--------T-------
---------------------------------------------------------------------------------------------------------------------------------------------------------------------------------------XX-------|B--TM--
---------------------------------------------------------------------------------------------------------------------------------------------------------------------------------------XXX------|---|--v
--------------------------------------------------------------------------------------------------------------------------------------------------------------------------------------TXXXX--X--|---|--f
-X------------------------------------------------------------------------------------------------------------------------------------------------------------------------------------|XXXXX-XX-|---|-Bf
--------------------------------------------------------------------------------------------------------------------------------------------------------------------------------------|XXXXXXXXX|---|--f
--------------------------------------------------------------------------------------------------------------------------------------------------------------------------------------|XXXXXXXXX|---|--f
--------------------------------------------------------------------------------------------------------------------------------------------------------------------------------------|XXXXXXXXX|X--|--f
--------------------------------------------------------------------------------------------------------------------------------------------------------------------------------------|XXXXXXXXX|XX-|--f
m------------E-----------------------------------------------------------------B------------------------------------------------------------------------------------------------------|XXXXXXXXX|XXX|--X
XXXXXXXXXBXXXXXXXXXXXXXXXXXXXXXXXXXXXXXXXXXXXXXXXXXXXXXXXXXXXXXXXXXXXXXXXXXXXXXXXXXXXXXXXXXXXXXXXXXXXXXXXXXXXXXXXXXXXXXXXXXXXXXXXXXXXXXXXXXXXXXXXXXXXXXXXXXXXXXXXXXXXXXXXXXXXXXXXXXXXX|XXXXXXXXX|XXX|--X
