---o----B--------------oo------------------------------o-------------B---X--o------o---------------------------------------o-o-----------------------BB--o-B-----------B--------------------------B-----
----oE-----------o-B----------oo--B----o----------------------------X---B-o--------o---B----B---------oB-----E----o--------o-----B--o--B-o--X--------------------B------o-------B--------oXEXX----------
---------------XB------B------------o-oX------o---o-----B------X----------------------------B----B--o----o-X-o-o-----o----------B-----------------X------B--------------o------ooo---X---o-----oBoo-----
-----------o---o--------------B---------o-Bo-------------BBo-------B----------B-------o-oo-------B-o-----o---o-------Bo-------o-----o-----o--XBM-------o-o--X----------------o-------B---X--------------
--B-E---------o-------o--------B-----o------------o---o--B-------o-o----------------------o---E--B---B--B--o-o------X--------------------o-B----oo-------o-------------X---------o------?---B--------o--
--o-----B--------------------------o--oo-------------B-X----o---X------------o---o--B---o------------Bo---B--B--------o--------E-------B-----------o-XB-B----oX---o-------oB--------X----o-oo-----------
--B-B--------X--X-E-B------?----o--------XEo---------B---------B-B----------------------X---B---o----------o-o--o----o-o---oo-B-X---Mo--o----------o----------X-------B--X--------------o-----B---------
----X---B--------X-o---------B--B------B------B--------o----o---X---o------B--B-o-------X------o---------o---------------o-------o-B--o--BBB-----------o----------------------------oB-X--o-----o------v
----oB---BB--o----BX---B-Bo-----------------oX-------o-o-X--o-------------B-------oBo-------------------------X--B---o---B----------------------------o------X-----o--o----o---------------------------f
--oE----B-------o------ooX---------B-------B---o----X-----o-oB-------------?-------B----B---o--------o-------o--------X---------------------B-o---B----B-----o---------------Bo-o------o--X-B-o-X----o-f
--E------o-------------X--------------------------X------o--B-o-X-----B-oB--------------o-----------X-------B--oo-----B--o--------X-----------------BB--BB-oo---------Xo------BX--------o---Boo--------f
---------X-------------o-----o------oX-----ooo--o---------------------------E----B-o-------------------B----o---B-----o------------------?o----o---E-----------------B------------------B---X--------B-f
---------o-B--X----o--------------------------B----o---B--------B--oo-----B------o--------o-o--o---------o-o------------oo------------X---------o-----------oo-o---------o--B------B-----------B-------f
---------------o-----------E-----o---------------oB---oo-------------------o-----------o-o--B------------o--------o------------o---------o---o-------B----------?---------o-------------o-o-o----------f
m---E-----------E-----B--oo---o--o----o---B---Xo------EB--o---B---B----B-o-------------------o--------oBo----Boo--oo------oB---------o-------X--------------o-------------oo----X-oB---X---------o-----X
XXXXXXXXXXXXXXXXXXXXXXXXXXXXXXXXXXXXXXXXXXXXXXXXXXXXXXXXXXXXXXXXXXXXXXXXXXXXXXXXXXXXXXXXXXXXXXXXXXXXXXXXXXXXXXXXXXXXXXXXXXXXXXXXXXXXXXXXXXXXXXXXXXXXXXXXXXXXXXXXXXXXXXXXXXXXXXXXXXXXXXXXXXXXXXXXXXXXXXXX
