--o------X---E------o----BX-o----------------B----------------------X---o-oo------o-------o------o-----------T----o?-------------X---o---X---E---XXo-o--o----X-B-B-------B----oo----oo-B------------o---
--o---BB-----B---o-------------------------o-o-o------T--oB---------------B-----------------B-oo------o-Xo---|----------Xo--o-BX---------B-B-B------B-B-oXX-----------B---Bo?o-o-o---o---oo----o---o-o--
--Bo--BB-----------------------Bo----o----------------|---------------------o--o-------------o--o-o---X------|-----B-o--------o-------------o-------Xo----o--E-------------------------o----------------
-----oo---------X------B-X--oXXo-----T-------o-------B|----o-o----------o-------X------o----------o------o---|---X-----o-----------B---------o--------o-o----B-B----------------E-----------o-BX------o-
-X--o----B--B--o------o--B--X--XB----|-----oo--B---B--|----B-----oX--------------X------o-----------o------B-|-----o--o--B--Eo-----------BX------B-------o-------B------X--o----B--o-----o---o-o--------
--BX-o--o--------X--------------o----|----------X-----|-------o---Bo----B-----oX----o---------o--X-----------|---o--o--B-X--X--X---Xo-------B--o-B-------X--o-------------o--------o----------------B---
----B-BB--------------------B----oB--|--o--X----------|-o----------------B-----o---------oo----------B-------|----------Bo-E---------------o------oX------------o-----B---------------B---?-----o-o-----
-o------o-B-o-----B-B-----o--oo------|--------X--E----|-----o-------o---B-Bo---o-oX--------BB----o--X--o--o--|--oX---------B-----B-----oX--XB--------------oB------o-o---o-o-X--------------------o----v
--X-o-------o--------------------X--B|-------X---B-o--|---------E--X-----------o----------B---X------?------o|-B-----X----------o--B-------o-----X----BX----------o---------o-------o----------------BXf
-----oX-o----o--oo------oo-o----oB---|--o-------------|-------BoX------------------B-------------oB----------|----------E-------B---------B---------X-o--B-Xo-----o--o--o--o--o-Bo?-o--o--o---BBX------f
-o-----------B----B--------o-----B---|----T--BX-X-oB-o|-----o--o-o-------o-----------oB--o-B--------E-o---Bo-|----------Bo-------------B-X----o-------B-B-X-----oB---o-----------B-B----ooB--------Boo-f
----------------o--X---------------o-|----|----o------|--Bo---------o-----o--X------o-B--------X----BX----oo-|--oB--o--X-Bo-o---o-B----B--oB-o----------o--o--B---oBo--B----T-B-o--B----X-o-----oo-----f
-------B----o--------X------o--X-o---|--B-|--B--------|-B----------oB------------T----BX------BB---o-------B-|-------------------o-----X-------o-----------B---------------o|----------B-----X----?o---f
B----BT--B--o------o---B-------EoB---|----|---------Xo|-----------Xo-B-X--o------|----BoXoo-o--o-------------|-----------B-o---o-o-E---------o-X---E----X-EB-B---------X--oo|----------B------X-o----E-f
mo-T--|-o----------------------X-o---|---o|--o-BE---B-|---o------B--o---o-BX---EB|--------o---E--o----o-----o|--o---o-X-B---o----XEXo---o--T------oXXB----B-Eo----X-B---B---|----o-----o------o------B-X
XXXXXXXXXXXXXXXXXXXXXXXXXXXXXXXXXXXXXXXXXXXXXXXXXXXXXXXXXXXXXXXXXXXXXXXXXXXXXXXXXXXXXXXXXXXXXXXXXXXXXXXXXXXXXXXXXXXXXXXXXXXXXXXXXXXXXXXXXXXXXXXXXXXXXXXXXXXXXXXXXXXXXXXXXXXXXXXXXXXXXXXXXXXXXXXXXXXXXXXX
