X---o----------------oo----o-----BBo------X-o-------o---o---X-B---------B---------X-o------X-X-X-------Bo---B----B----B----o---B-----B------X----------o-------------oB----X---o-o------BB--T---oo------
------o--o--o--o---o--o--------E-B--o--------------o-B-o-----X-o--B-oX----BooX-o---o---o-------B-----o-oo--------------------oo-----X-------oo---------X--BX-----o-o--------X----o----------|-------o---
------------X-------ooB-X---Xo-XB-B--B----------o-B-----B------------B--------oooX------BoB--B----X-------X---oX---oX----oB--oo----B-o-------------------o---X--o--------X------o-X--B-XB-X-|-o-------X-
X---B-Bo------Xo-----X-----o-o--o----X-oo--o----B--o------B------oo-----X----o-o--ooB------------o--------------------BB---B--o-------X-o--B----B--B----X-o----BoB-----------B---------oX---|--B--------
-X----ooB------o-B---X-----------o--X--------o-------o------o-o----o------------------------B--------B-------o---X-----o------B---------o---X-----o----oo-X----o-BB---X-X-------------B-----|---B--o----
-T-o----B---o----o-oo----------o-----B------o-o--oBo----X---------X-B---------o---o-------ooB--------o-------------X------------oo------------B--X--oBo-B----------B--B---B--------o-oB---X-|---T----B--
B|-X------o---B------oo----o--X--X-o----B---B-E--X-o----B-B-------Bo----------o---------Xo---------B--o-o-X----------o---B-B------o--o-----B-----------B--B----BBBo--B------o-------oX-o----|-o-|----B--
-|-B-X---oo-----------XBX---------o----X-------oo----Bo---------------o----X-------o----B--o--------o------B-X-----------------o----o----------B-----o--o-B-----------Bo-----o----B-B---X---|---|------v
B|-------B---T-----o----Bo----------o-o-o------------------o--B-------oB-----------BB-------B-B--Mo-o---o--------------o---------o-o-BoB--M-o--------oBo-B---------XB--oB---------------o--o|---|----o-f
-|--B-o-o----|--X-----Bo-o--B----o---B-----------ooX--X----o-----B----o--------------------B-------------o--o---o-----------------o---o-------X----oX-o-----------E--XB-----------o--o------|-oB|------f
o|-------o---|------B----B--o---o-o-------E-B------o-----------B----------o-----------X------------------o-------B--o-----------o---------o-------o--o----X-E---B-----------B--o-------B----|---|---B-Ef
-|-------X-B-|--BXX-----B---------o-------o--B-oX----B----o----B--o-----B---------B------X-o----------B---BB------------BB--B--o---Bo-o--------------------------B-----------------oo----B--|---|---Bo-f
-|------B----|--------B------------X------BX----------o-------Bo-----X--B--B--B--B-X--o----oo----B--X---B-o---T-o-B---X-o------B-----------X-------B-o----E-----o---------B---X----o--o-----|--B|------f
-|-oXB-------|-----------oB------B-oX----------------------o----------B---------B------------o-B-o-----o------|---oo---------------T-----o-B-------B--o---o--o--o-------------X-------o----B|-B-|-----of
m|-----oB----|-o---------Xo-----oB----B-XoB----o----B---E-----o--B---o-o----------------o---E--o---E----------|-o-----o---o-------o|---o---------BEo------------oo-B------E--------o--o---Bo|--o|-------
XXXXXXXXXXXXXXXXXXXXXXXXXXXXXXXXXXXXXXXXXXXXXXXXXXXXXXXXXXXXXXXXXXXXXXXXXXXXXXXXXXXXXXXXXXXXXXXXXXXXXXXXXXXXXXXXXXXXXXXXXXXXXXXXXXXXXXXXXXXXXXXXXXXXXXXXXXXXXXXXXXXXXXXXXXXXXXXXXXXXXXXXXXXXXXXXXXXXXXXX
