---------------------------------------------------------------------------------------------------------------------------------------------------------------------------------------------BBBBBBBB---
---------------------------------------------------------------------------------------------------------------------------B----------------------------------------------------------------------------
-o------------------------------------------------------------------------------------------------------------------------------------------------------------------------------------------------------
--------------------------------------------------------------------------------------------------------------------------------------------------------------------------------------------------------
--------------------------------------------------------------------------------------------------------------------------------------------------------------------------------------------------------
---------------BBB---------------------------------------------------------------------------------------------------------------------------?----------------------------------------------------------
--------------------------------------------------------------------------------------------------------------------------------------------------------------------------------------------------------
----------------------------------------------------------------------------------------------------------------------------------------o--------------------------------------------------------------v
----X-------------------------------------------------------------------------------------------------------------X------------------------------------------------------------------------------------f
------BBBBBB---------------------------------------------------------------------------------------------------------------------XXX-------------------------------------------------------------------f
--------????????------------------------------------------------------------------------------------------------????--------------??????--------------------------------------BBBBBBBB-----------------f
----------------------------------------------------------------------------------------------------------------------------?--------------------------------------------------------------------------f
---T--------------------------------------------------------------------------------------------------------------------------------------------X----------------T-------------------------------------f
---|--------------------------------------------------------------------------------------------------------------------??---------------------XX---------------T|-------------------------------------f
m-E|---------------------------------------------------------------------------------------------------------------------------------------E--XXX---------------||--E----------------------------------X
XXX|XXXXXXXXXXXXXXXXXXXXXXXXXXXXXXXXXXXXXXXXXXXXXXXXXXXXXXXXXXXXXXXXXXXXXXXXXXXXXXXXXXXXXXXXXXXXXXXXXXXXXXXXXXXXXXXXXXXXXXXXXXXXXXXXXXXXXXXXXXXXXXXXXXXXXXXXXXXX||XXXXXXXXXXXXXXXXXXXXXXXXXXXXXXXXXXXXXX
