--------------------------------------------------------------------------------------------------------------------------------------------------------------------------------------------------------
---------------------------------------------------------------------------------o--------------------------BBBB----------------------------------------------------------------------------------------
-XXXXXXX------------------------------------------------------------------------------------BBBBBBBB-------------------------------------------------o--------------------------------------------------
--------------------------------------------------------------------------------------------------------------------------------------------------------------------------------------------------------
-------------------------------------------------------------------------------------------------------------------------------------------------------------o------------------------------------------
--------------------------------------------------------------------------------------------------------------------------------------------------------------------------------------------------------
--------------------------------------------------------------------------------------------------------------------------------------------------------o-----XXXXX-------------------------------------
-------------------------------------------------------------------------------------------------------------------------------------------------------BBBBBB------------------------------------------v
-------------------------------------------------------------------------------------------------------------------------------------------------------------------------------------------------------f
---------------------------------------------------------------------------------------------------------------------------------------------------------------------o---------------------------------f
--------------------------------------------------------------------------------------------------------------------------------------------------------XXXXXXX----------------------------------------f
---------------------------------------------------------------------------------------------------------------------------------------------------------------------------X---------------------------f
--------------------------------------------------------------------T-----------------?---------------------------------------------------------------BBBBBBB------------TXX---------------------------f
--------------------------------------------------------------------|---------------------X-------------------------------------------------------XXXX---------------T---|XX---------------------------f
m-------------------------------------------------------------------|------------------------------------------------------------------------------------------------|--X|XX---------------------------X
XXXXXXXXXXXXXXXXXXXXXXXXXXXXXXXXXXXXXXXXXXXXXXXXXXXXXXXXXXXXXXXXXXXX|XXXXXXXXXXXXXXXXXXXXXXXXXXXXXXXXXXXXXXXXXXXXXXXXXXXXXXXXXXXXXXXXXXXXXXXXXXXXXXXXXXXXXXXXXXXXXXXX|XXX|XXXXXXXXXXXXXXXXXXXXXXXXXXXXXX
