--------------------------------------------------------------------------------------------------------------------------------------------------------------------------------------------------------
--------------------------------------------------------------------------------------------------------------------------------------------------------------------------------------------------------
--------------------------------------------------------------------------------------------------------------------------------------------------------------------------------------------------------
----------------------------------------------------------------------------o---------------------------------------------------------------------------------------------------------------------------
--------------------------------------------------------------------------------------------------------------------------------------------------------------------------------------------------------
--------------------------------------------------------------------------------------------------------------------------------------------------------------------------------------------------------
--------------------------------------------------------------------------------------------------------------------------------------------------------------------------------------------------------
-------------------------------------------------------------------------------------------------------------------------------------------------------------------------------------------------------v
-------------------------------------------------------------------------------X-----------------------------------------------------------------------------------------------------------------------f
---------------------------------------------------------?--------------------XX-----------------------------------------------------------------------------------------------------------------------f
-----------------------------------------------------------------------------XXX-----------------------------------------------------------------------------------------------------------------------f
----------------------------------------------------------------------------XXXX-----------------------------------------------------------------------T-----------------------------------------------f
-------------------------------B-------------------------------------------XXXXX-----------------------------------------------------------------------|----------------------------------------T------f
--------------------------------------------------------------------------XXXXXX----------------------------------------B------------------------------|----------------------------------------|------f
m-----------------------------------------E------------------------------XXXXXXX-----------------------------------------------------------------------|--------------E-B-----------------------|------X
XXXXXXXXXXXXXXXXXXXXXXXXXXXXXXXXXXX-------XXXXXXXXXXXXXXXXXXXXXXXXXXXXXXXXXXXXXXXXXXXXXXXXXXXXXXXXXXXX--XXXXXXXXXXX--------XXXXXXXXXXXXXXXXXXXXXXXXXXXX|XXXXXXXXXXXXXXXXXXXXXXXXXXXXXXXXXXXXXXXX|XXXXXXX
