----------------------o---------------o----------X-------------o---------------------o----oo-----------------------B-----o----------------------B----------------------------------------X------------X-
----------------------o----B---Bo---B------------oBo--------------------o---o----o------------X------------oo---------------o---o------o-------------B-B---------X-----------B----B--------o--------o---
-------X----o------X-------------o---oB----B------B-B----B--------o--BX----------------o---o-----------o------------BB--B-------------------------B-B--BB-X-----------o---------------o--------Boo------
---B------B--Bo----o----------o-----------B-------------B---BB----------B-----------X----o-X----o-------B-----o-E--------oo-----B------X-o-----o----o--B-B----------------------X----Bo--o-o------------
--B-----------o----B--o-----X-oB--o---------o--X-------------Bo-B-----Bo--X-------o-o----B---------o---------X------E-B------------oo--X---X--o-oo-----------X---------oB-----------B-B-------------B---
-----B-----------B--------------------B------------o-------o-X--B-oo-B----o------oXo--------------------------o------o----B--B------o-------------oo---X-------o---------X-------o-B---X-----X--X--oo---
-----X--B------------X----------o-o-------X---------o---------B---o--o-----o---X-B-------oXX---o--------o---------------------o-o-------------------X----------o--X----------B---o------oX--B-B---------
----o-----------o------B---B-E------o--------o---o-------o-o--o-----oo----o-----------------------------------o----Bo--------------o-oX--oo-o---------X-B--B----X----------o--B---------------B--------v
-----B-------------o----------o--------------B--X-----o--o---B--E-------Eo---------o----B--o-------o--o--E--o---EB--X--------oo----o-----------o----o---B---B--------o--------------B--o------o------o-f
----Bo-X-------o-o--B--------B------o---o--------------------o----B--o--B----------------B--o---o-------B-----------------------oX---o-----oB---------E--------oBo-----oo------B---------------o-------f
-o---------------X-o----------o-----o-X-----------------o-BB-X-?o----------------------B---B---o--------oX------oB-B-------------X-o-----oo-------o--------------------o--o---oo-----------B--o--o---oof
-------------B-------B-o----------------------------------E---X-----o----------------B--X-B--------o-----o-X---oX-----------------------------o--B--X---BB---B----oX------------o-------EBo----B---ooo-f
-----------X---o--------BX----------BX-X---o-------------X------------------B---o-----o---o----B-o---XE-Bo----o------------------B------o-Xo-oX---------o-----o--o-o--------XEB-X-------B------X-------f
---o----------B---o-BB-BX-------oX----B----o--BB---o------X-------X-o----o---o---o---oXB-o-------B-o--B------ooo-------B-----o--------------------------E--------B-----o----------X-----------o--E-----f
m-----B-o-o------B---B-B---B------oo--o--------oEo---B-B--o---------------o--------------o------X---------------o-B--E--------X----M----E--E------X--------BB----o-oEBB-------E--EX---------X-----o-X---
XXXXXXXXXXXXXXXXXXXXXXXXXXXXXXXXXXXXXXXXXXXXXXXXXXXXXXXXXXXXXXXXXXXXXXXXXXXXXXXXXXXXXXXXXXXXXXXXXXXXXXXXXXXXXXXXXXXXXXXXXXXXXXXXXXXXXXXXXXXXXXXXXXXXXXXXXXXXXXXXXXXXXXXXXXXXXXXXXXXXXXXXXXXXXXXXXXXXXXXX
