-------------------------------------------------------------------------------------------------------------------------------------------------------B-----B---------------X--------------------------
----------------------------------------------------------------------------------------------------------------------------------------------------------X-----X---------------------------------------
------------------------------------------------------------------------------------------------------------------------------------------------------X---o------------------------------------B--------
--------------------------------------------------------------------------------------------------------------------------------------------o------------------------------B-------------------------B--
---B-----------------------------------------------------------------------------------------------------------------------------------------------------------------------------------------X----------
--------------------------------------------------------------------------------------------------------------------------------------------------------------------------------------------------------
-------------------------------------------------------------------------------------------------------------------------------------------------------------------------------X------------------------
----------------------------------------------------------------------------------------------------------------------------------------------BBBB------B----T--X-----------------------XXX------------v
-------------------------------------------------------------------------------------------------------------------------------------X--------B--------------|--XX-----------------------------B----M--f
-----------------------------------------------------------------------------------------------------------------------------------------------X-------------|--XXX--X---------X-X---------------------f
--------------------------------------------------------------------------------------------------------------------------------------------------B----------|--XXXXXX-o--------XX--o---------------X--f
----------------------------B--------------------------------------------------------------------------------------------------------------------------------|--XXXXXXX--------XXX---------------------f
-------------------------------------------------------------------------------------------------------------------------------------------------------------|-oXXXXXX--------XXXX---------------------f
-------------------------------------------------------------------------------------------------------------------------------------------------XXXXXXX-----|--XXXXXXX------XXXXX------------B--------f
m---o-------------------------------------------------------------------------------------------------------------------------------------------------------X|--XXXXXXXX----XXXXXX--------BBEEBE----E--X
XXXXXXXXXXXXXXXXXXXXXXXXXXXXXXXXXXXXXXXXXXXXXXXXXXXXXXXXXXXXXXXXXXXXXXXXXXXXXXXXXXXXXXXXXXXXXXXXXXXXXXXXXXXXXXXXXXXXXXXXXXXXXXXXXXXXXXXXXXXX--------XX-X----X|-XXXXXXXXXXXXXXXXXXXXXXXXXXXXXXXXXXXXXXXXX
