-----------------------------------------X---------------------------------------------------------------------------B----------------X-------------------------------------B-X----o-------BBBBBB--o----
------------------------------------------------------------------------------------------------------------------------X--M----X---------?---B------------------------------------------B---X----B--X--
---------------------------------------------------------------------------------------------X-----------------------B--------------------B--X---------------------------BX-------X--B--X---------------
--------------------B-----------------------------------------------M----------------------------------------------o------T----B-----?------------------------------------------XXXXXX-----------X------
------B---------------------------------------------------------------------------X-------------------------------------X-|------X-------------------------------------------------X-----B--------------
-----M--------------------T------------------X-------------------B---------------X-------------------T-----------------XX-|B-M-------B------------------T----------------?----X-------------X-------X---
----------------------B---|--------------o-----------------------------------X----oB-----------------|----------------XXX-|-----T----T---------?B-------|-T-------------------XX------B-----XX--X????X?-
--------------------------|-----B--------------------X-----------------------XX-----------------X----|-X-------?----XXXXT-|-----|-X-?|----X----BBBBBBBB-|-|-------------------XXX-------X--BXXX--B-----v
--------------------------|--X----B-?-------------------------B---X----------XXX----------B------B-B-|-----X--o-----XXXX|-|-----|----|-------X----------|-|-X-------------X---XXXX----------XXXXBBB----f
-------------------------X|--XXT------------------------X--------------------XXXX-B---------B--------|-----XX------XXXXX|B|-----|----|X-----Bo----------|-|-----------X-------XXXXX------X--XXXXX------f
------------------------XX|o-XX|-----------------------B---B---------------B-XXXXX--------------X----|-T--TXXX----XXXXXX|-|--B--|----|-B----------------|-|----------XX-----T-XXXXXXX-------XXXXXXBXBBXf
-----------------------XXX|-BXX|X--------------------------------------------XXXTXX-X----X----------B|-|-?|XXXX?MXXXXXXX|-|-----|----|-------X--X-------|-|----B----XXX-----|-XXXXXXXX------XXXXXXX----f
------------------X---XXXX|--XX|XX----------------------B---X----------------XXX|XXX-----------------|-|--|XXXXXXXXXXXXX|-|-X---|---B|-X----------------|-|--------XXXX-----|-XXXXXXXXX-B---XXXXXXXX---f
-----------------X---XXXXX|--XX|XXXo-----------------------XX----------------XXX|XXXX-------Xo--o----|-|--|XXXXTXXXXXXXX|-|X----|----|XX----------------|-|-------XXXXX-----|-XXXXXXXXXX-BX-XXXXXXXXX--f
m----E--------------XXXXXX|--XX|XXXXE-----EE---E----------XXX-B-------B--?-E-XXX|XXXXXX--------E-o---|-|--|XXXX|XXXXXXXX|-|-----|---E|XX----EE----------|-|---E-EXXXXXX---E-|-XXXXXXXXXXXE--XXXXXXXXXXMX
XXXXXXXX----XXXX---XXXXXXX|XXXX|XXXXX-XXXXXXXXXXXXXXXXXXXXXXX------XXXXXXXXX?XXX|XXXXXXXXXXXXXXBXXXXX|X|XX|XXXX|XXXXXXXX|-|XXXXX|XXXX|XX-------XXXXXXXXX|X|XXXXXXXXXXXXXXXXX|XXXXXXXXXXXXXX-XXXXXXXXXXXX
