-----------------------------------------X---------------------------------------------------------------------------B----------------X-----------------------------B---------X-B--o-----BMXBBBBB-------
-------------------------------------------------------------------------------------------------------------------B----X--M----X---------?----X-MX-------X--------B-------BBBBBBB----------------------
---------------------------------------------------------------------------------------------X-----------------------B--------------------B--X-----------------X-X----?-B---------------X---------------
--------------------B-----------------------------------------------M-----------------------------------------------------T----B-----?--X-----B---------------------XX--------------------------------o-
------B---------------------------------------------------------------------------X-------------------------------------X-|------X--B----X-----------X-------B--------------T----BBBBB------------------
-----M--------------------T------------------X-------------------B---------------X-------------------T-----------------XX-|B-M-------B----------X----T--T----------X-----?--|-X--------------T------X---
----------------------B---|--------------o-----------------------------------X----oB-----------------|----------------XXX-|-----T----T---------?B----|--|-----------XBBB----|-XX------B-----M|--X---XXX-
--------------------------|-----B--------------------X-----------------------XX-----------------X----|---------?----XXXXT-|-----|-X-?|----X----BBBBBB|B-|------------?------|-XXXT-----------|---------v
--------------------------|--X----B-?-------------------------B---X----------XXX----------B------B-B-|-----X--o-----XXXX|-|-----|----|-------X-B-----|--|-------------------|-XXX|-----------|--T----B-f
-------------------------X|--XXT------------------------X--------------------XXXX-B---------B--------|-----XX------XXXXX|B|-----|----|X------o-------|--|-----B-------X---BB|XXXX|XX??????---|--|------f
------------------------XX|o-XX|-----------------------B---B---------------B-XXXXX--------------X----|-T--TXXX----XXXXXX|-|--B--|----|-B----T--------|--|X-----------XX-----|BXXX|XX--------B|--|------f
-----------------------XXX|-BXX|X--------------------------------------------XXXTXX-X----X----------B|-|-?|XXXX?MXXXXXXX|-|-----|-X--|------|X-XX----|--|-----X-----XXX-----|-XXX|XXX---B---B|--|------f
------------------X---XXXX|--XX|XX----------------------B---X----------------XXX|XXX-----------------|-|--|XXXXXXXXXXXXX|-|-----|---B|-X-X--|T-------|--|---X---B--XXXX-----|-XXX|XXXX--TB---|--|------f
-----------------X---XXXXX|--XX|XXXo-----------------------XX----------------XXX|XXXX--------o--o----|-|--|XXXXTXXXXXXXX|-|----X|----|XXXX--||-------|--|---XX----TXXXX-----|-XXX|XXXXX-|----|--|------f
m----E--------------XXXXXX|--XX|XXXXE-----EE---E----------XXX-B-------B--?-E-XXX|XXXXXX--------E-o---|-|--|XXXX|XXXXXXXX|-|-----|---E|XXXX-E||-------|--|---XXX-EX|XXXX---E-|-XXX|XXXXXX|EBB-|--|-----MX
XXXXXXXX----XXXX---XXXXXXX|XXXX|XXXXX-XXXXXXXXXXXXXXXXXXXXXXX------XXXXXXXXX?XXX|XXXXXXXXXXXXXXBXXXXX|X|XX|XXXX|XXXXXXXX|-|-----|-XXX|XXXX--||-XXXXXX|XX|XXXXXXXXX|XXXXXXXXX|XXXX|XXXXXX|----|--|XXXX??X
