------------------------------------------------------------------------------------B????----------B-B------------X-----?B--------B---X-----B-----------?????---XB---------------------?-----------X----
------------------------------------------------------------------------------------------B---X------X-----B----B---------o-----------X----------------X--------B---B--BB?BB-------------XXXXXX---------
----------------------------------------------------------------------------------------------B---o---M--------------X----X-X-----------B---XB---o-M-----------------------B-------X-------BBBB------B--
--------------------------------------------------------------------------------------------X--X----B------XXXXXXo--------B----------------------X-------------------X---------------B--X----------o----
---------------------------------------------------------------------------X--------B-X---X--------X---T--X----------------???---X--B--XB-T--TX--------B----------B--T----X-----------B--T-----------o--
-----------------------------------------------------------------------------------------XX------X----T|---------X---T-----X-X-X---------X|--|X--M--B----------------|------T--M--B----M-|------X--MXX--
--------------------------------------------------------------------------------------o-XXX-----------||---T---X----T|B------XX---X-----XX|X-|-X-----------------BBXB|------|T--X-X--o---|-------BBX-XX-
---------------------------------------------------------------------------------------XXXX-------BM--||--X|B-------||------XXXX-X-----XTX|--|---BBBT?X-XXX-----XB---|XX----||----XX--X--|-----------XXv
--------X-------------------------------------------------------------------B---------XXXXX--------X--||---|------T-||-------TXTX-----XX|X|X-|X-----|XXXXXX-----X----|--X---||----XXX----|----??????BXXf
-----------------------------------------------------------------------------------T-XXXXXX-----------||---|-----X|-||-------|X|XX-B-XXX|X|XX|------|BXXX-------X----|--T---||----XXXX---|XB----X----XXf
-----------------------------------------------------------------------------------|XXXXXXX---BBTBBBB-||---|------|?||B-X----|X|XXX-XXXX|X|XX|------|XXXXX----X----X-|--|---||BX-TXXXXX--|X--------B-XXf
----------o------------------------------------------------------------------------|XXXXXXXBBB--|----?||X??|?-X-X-|-||-XXX---|X|XXXXXTXX|X|XX|X-----|XXXXXT-?X---XXXo|--|--B||BBX|XXXXXXX|X--------BTXXf
----------------------------------------------------------------------------B-----X|XXXXXXX---X-|-X--X||X--|X-----|B||XXX----|X|XXXXX|XX|X|XX|XX---X|XXXXT|X-----XXX-|--|--X||B--|XXXXXXX|X-----B---|XXf
-----------------------------------------------------------------------------B--XXX|XXXXXXX--B--|T--XX||XB-|------|-||XXX--X?|X|XXXXX|XX|X|XX|XXX-XX|XXXX||XX---XXXX-|--|---||--T|XXXXXXX|X---------|XXf
m--------------------------------------------------------------------X---------XXXX|XXXXXXXE----||-XXX||X--|---EoE|-||XXX----|X|XXXXX|XX|X|XX|XXXXXX|XXXX||XXX-XXXXX-|E-|---||E-||XXXXXXX|XB-E------|XXX
XXXXXXXXXXXXXXXXXXXXXXXXXXXXXXXXXXXXXXXXXXXXXXXXXXXXXXXXXXXXXXXXXXXXXXXXXXXXXXXXXXX|XXXXXXX---o-||XXXX||X-X|XXXXXX|X||XXXXXoX|X|XXXXX|XX|X|XX|XXXXXX|XXXX||XXXXXXXXXX|XX|---||--||XXXXXXX|XX--------|XXX
