----------B---------------------X-------------------------------------------------B---------------X----B----B----o-------------------------------------o---X------------B--B----------B-------------B---
-----X---------o-o----o------Bo--B----------------------o-o------------------oB----B---X-----------o-----B-----------------------------------------o-----------------------------B----------------------
-----------o--------------------------------------------------o-----o--------------------------o-------------------o--o-B---------------------------------------o---------B?---------------X------------
--oo-------o--X----------o---------o---?---o-----o-----------------o--Xo----------------o---------------------o--B-o-X-----------B----------o--o------------------X------o-----X------------------------
-----B-------------------X---E---Xo-------o--------X---------o----Xo-o-------E---------------o----------------B-----------BB--o------X----X-o------------------o--------B--------o---X----B--------o--o-
-----------?------B------ooB----B----o---------B-----o-o-------------?----------------------------Bo----------o----E----o------------------------------------X------B---------------------------X-------
---------X---B-------------------------o----------o-------------------------o----------------------------oB---------B-o------------B---------------o--B-o--------------------------B--------------o-----
-------------------o--------o---X------------------------B--------o------o-o-----o-------------o---B------------oB-------------------------o-B--o---------------B---oB----o--o-----B--------o---------Xv
--o--X-X--------X--------o--X--B-o----------------o-----------B----------B---------------Bo------o--------------------B--------o--o---o--------------------o---------o---o-----o------------o-----Bo---f
--o----B-----------------------------------------------------------oo--B--------------------------B-----ooBB------------BX------------------------o--------o-------------------B-------o---------------f
-------------o----------------------o---------------X-----------Bo--B--o-------------------------------------------o-o--------E----B-------------------------B--------o-------X---------------B--------f
---------o--X-------X--------------o-------o---------B----------B-----------o-o---------o-------------------------------o---B---------o-------------------------o---------B-------------------------X-Xf
-----BX-o-----------------------------------------B--o---------B--X---oB--------------Bo-------------------------------B---------o------o------------------B----X-----o-------o-X----?--B--------o---o-f
--------B---o-------oX-----X----------B----------B--------------oo------o-----------------B---B---o-----------o---o------------------o-------B----------o-X-B----o-o---o---o-B-----B-----------X-------f
m--------X----o-------o--o-----B--------X-----o---------------------X-----------o---o--X------------B--X--------o-------X--------X-----o--------X-B--o---------------B-----XB-------------------o---o--X
XXXXXXXXXXXXXXXXXXXXXXXXXXXXXXXXXXXXXXXXXXXXXXXXXXXXXXXXXXXXXXXXXXXXXXXXXXXXXXXXXXXXXXXXXXXXXXXXXXXXXXXXXXXXXXXXXXXXXXXXXXXXXXXXXXXXXXXXXXXXXXXXXXXXXXXXXXXXXXXXXXXXXXXXXXXXXXXXXXXXXXXXXXXXXXXXXXXXXXXX
