-------------------------------------------------------------------------------------------------------------------------------------------------------BB-------BX-M-----------B----------Xo-B----------
-----------------------------------------------------------------------------------------------------------------------------X---------------------B-----?----------X----X---------B--------------------
--------------------------------------------------------------------------------------------------------------------------------------------------B-----o-------------B---o-X-X-B-B----------BB--B------
------------------------------------------------------------------------------------------------------------------------------------------XXXXXX---------------T------------B--XXXXX------------BBBXXXX-
-------------------------------------------------------------------------------------------------------------------------------------------------------------T-|---Xo---------X------T-------X----B-----
--X--------------------------------------------------------------------------------------------------------------------------------------X--B---T----X-------|-|-X---o----------X----|B--X---T-----B--X-
------------------------------------------------------------------------------------------------------------------------------------------------|T------X---T|-|----B------B-----o-X-|---X---|---?--o-X-
---------------------------------------------------------------------------------------------------------------------------------B---?----XB---X||----BBXXBX||X|---XX---B-X--------XX|-BXX---|----T---Xv
------------------------------------------------------------------------------------------------------------------------------------X---------XX||------XXX-||X|X--XXX-B--X----o---XX|-XXXXXX|M-T-|---Xf
---------------------------------------------------------------------------------------------------------------------------------------X-----XXX||------XXXX||X|X--XXXX---------B--XX|XTXX---|--|-|---Xf
----------------------------------------------------------------------------------------------------------------------------------------B---XXXX||XXXXB-XXXX||X|XX-XXTXX-T-X-X-BBBBXX|X|XX--B|--|-|---Xf
----X--------------------------------------------------------------------------------------------------------------------------------------XXXXX||---X--TXXX||X|XXXXX|XXX|T--------XX|X|XX---|--|-|---Xf
------------------------------------------------------------------------------------------------------------------------------------------XXXXXX||------|XTX||X|XXXXX|XXX||---B----XX|X|XX-TX|X-|-|T--Xf
----T------------------------------------------------------------------------------------------------------------------------------o-----XXXXXXX||-----o|X|X||X|XXXXX|XXX||BX-----XXX|X|XXX|-|X-|-||--Xf
m---|-------------------------------------------------------------------------------------------------------------------------------EE--XXXXXXXX||--o-BX|X|X||X|XXXXX|XXX||X----EXXXX|X|XXX|X|XE|-||-EXX
XXXX|XXXXXXXXXXXXXXXXXXXXXXXXXXXXXXXXXXXXXXXXXXXXXXXXXXXXXXXXXXXXXXXXXXXXXXXXXXXXXXXXXXXXXXXXXXXXXXXXXXXXXXXXXXXXXXXXX-----XXXX????XXXXXXXXXXXXX||----XX|X|X||X|XXXXX|XXX||XX---XXXXX|X|XXX|X|XX|-||XXXX
