------B-o----o--oBo----------o---o---X-o-o---o----------B----o-----o--X------B---------------o------Xoo--------Bo---oo---------BX-----BXo-B--------------X---o--X---o---------o-------------o-------o-BB
---B---B-----B-o------B--------o-o-o-Bo---X-X-o--------B---oB---BX-o-------o------------BX-----oo-B-X-B-o-E-o--o--------X-------B--X-o----o------B------------------o------BoB----------Bo---B-B--------
---------B----o---------B-B----B-------------------o-------o--------Bo---------E-----------B-----o---o-o---------------?--X-Xo---oo--X--o--o------o-----o----o-------B-------B-B-----------X----B-------
------------o-o----------B----B----------------o-E------------o-B----o----------o------o--------------X---------o---o--oo----o-o--B-o--BB-B------B-----X--------o------B--oT-B---------E-----o----BXo---
o-o----------B-B-X------o--B--o----X--------B-o------B----------------o------------o-----B------B----o----------------B-?X-----o--BB--o-o-----B--B----o----B-----o--B------|------o----------B--------o-
-oX---------B----oT---B-o---o--X--B-----o-B---o---o------E-----o-E---Bo-X---------E------o-------X-------o----------B-B---o-X-Boo---------o--------B----o----X-----------B-|---o---------T----X---B--o--
---------B-T--o---|----------o---------------Xo---------X--X-o---X--o----B-XX---o--------------o--o----B----o---------o--o-----------B------B--------B----X--o--------BB---|------X-----B|-o----o---o-X-
o--o-B----o|------|--Xo----B--o---B------------o---X------oX-------o-E------X---o-o---oo---oX--------oo----o-B----o-----B----ooX-o----------X---B-BE-----B---BX--B--o---oB-|-------B-B---|-------------v
-----------|---B--|-oT------B---Bo------------o-B-----o-B--B-B----o-T---o----B-o-----------------X-o-o--------X--------------E--o--BBBo---o--------BB----XEo-------------o-|-------------|-----B------Xf
---o-XX----|--X-o-|--|--B-o----X-o-o-----o------Xo----o-----------o-|-B---o-------o---o--------o---T-oB---o--o--o--?o---X----o------oo------B---B-----X---o-B----o-o-o---o-|-B--?--------|--------o-o--f
-X---B-X---|-----B|-B|----B-------o---oB-Bo------B-------o---o--o---|----B---B---------B--B-------o|-o--------o---o-?-----B----o-------o--o-------------o---X-----o--X-----|------X-B---B|----o-o---o--f
-------BBBo|----o-|--|---------T-o------------------B-oBB----B-o-B--|--------B--B----BoMB-------E-B|------B-------------o---------X---XXXo----B------------B---E-----o-X---|----------T--|-------o--B--f
o----------|------|--|--o------|---------o--o---------oX----------X-|------B---Xo------M-B--o---X--|--oE-Bo--o-----o-B---o-------------------o-------------o--------EEo----|---------o|--|-------------f
X----o-----|-----?|--|--o----B-|-oB----B--X--o-------o--------------|-ooB-B---------BX-------------|--B--o--o------B----Bo---------------B----------Bo-E-o-----B-------oo--|----Bo--X-|--|----o-----BE-f
m-E--B--o-B|------|--|----o-o-E|-E-------oo-------E---------E---o-o-|--o-----B------B--o-----------|----------BXE-Bo---B------X------o-o-------X---BE--B------B-Bo--oEE-EB-|-B-------o|--|------ooo-o---
XXXXXXXXXXXXXXXXXXXXXXXXXXXXXXXXXXXXXXXXXXXXXXXXXXXXXXXXXXXXXXXXXXXXXXXXXXXXXXXXXXXXXXXXXXXXXXXXXXXXXXXXXXXXXXXXXXXXXXXXXXXXXXXXXXXXXXXXXXXXXXXXXXXXXXXXXXXXXXXXXXXXXXXXXXXXXXXXXXXXXXXXXXXXXXXXXXXXXXXX
