--------------------------------B-------------------B--------------X------------B-----------X-------------?----------------------------------------------------o----------------------------------------
------------------------X-----X---BXXXXXX-------X------------------------------------X--------------------?----------------B----------X-----------------------------------------------------------------
--------------------B---------X------o---B-------------------------BBBBB----------------------------------------------------------------X--o---------------------------------------------o--------------
---------------------------TT---------M----------------------------------------------------X---------------X-------------------------------------------------X------------------------------------------
-------------------B-------||--------------X---X-----------------------------------------------------X-------------X----------T---X---------------X-----------------------------------------------------
--------------------BB-----||--X?--B------XX--XXo---------------------------------------o-------------------------TXX--B-----X|--------------------------------------???--------------------------------
-X--M----------------------||---B--BXX---XXX-XXX--------------------------------------------------------B-----B--X|X-XT-----XX|-X------?????--------B---------------X---X-------------------------------
------------------BBBBBB---||-B?---XXX--XTXXXXXX--------------X------------------X------------------------------XX|X--|--X-XXX|------------------------------------------------------------------------v
-------------------B-------||X----XXXX-XX|XXXXXX--------------------------------XX-------T-------------X----B--XXX|X??|---XXXX|----X-----o-------------------------------------------B-----------------f
--------------------o--X---||----XXXXXXXX|XXXXXX-------------------------------XXXo------|---X----------------XXXX|X--|-XXXXXX|--------------------------------------------------BBB-------------------f
-----------------------B---||-X-XXXXXXXXX|XXXXXX-----------?------------------XXXX-------|--------T--X-------XXXXX|X--|-XXXXXX|--------X---------------T-----------X---o-----B-------------------------f
---------------------X-----||--XXXXXXXXXX|XXXXXXX----------------------------XXXXX-------|--------|-X-------XXXXXX|X--|XXXXXXX|-B-----B-------------X--|o----------o--X--------------------------------f
------X----B-------?XX???--||-XXXXXXXXXXX|XXXXXXXX--------------------------XXXXXX-------|------B-|-------BXXXXXXX|X--|XXXXXXX|---------------T--------|-----------------------------------------------f
------XX------B---XXXX---M-||XXXXXXXXXXXX|XXXXXXXXX------------------------XXXXXXXXXX----|--------|-X-----XXXXXXXX|XBX|XXXXXXX|-----BT-X------|--XXXXXX|------?----------B-----------------------------f
m-----XXX--------XXXXX-----||XXXXXXXXXXXX|XXXXXXXXXX----------------------XXXXXXXX-------|X--B----|-E-E--XXXXXXXXX|XXX|XXXXXXX|------|--------|--E---XX|----X-------------------------------X----------X
XXXXXXXXXXXXXXXXXXXXXXXXXXX||XXXXXXXXXXXX|XXXXXXXXXXX----XX------XXXXXXXXXXXXXXXXXXXX----|-X----XX|XXXXXXXXXXXXXXX|XXX|XXXXXXX|XXXXXX|---XXXXX|-----XXX|XXXXXXXXXX---XXX---XXX----XXXXXXX---XXXXXXXXXXXX
