-----BBBB------XX--------------------------------------------------------------B---------------------------------------M------------------------------------------------------------------XX--------BBB-
---------------------------------------------------------------------------------------------X--------------------------X-------------BB--X-------------------------------------------------X--o----X---
----------------------------------------------------------------------------------------------------------------------B-------------X-------------------------------------------------------B---M---B---
---------------------T----------------------------------X--------------------------------------------------------------------BBBBBBBB-T----------------------------------------------X------------------
---?X----------------|---------------------------------------------------------------------------------------------------------?------|---------------------------------------------------B-B----T------
--------------B----B-|---------------------------------------------------------------------------------------------T-------------o----|-X-----------------------------------------------???M??---|------
---------T-----------|-------------------B------------------------------------------------M------------------------|X--------B--------|---------------------------------------------B----?----XM-|-BX---
-----o---|----X------|---------------------------------------------------------------------------------------------|---------------X--|-----------------------------------------------B---------B|-M---v
---------|-----B-----|---------------------------------------------------------------------------------------------|-----M------------|T----------------------------------------------?--B---B---|----Xf
---------|-----------|---------------------------------------------------------------------------------------------|-----------B------||--------------------------------------------------X------|---XXf
---------|-----------|---------------------------------------------------------------------------------------------|------------------||----------------------------------------------XT---------|--XXXf
-------X-|-----------|--------X-------------------------------------------------------------------------------B----|--------------X-X-||----------------------------------------------X|---X----T|-TXXXf
---------|-----------|-----------------------------------------------------------------X---------------------------|-------------BXXXB||----------------------------------------------X|X--XX---||X|XXXf
---------|-----------|-----------------------------------------------------------------X---X-----------------------|-------B------XXX-||----------------------------------------------X|XX-XXT-T||X|XXXf
m--------|-----------|-----------------------------------------------------------------XX--XX----------------------|o-------B-E--XXXXX||EE--------------------------------------------X|XXXXX|X|||X|XXXX
XXXXXXXXX|XXXXXXXXXXX|XXXXXXXXXXXXXXXXXXXXXXXXXXXXXXXXXXXXXXXXXXXXXXXXXXXXXXXXXXXXXXXXXXXXXXXXXXXXXXXXXXXXXXXXXXoXX|XXXXXXXXXBXXXXXXXX||-B--XXXXXXXXXXXXXXXXXXXXXXXXXXXXXXXXXXXXXXXX--X|XXXXX|X|||X|XXXX
