----------------------------------------------------------------------------------------------------------B----------B----------B---------------------------------------------------o-------------------
--------------------------------------------------------------------------------------------o---------B-M-----BBBBB---Bo-B---------------------------------------------------------------B---------X----
-----------------------------------------------------------------------------------------B----X-BB-----X---?B--?--------Xo---X--B------------------------------------------B----B----XXXXXXX-??????-----
-------------------------------------------------------------------------------------------T--B------------------X----T----M-----o------------------------------------------------?-------BBBBXBXBX--B--
----------------------------------------------X------------------M-------------------------|------------XXXXXXXXX-----|----XX--X---B--------------------------------------------B------X-----------X----
----------------------------B-------------------------------------------B-M----------------|---B--XX-M----XX------B-TB|X--X----B-----T-------------------------------------------X----?M----------XXT---
-------------------------------------------------------------X------------X-----T---B------|---X----M-oB-XXX------BX|M|--B---T-XB----|-------------------------------------------XX----X----M----XXX|---
--------------------------------------------------------------------------T-----|--------T-|-----B--B-T-XXXX-B-BB-X-|B|-BB---|-------|---XXXXX---------------------------------B-XXX------------XXXX|??v
----------------------------------------------------------B------------B--|-B---|--------|B|-X--?----X|XXXXX-----XXX|?|XBB---|-----BX|-------------------------------------------XXXX-o-----X-BXXXXX|--f
--------------------------------------------------------------------------|-----|--------|-|----------|XXXXXBXB---XX|-|oT-X-T|---X--X|---------------------------------------X---XXXXX--?B----XXXXXX|BXf
--------------------------------------------------------------------------|--o--|--------|-|------TX-X|XXXTXXXX-B-XX|X|-|B--||---XX-X|X----------------------------------------M-XXXXXX-X----XXXXXXX|-Xf
---------------------------------------------------------------------?----|--B--|-X------|-|------|-XX|XXT|XXXXXo-XX|X|-|-M-||---XXXX|XX-----------------------------------------XXXXXXX-B-BXXXXXXXX|-Xf
--------------------------------------------------------------------------|---??|XXX-----|-|--Bo??|XXX|XX||XXXXTX-XX|X|X|--?||---XXXX|XXX--------------------------------------TBXXXTXXXXX-XXXXXXXXX|-Xf
---------------------------------------------------------------------X----|-----|-XXX----|X|--B---|XXX|XX||XXXX|TXXX|X|X|---||--TXTXX|XXXX-------------------------------------|-XXX|XXXXXXXXXXXXXXX|-Xf
m---------------------------------------------------------E---------XX----|--EE-|-XXXXEE-|X|EE-E-X|XXX|XX||XXXX||XXX|X|X|XBB||E-|X|XX|XXXXX------------------------------------|-XXX|XXXXXXXXXXXXXXX|-XX
XXXXXXXXXXXXXXXXXXXXXXXXXXXXXXXXXXXXXXXXXXXXXXXX----XXXXXXXXXX-----XXX----|--XXX|XXXXXXXX|X|X--BXX|XXX|XX||XXXX||XXX|X|X|XX?||--|X|XX|XXXXXXXXXXXXXXXXXXXXXXXXXXXXXXXXXXXXXXXXX|XXXX|XXXXXXXXXXXXXXX|XXX
