--------o------B----------B----o-------X----X----o--B----Bo-------o---o---Bo---oXB-Xo----B--X--o------B-----------------------?o--B-----o---o--o---------o--B----o---X-o----o----o-ooB-----XX------oT---
---B--o-------------XX---X---X--------B--oo---o---Bo----o------B----------------XoB-----------------------------oo----------B----oBB----------E--o---o--B------o-Xo-o-----X--T--------------B-------|---
--Boo--EBB-BX----oT---B-------------------o-------o------E-o----X--------o-B--oB----o----o------E-----o----B-------B-----------oX--E----------X------o------------------B----|----------o--B--B-B---|---
--oo---B--X-o-----|-B---B--o-------B------B-------o---oX-B-----B-oo-------B---------------Eo--X-B------o--BB-B----oo-------------oEB---B--------o-BXB----BBo-Eo-------------B|----BX----X----E--X---|-o-
-B-o-------B--B---|--B--B---B---------B-----o-B-o--------EB--o-------Xo--B-o---oo-BB--X---X-Bo---o-----B-o---T-------------o---B--B------o------oo---------X-X----X----BX----|-------oX---o--Bo-o---|-o-
----E--------oo---|-----o------o--oo--ooB-----------o----B---------B----BX-X-----o-------------------------o-|---o----B-B--oo----o-o-----o-----o---X---B----------------o----|---B-----B-----oo--B--|---
----Xo-o----------|-o---B--oX-o----B--------B----B--X---o---Bo---X-B---------BXo-Bo---------o------Bo--------|-----------o--------o--o-----XoB-------ooo-----B--X------------|--oo----o--B-X--------|---
--------o-------XX|-------------o--o-------o---o--------X----o---B--X--B------oo-o------o------B----------o--|--o-------oo------B-X--------------X--B--B---------oE-----o--Bo|----------------------|--v
----B----------o--|-------Xo--o------------o-------o---------T----------------o--------B-B-----o---B-oB----B-|---X------o------B-----------B-B-----X---B---------oB--o-------|---Xo--X-o-o---o---X--|--f
--B------o--B-----|------oo--------------o-------Xo--o-------|--------------------o-----E-B-o---E--------o---|--------------XX---o-o-X---------o-------o-------------------oX|--X-oX----------oX--B-|--f
--Bo--o-------XX--|--B--------o-------Xo---o--oo-B---oo------|-----oX-----X-----oo------X-B-----B--X-o-------|------------o-Xo-----BBoEo-----------------X-------------o----B|------B----B---o--XE--|-Bf
-----------X-B----|---o-ooX----------oBXB--o-oo----Bo--B-----|---o--------B---B---o-B---o------o-o--oX--B-BBB|----X-o---o-----o-------B----------oo---B--o-----o-------------|--o--oBB-X-B-------X--|--f
------o---oX----B-|----------Xo---o----------o-E-o--B----o--o|-------o----------o--------------------o------o|----------------o--o----------Bo------------o--B---------------|----o----o-----------o|--f
--------X-------oo|--------E---o---------------B-o---------?X|-o-------------------------o------------o-o-o--|----B----o--o--o---o--o-o-B----B----------X---------o-------X--|-----B--o--o--o-o-B--o|--f
m------o-------E--|--oo-B--BB---------X-------------o--------|-----T-o-----o---------X------o--BB------o-----|-------o----------X-EBo-o--E-T----o----Xo-------BB-----o-------|----o-------o---------|--X
XXXXXXXXXXXXXXXXXXXXXXXXXXXXXXXXXXXXXXXXXXXXXXXXXXXXXXXXXXXXXXXXXXXXXXXXXXXXXXXXXXXXXXXXXXXXXXXXXXXXXXXXXXXXXXXXXXXXXXXXXXXXXXXXXXXXXXXXXXXXXXXXXXXXXXXXXXXXXXXXXXXXXXXXXXXXXXXXXXXXXXXXXXXXXXXXXXXXXXXX
