--------------------------------------------------------------------------------------------------------------------------------------------------------------------------------------------------------
--------------------------------------------------------------------------------------------------------------------------------------------------------------------------------------------------------
--------------------------------------------------------------------------------------------------------------------------------------------------------XX----------------------------------------------
--------------------------------------------------------------------------------------------------------------------------------------------------------------------------------------------------------
---------------------------------------------------------------------X----------------------------------------------------------------------------------------------------------------------------------
--------------------------------------------------------------------XX----------------------------------------------------------------------------------------------------------------------------------
------------------------------------------------------------T------XXX----------------------------------------------------------------------------------------------------------------------------------
------------------------------------------------------------|?----XXXX---------------------------------------------------------------------------------------------------------------------------------v
----------------------------------------------------T-------|----XXXXX---------------------------------------------------------------------------------------------------------------------------------f
----------------------------------------------------|-------|---XXXXXX--------------------------------------------------XX------------------------o----------------------------------------------------f
----------------------------------------------------|-------|--XXXXXXX---------------------------------------------------------------------------X-----------------------------------------------------f
-----------?----------------------------------------|-------|-XXXXXXXX---------------------------------------------------------------X-----------------------------------------------------------------f
----------------X------------------------------T----|-------|XXXXXXXXX---------------------------------------------------------------XX----------------------------------------------------------------f
-----------------------------------------------|----|-------|XXXXXXXXX---------------------------------------------------------------XXX---------------------------------------------------------------f
m----------------------------------------------|----|------X|XXXXXXXXX-------------------------E-------------------------------------XXXX--------------------------------------E---------EE------------X
XXXXXXXXXXXXXXXXXXXXXXXXXXXXXXXXXXXXXXXXXXXXXXX|XXXX|XXXXXXX|XXXXXXXXXXXXXXXXX---XXXXXXXXXXXXXXXXXXXXXXXXXXXXXXXXXXXXXXXXXXXXXXXXXXXXXXXXXXXXXXXXXXXXXXXXXXXXXXXXXXXXXXXXXXXXXXXXXXXXXXXXXXXXXXXXXXXXXXX
