--------------------------------------------------XXXX--------------------------B----M--------------B----------------------------------------------------------o------------B-----B---------------------
----------------------------------B--M-----------------------Bo????---------------------------------X------------------X---------B-X------------B---------X---------B--B--XX---X----------------?-------
----------?-------------------------X------------X--------------------------B---------------?---------X--X--------------------------????X?-oB---M---------o-----B--BX------------B----------------------
---------------------------------------------------B---------------------------------------X-X-----X---------------------------------------------X-----T-----X---X--------?--X--T---o-------------------
---------------------------------X-------X----B---------B----X-B----------------X-----------------------------X--X---------B--T---X--------------T-----|------------B----B------|------------X-o-----X--
--------------------------------XX------------??o----------T-----?---T--B-----X----------o-----X-----X---T--------T-X-------BX|----B----B-------X|-----|------X-X--M-???--B--X-T|--T---BBXBBBB----------
-------------------------------XXX-----B-------------------|T--------|--------------------X---------X---X|--X-----|---T-------|-X------X-----?---|-X---|-TX---XXXBBoXBXB----XX-||-X|----X--??????B?-----
------------------------------XXXX-B------XXXXXXXXX--T-----||-------X|----------------------------------X|--------|---|-------|---M-----XXXXX----|---B-|B|---XXXX-----XX---XXX-||XX|----XX-B-----------v
-----------------------------XXXXX--------X----------|-----||------XX|--------------------B---?--------XX|X?B--X--|T??|-----??|----------o----X--|----M|B|B---XXXXXX-TXXXBXXXX-||XT|--X-TXX-----o------f
----------------------------XXXXXX------------------?|?XB--||-----XXX|------------------------X---------X|XX--X-M-||--|-------|-----------X-----T|B----|X|----XXXXX-X|XXXXXXXXT||X||X---|XXXo-?--------f
---------------------------XXXXXXX---B---------------|----B||----XXXX|----B-B----------X----------------X|XXX---BB||B-|-------|--------X--XX----||B---X|X|----XXXXTX-|XXXXXXXX|||X||---B|XXXX-B--------f
--------------------------XXXXXXXX--BX---------------|-----||-?-XXXXX|XT---------------------o----------X|XXXX----||--|-------|-M--B-X--X-XXX---||-T--X|X|---BXXXX|TX|XXXXXXXX|||X||----|XXXXX-------B-f
-------------------------XXXXXXXXX----------X-XX---o-|X--o-||--XXXXXX|X|--------X----B--BBB-----B-------X|XXXXX---||--|-------|---------?-XXXX--||-|-XX|X|----XXXX||X|XXXXXXXX|||X||-?--|XXXXXXo-------f
------------------------XXXXXXXXXX----------X--B-X-X-|-B--X||-XXXXXXX|X|X------------------XB----------XX|XXXXXX--||-o|-------|-M---BT----XXXXX-||X|XXX|X|X---XXXX||X|XXXXXXXX|||X||----|XXXXXXX-oT----f
m---------E------------XXXXXXXXXXX-?------EEBBB------|B-EXX||XXXXXXXX|X|XX------X---------XXX---------ooX|XXXXXXX-||-X|-------|E---Bo|---EXXXXXX||-|XXX|X|XXX-XXXX||X|XXXXXXXX|||X||X---|XXXXXXXX-|--E-X
XXXXXXXXXXXXXXXXXXXXXXXXXXXXXXXXXXXXX---------oX-----|-BXXX||XXXXXXXX|X|XXX---XB---------X-XXXX---------X|XXXXXXXX||XX|XB-----|--XX-X|----XXXXXX||X|XXX|X|XXX-XXXX||X|XXXXXXXX|||X||XXXX|XXXXXXXXX|----X
