-------oX-------------o-----------X---B-----o--o-o-o-------X--o-----oo--------o----o----oBB-B-------o---------B----------o-Bo----BB--------o---o----oB---------------?--------------------oX------------
o-B------B-------------o--o--o--o-----o---B------o----o----X--X------------------B-oooB---------X---o-o--------o----BoT-B--B-BB-Xo-------o---o---X--------------o-o-o----o--o---------------------------
---o------o--o--B--o-------o---------B--------------------o----o-B------o--B-B-o----B--------o----BB----B--------oo-oo|---X-o?--------------B---oB------oX-o--B--o-o-------oB----o------------o-X--E----
-----o------T-----X----o--o--X---------o---o----o---oX-o-X----o------B--o----o-----Xo------B--o------oo-B---o--Bo-----|--BBX--T-oo-E--o-B----------------------B---B--o----------------------o-----X--o-
----X------o|-----o-B--------BX----X------o------o---o-oo---------B---o----------oB-o-B---o------o-o-----------------B|-------|----X-------o--------------o-------------XX-X--o---B-B----B---B-X---X----
--X-----B---|--------o--E-B--------o------------------------o-----X--------o---B-o--oX-o--X-----o-oB--------B-o-------|-------|-------o---------T----o--------o----o---o-------o-o-B-X---o-oo----B------
---Bo--X----|-------------------X-T----------X-------o----E--o----X---?-----E-oo--------B-X-----B--X---oE----T--------|-----B-|--B----o---------|--B-----BX-----XB----B----------B------X-----X---o-o-o-
--o--B-o-o--|-------X-B----o-o--BB|------X-XB--oo-BB------B------oX----oB---B---B-B-----o---B-o-----B---B---B|-o----B-|---B---|--Xo------X------|-----oo---------X------o----o----o--B-----o-X---------v
------------|-----B-X---o---ooo---|-----------------B-----------?B-----------------o----------oo--XE---------|--------|--B--X-|-----o--B----oB--|------------------o-------o--------Bo-B---------B-B---f
--oB--------|----o-B------B---X---|-o-o-B-BB------o--T----B----o--BBo-----X----X------------B------Xo-o-B-X--|--B-----|-o-----|---o---oBX--o----|------------Xo------o----B-----X-----B----oB-------o-Bf
----X-------|-----o--B--------o-X-|---B-------------o|--------X----oB-o----X-o-----X----B-----o-o-B------o---|-----o-o|-----X-|------------o----|-----------BBo----------X-o------X--B--BB-------------f
-B----o-----|-B---T----------o-o--|---------o-B------|--o--o-o--o-BB----o--ooo---------------B---------------|-B------|-----o-|-------o---------|--X------o-B---------o----------B-----X-----o-----X--of
---B---o--B-|-----|-oo------oo----|---o--o-B--X--o-B-|------T---------B-o-----o-------------o--------o--Xo---|------?X|-o-E-o-|-oo-----o-----o--|--B--o---o-Bo----o---------X---o----X----Eo--oo-oBXX--f
-----Bo-B---|-----|-----o--o----Bo|-----oo----------o|---X--|-X-----X--B----o--------o-----------o------o-?--|--------|---B---|---oo----o------o|-----o----oo?---B-----Bo----X------------B---B--X-----f
m-----------|-----|----E------oo--|----oo--o--o--oo--|---B--|--o---B--E--B---BB--B-E--o--oo---------oo-B-----|-o------|-----Bo|------E----o-o-o-|--o-------E--oE--E---B-o-ooBB-------B------X-B--------X
XXXXXXXXXXXXXXXXXXXXXXXXXXXXXXXXXXXXXXXXXXXXXXXXXXXXXXXXXXXXXXXXXXXXXXXXXXXXXXXXXXXXXXXXXXXXXXXXXXXXXXXXXXXXXXXXXXXXXXXXXXXXXXXXXXXXXXXXXXXXXXXXXXXXXXXXXXXXXXXXXXXXXXXXXXXXXXXXXXXXXXXXXXXXXXXXXXXXXXXX
