--------------------------------------BB---o-------------o--o-------------o---B---------o--BX-X----------o----------B----------o-----B---------------------XB--------oo--B-------------o----------------
---B-oB---o-B-B----------------o-----------o-----o-------BB----------o----o----X--B--------o------------------X-oo---o-o------o--------B-------------o----X--o----oB--oo------X-----------o-BB-o--------
--------o------------------B----------------B---M---o-------o-----oB---oX-o--B----------------------------Bo--o----o--------o--B----B--oB-------------B----E--o-B---------------------B-B--B------------
----o-B----------X-------------o--------B---------------------------o--------------------B---------X------------E-oB-----------------o----o------o--B-------X---B-------B---o---X------o--o----B-------B
---o------o--oo----X-----Bo----X-----B---BoB--X-----BB-----X--o---X--B--X-oB---------XX-------B----B-----------o---BB---o----B---o--------B-E------oo-Bo-------B----B------------B---oB-------B----E----
-X------BE--oBo-----------o------------oooX----X----o-X-----oo--B------o-----o----------------XB-o-----------X--o-----B----o---o---o---oX-o-X--BX-----o------------------------oB------o---B------------
-X--o-----X-----------B------------B----------o----------BX-o--X-------------oB-B---o---------o-----o-------------------o--------B--?--B-----------o----------------------------BBo-----------o--Bo-----
------o-X----------B--X---BoB-oB--X----------X----B--------------X-o----o-o--B----X----------o--o-oX-----o---------------------o-------------B---------------o---o-X-----E-B-X------X-------o--------oov
--------o----------XX--------oX-------X-B-------o-o------B-M-----B----o--o-----------------o----B--o--o------o--B-B-------o--------o------o-B--o--o-------------o--------X-B--B-------B----?----------Xf
--o---------o-----B-----------Bo-o-------X-----------------------B--o-----o--------B-oo-----------o----B-o-----o-------------------o---------o--------------B---------oX-o-----Bo--oo------------------f
-----o-----EBo-------o----B-----X--------------XBB--o-----o-----B---X--B---------------oo--o--B--E---------------------o------X----------------BB-o-------X-X----o----B--o--B--o---------B------B-o---Bf
-Bo-----------o-B--B--o------B-------B-B-----o-o--o-oX---------o-----------oo----X---------------X-o-----o----------------o-o--B---o--------o------------o-----B---------o-B-o-----------X--Bo--X--X-Xof
-----o-------B-------o-B------o--o-------o-oo-X---------o----B--o--o-o---B-----------B-------------o--E-------B-------B------Eo--B--Bo---B---B--------o-----B-BX--oo----X-----X---o---------B-------X-Xf
----o--Bo---------o----B------B----X-o----o------o------o--------------o---B--------o-X---B-o---o----------------o------B-o-oo-oo--oB-----o--------Bo--o--XX----o-o-o--o-----X--------o---B-o---------Xf
m--B----o-------------------------B---B----------B------------------X----------o-B-o---------XB-B----X--B----o---------oX-Xo-B---oo----B--o--X---------o-----B-----------o----BB--ooo---------------B--X
XXXXXXXXXXXXXXXXXXXXXXXXXXXXXXXXXXXXXXXXXXXXXXXXXXXXXXXXXXXXXXXXXXXXXXXXXXXXXXXXXXXXXXXXXXXXXXXXXXXXXXXXXXXXXXXXXXXXXXXXXXXXXXXXXXXXXXXXXXXXXXXXXXXXXXXXXXXXXXXXXXXXXXXXXXXXXXXXXXXXXXXXXXXXXXXXXXXXXXXX
