-------------------o------------o----o--------------------------------------o-o---------o-----o------------B----o----B-----oo-B-X-------------X--X---------------------------------------------o--------
-o---o---o-----------E-----Xo--o---------o--------------B-oB-----------B---------------------o-------B----------o--Xo--o----o----o--o--o--o-------Xo-----o-oB---X-------------------o-o------------B----
--------X---o-X-------------------------------Boo--------MB-o----B-----B--B-B-Bo--------o------------oX------oMoo-------------------B--------BB--o--o-o---o--B------------XB---o-----oB--------oo-------
--B---o---o-------------------B-B---------------B-----B-------B----o---------o---------B-----o-------------E-B----------B-o-------------X------B---------ooo--XB-----------------o---XB--------o------o-
-------------------BB----o------o---------------o---o-----------X--o--Xo------B------X------B--o--------------o---X---------------o-oo---ooX---o---------oX---BBB----------------B----------X---oB------
------------X-------------o------B------------X-------X------------X-o------------o---------------X---------Bo-------------o--oB----o----B-------o--------------------o---------X----B------------------
---------o-------------o-B-B--X---B----oo------o-B-o----B------o----o--B--------BB---o---------o-----o----B------------------o--o----------B-?----o----o-------o----o----BX---Eo---------X---B-o-o------
---BB-------o-----------o--------Bo-o----------B------------B-BX----o-Bo--B-B-XX----------------------------------B-------X---o--o----------o---B---------------------B-X-----oo--------------------o--v
------X-----B-----B-----o--------B-----o-X-o------------B--X----o-B----o---X-Bo-----X----B-------------B-----o-o-B-----B-----------------o-------o-----o--B-------o---B----o--------------B-ooE--o-----f
----B-----o----------B-----?---o-------X---B-oo--------------X-o------B--X-o-B-o---------B--------B---------o-------o-B---B----o----------E-o-----------B------B----------------B-----o-o--------oE--B-f
-----------------------------------------------o--M--------o-B------B-?X----------------oB------------------B-X------------------E----------------oB--------------------o-XB---B-----o-----------o----Ef
-------------------------B--E------o-----------X----o---oX---------B---X----o-------X---X----B---Xo----------o-o--------o-----------------o---------X-B---X-----B---o---o---B---o---o------o-------o--Bf
---B-------o-----------B-------------------Xo----o-o-o--o-o--X-X-------o-B----B----------o-------------oB---BX---B-----o----X--BX------B---o---o--------XB----------------------o---------o----X--X----f
----B----B-oX--------o-------oB-o--o------------X---oB-------B------X------o---------o-B------------oX--B-o--o--o-----Xo---o-----------B-o---o---X--------o-------X-o-----o---------B----o-------------f
m--o-B---------X-B----B-o----------B----E-o--o------B-------XX----X-------------B-B-------------o-o----o--B--o---oo---B---------B--o--------o---o---Xo------o-----X---B-X---------X----o---o----o---o-BX
XXXXXXXXXXXXXXXXXXXXXXXXXXXXXXXXXXXXXXXXXXXXXXXXXXXXXXXXXXXXXXXXXXXXXXXXXXXXXXXXXXXXXXXXXXXXXXXXXXXXXXXXXXXXXXXXXXXXXXXXXXXXXXXXXXXXXXXXXXXXXXXXXXXXXXXXXXXXXXXXXXXXXXXXXXXXXXXXXXXXXXXXXXXXXXXXXXXXXXXX
