-----------------------------------------------------M--------o--M-----o-------BBBBM---------M-----o-----XMXXXXXoBMXX-----------------------------------------------------------------------------------
-----------------------------------------------------------------------BBBB----------o---------------?-------XXX----------------------------------------------------------------------------------------
------------------------------------------------------------------------------X--????M?----------o?????-MX?BBBoB---???----------------------------------------------------------------------X-----------
-----------------------------------------------T-----------X----------M-BToTBBB-------B--------o--B------TT-?--T--T-------------------------------------------------------------------------------------
-----------------------------------------------|--------------X-T-M--Xo--|-|-------??o???--------XoTo--T-||BoBB|BT|-X---X-------------------------------------------------------------------------------
---X-------------------------------------------|----------------|X--o--XX|-|--X---o-MBXBBXBBB-M-XX-|XXT|-||To--|?||XX-XXX-------------------------------------------------------------------------------
---XX------------------------------------------|----------T-----|--XTT-TX|M|--XTTTBBXTXXXXT----XXXT|XX||-|||X-o|T||XXXXXX-------------------------------------------------------------------------------
---XXX-----------------------------------------|----------|---BB|BB-||-|X|X|TXX|||T--|XXXB|B--XTXX||XX||X|||XX-||||XXXXXX------------------------------------B-----------------------------------------v
---XXXX----------------------------------------|---o------|-----|---||?|X|X||TX||||X-|XXXX|--XX|XX||TX||X|||XXX||||XXXXXX----------X----------------------------------------------------------------X--f
---XXXXX---------------------------------------|----------|-----|T--||X|X|X|||X||||XX|XXXX|-XXX|TX|||X||X|||XXX||||XXTXXX---------XX---------------------------------------------------------------XX--f
---XXXXXX--------------------------------------|----------|-----||BB||X|X|X|||X||||XX|XXXX|XXXX||X|||X||T|||XXX||||XX|XXXX-------XXX--------------------------------------------------------------XXX--f
---XXXXXXX-------------------------------------|--B------X|XXo--||--||X|X|X|||X||||XX|XXXX|XXXX||X|||X||||||XXX||||XX|XXXo------XXXX-------------------------------------------------------------XXXX--f
---XXXXXXXX------------------------------------|o---------|---MX||-X||X|X|X|||X||||XX|XXXX|XXTX||X|||X||||||XXT||||XX|XXXX-----XXXXX------------------------------------------------------------XXXXX--f
---XXXXXXXXX-----------------------------------|---------X|XX-XX||XX||X|X|X|||X||||XX|TXXX|XX|X||X|||X||||||XX|||||XX|XXXXX---XXXXXX-----------------------------BBBBBBBB----------------------XXXXXX--f
m--XXXXXXXXXX----------------------------------|----------|-EXXX||XX||X|X|X|||X||||XX||XXX|XX|X||X|||X||||||XX|||||XX|XXXXXX-XXXXXXX----------------------------------E-----------------------XXXXXXX--X
XXXXXXXXXXXXXXXXXXXXXXXXXXXXXXXXXXXXXXXXXXXXXXX|XXXXXXXXXX|XXXXX||XX||X|X|X|||X||||XX||XXX|XX|X||X|||X||||||XX|||||XX|XXXXXXXXXXXXXXXXXXXXXXXXXXXXXXXXXXXXXXXXXXXXXXXXXXXXXXXXXXXXXXXXXXXXXXXXXXXXXXXXXX
