--oo-X-----X-----------o--o-------B-----------o------B-------o---Bo---oB------X----B--------------------------------------B-----oB-B------------------o--------o-------o-------B-XX----oo-o------XX-----
-o--oB---X----------o-oo----o------B--------X-------B---X--o-------E-----B----X-B-------B----------------o-----------------------------o--------------o--o----X--------------------o------oo-------B----
-----o------B--ooB----o----------Eoo------------X---o-----o------------o------o-----?B--B--o----o---------X---Eo------ME-o---------o-B---o--o--------B-----oBB---B--------o--B---------B-o---o----o?----
--B-X---B---E-o-----o-o--------o---------BX---o----o-----o-----o--X-----------------------------------o-B--B---o--------o----B---------------E-------------X-----------X-----------B-X-----B-B---B------
---B--BB--BoX---o-----------X----BXo-----B------B------o--B-------------o--o---B--o----------o-----o-----o-o---------E-------o----Xo-B--B--B---------Eo------X-------------o-------o--X-B-E----X---o-o--
-o--o------------o---o-X--E-------o------o----o--o----------o--o----BX-----oo------X---X------BBX--o--B--------o-----Bo-XX------------------Bo--o-o-------B---------B---XX---X--------X---------------B-
-------------------------XB----B-------B-X--o----------X----------------------B----B-o---X-----------X----B-------------B-T-X-----o--o-----BB-E----o----B--------oo-----o---o--o-----B-o---B-----o-o----
---B--B---B---B---BX--------o----------X--------------------------------o--o----------o--B---X-o-Xo--------Xo-----B----o--|--------------o-o---B-------------o------B-B---B?-Bo----B-B--X------B-o-----v
oX--------X--------B-o--------o------------EBo----------oX-X-----B------o---------B---E-B---X-o-------X--B----------------|-----X---------o----o---o------------B----ooB-------Bo----o-------Booo------f
----o----------X---o----o---o-----BE---o--oX------o---------X----------X--B----B-------oX-----------o-X----------------X--|----X-B-o------------------E----oB---o------------------B------Bo--o----B--Ef
o--T------B--------o-B--o---------------------T--------------XX---o-o---Bo-----B-o-oo-X-BB------o-----o------------BX--o--|-o-B-B------o---o--o------o------ooBB--o-------------------------B-X--------f
---|-------------------oo---------------------|--------------------X-o----o-B--B-X----o----o-----X----o----X-------o----o-|-------------BoB--B---o----o------E-----BB----------------------------o-----f
-B-|------M-----------B------o---------Eo----B|---oB----B-oX-----o-o-----Xo---------B--B------------o----o--o----------o--|--------o--o--B-------o--------BB----BB-----o-Bo------o--X-------o--B----o--f
-o-|----------o---o-----------o-o----o---B--oo|--o----X-----o------------B------o-----------o-oBo--T----------------------|----BX----------o--o-----------------o------o-----o---X-----------B--o-o-o--f
mB-|-o-XEo------------------B-B--------B-----o|---XB---E-oB-------------X--E------?-o----B-o--E-o--|------------B---B---X-|---BX---------E------E-----------EEo-EB-------o--o-------------------XBo-----
XXXXXXXXXXXXXXXXXXXXXXXXXXXXXXXXXXXXXXXXXXXXXXXXXXXXXXXXXXXXXXXXXXXXXXXXXXXXXXXXXXXXXXXXXXXXXXXXXXXXXXXXXXXXXXXXXXXXXXXXXXXXXXXXXXXXXXXXXXXXXXXXXXXXXXXXXXXXXXXXXXXXXXXXXXXXXXXXXXXXXXXXXXXXXXXXXXXXXXXX
