----------------------------------------------------------------------------------------------------------------------------------------------------------------------------------------------------?---
--------------------------------------------------------------------------------------------------------------------------------------------------------------------------------------BBBB--------------
-----------------------------------------BBB------------------------------------------------------------------------------------------------------------------------------------------------------------
--------------------------------------------------------------------------------------------------------------------------------------------------------------------------------------------------------
------------------------------------------------------------------------------------------------------------------------------------------X-------------------------------------------------------------
--------------------------------------------------------------------------------------------------------------------------------------------------------------------------------------------------------
------------------------------------------------------BBBBBBBB-----------------------------------------------------------------------------------------------------------------BBBB---------------------
-------------------------------------------------------------------------------------------------------------------------------------------------------------B-----------------------------------------v
------------------------------------------------------------------------------------------------------?------------------------------------------------------------------------------------------------f
-------------------------------------------------------------------------------------------------------------------------------------------------------------------------------------------------------f
-------------------------------------------------------------------------------------------------------------------------------------------------------------------------------------------------------f
-------------------------------------------------------------------------------------------------------------------------------------------------------------------------------------------------------f
-------------------------------------------------------------------------------------------------------------------------------------------------------------------------------------------------------f
-------------------------------------------------------------------------------------------------------------------------------------------------------------------------------------------------------f
m---------------------------------------------X--------------------------------------------X-------------------------------------------------------------M---E-----E----------E----------E------------XX
XXXXXXXXXXXXXXXXXXXXXXXXXXXXXXXXXXXXXXXXXXXXXXXXXXX----XXXXXXXXXXXXXXXXXX-----XXXXXXXXXXXXXXXXXXXXXXXXXXXXXXX-----XXXoXXXXX------XXXXXXXXXXXXX------XXXXXXXXXXXXXXXXXXXXXXXXXXXXXXXXXXXXXXXXXXXXXXXXXXXX
