----------------------------BBB--------------------------------------------------------X-------------------XBXo---B--?-B???X-------XBo---o--------------------------------------X-B--X---B-B-----B?-----
----------------------------------------------------------------------------------------X--------B-----o---M----------X---X--B------------------------------------------X-----?---Bo-X-B--X---B-X-------
---------------------------------------------------------------------------------------------------------------X----B--B--???----B---B-----------------------------------------B--?X?X????-------?------
------------------------------------------------------------------------------------------------B---B-BX--------BT-XX-B-X-T--B-T-o-B------------------------------------------M-XB-------X-X---X--BB----
-------------------?-----------------------------------------------------------------------------X-XB------TB---B|B-Xo-BXB|XBBX|X---B---------------------------------------------B-?-o--XTBMBBB---B--X-
-------------------o----------------------------------------------------------M----T-----XX-------XX-------|--XXB|-XX--BXB|-B--|XXT-?-------------------------------------------------X-X-|X-o----oX--X-
-----------------------------------------------------------------------------------|-----XXX----MXXXB------|-X-X-|XXX-X---|XB-B|XX|--T------------------------------------XX------X-X-XXB-|XXXXTXXXX-XX-
-----------------------------------------------------------------------------------|-----XXXX-B-XXXX-----XB|----B|XXXX--B-|----|XX|--|--X---------------------------------------T-?---XXXX|XXXX|-XXXXXXv
---T-------------------------------------------B----------------------------------?|????-TXXXX-XXXXX--X---B|----X|XXXXX-X-|XTXB|XX|XB|X-----------------------------------------|XXXXXXXXX|XXXX|XXXXXXXf
---|-------------------------------------------------------------------------------|----X|XXXXXXXXXX-XBBBBX|-XXXX|XXXXTX-T|X|XX|XX|XX|-----------------------------------B-X-B--|M---BXXXX|TXXX|XXXXXXXf
---|-------------------------------------------------------------------------------|X----|XXXXXXXXXXTXT--XX|B-XTX|XXXX|XX||X|XX|XX|XX|-------------------------------TX----XX-B-|-----XXXX||XXX|XXXXXXXf
---|------------------------------------------------B-----------------------B------|-----|XXXXXXXXXX|X|XXXX|XXX|X|XXXX|XX||X|XX|XX|TX|X------------------------------|-----XXX--|--XXXXXXX||XXX|XXXXXXXf
---|------------T-----------------------------------------------------T------------|---BB|XXTXXXXXXX|X|XXXX|XXX|X|XXXX|XX||X|XX|XX||X|XX-----------------------------|-----XXXXT|---XXXXXX||XXX|XXXXXXXf
---|------------|-----------------------------------------------------|------------|-----|XX|XXXXXXX|X|XXXX|XXX|X|XXTX|XT||X|XX|XX||X|XXX----------------------------|-----XXXX||B-TXXXXXX||XXX|XXXXXXXf
m--|------------|-----------------------------------------------------|------X-----|B--E-|XX|XXXXXXX|X|XXXX|XXX|X|XX|X|X|||X|XX|XX||X|XXXX---------------------------|----EXXXX||EX|XXXXXX||XXX|XXXXXXXX
XXX|XXXXXXXXXXXX|XXXXXXXXXXXXXXXXXXXXXXXXXXXXXXXXXXXXXXXXXXXXX----X---|XXXXXXXXXXXX|B-XXX|XX|XXXXXXX|X|XXXX|XXX|X|XX|X|X|||X|XX|XX||X|XXXXXXXXXXXXXXXXXXXXXXXXXXXXXXX|XXXXXXXXX||XX|XXXXXX||XXX|XXXXXXXX
