--------------------------------------------------------------------------------------------------------------------------------------------------------------------------------------------------------
--------------------------------------------------------------------------------------------------------------------------------------------------------------------------------------------------------
--------------------------------------------------B-----------------M-----------------------------------------------------------------------------------------------------------------------------------
--------------------------------------------------------------------------------------------------------------------------------------------------------------------------------------------------------
----------------------------------------------------------------------------T---------------------------------------------------------------------------------------------------------------------------
----------------------------------------------------------------------------|----------------------------------------------------------------------------------------------------------------------o----
-----------------------------------------------------X----------------------|---------------------------------------------------------------------------------------------------------------------------
----------------------------------------------------------------------------|--------------------------------------------------------------------------------------------------------------------------v
-------------------------------------------------------------------B--------|--------------------------------------------------------------------------------------------------------------------------f
----------------------------------------------------------X-----------------|--------------------------------------------------------------------------------------------------------------------------f
-----------------T------------------------------------------------------B---|--------------------------------------------------------------------------------------------------------------------------f
-----------------|---------------------------T---------B--------------------|--------------------------------------------------------------------------------------------------------------------------f
-----------------|---------------------------|------------------------------|--------------------------------------------------------------------------------------------------------------------------f
-----------------|---------------------------|---------------------X--------|----------------------------------------------------------------------------------------------------------------X------?--f
m----------------|---------------------------|--------------------XXBBBBB---|----------E----------------------------------------------------------------------------------------------------BXX------E-X
XXXXXXXXXXXXXXXXX|XXXXXXXXXXXXXXXXXXXXXXXXXXX|XXXXXXXXXXX------XXXXXXXXXXXXX|XXXXXXXXXXXXXXXXXXXXXXXXXXXXXXXXXXXXXXXXXXXXXXXXXXXXXXXXXXXXXXXXXXXXXXXXXXXXXXXXXXXXXXXXXXXXXXXXXXXXXXXXXXXXXXXXXXXXXXXXXXX
