--------------------XXX---------------------------------------------------------------------------------------------------------------------------------------------------------------------------------
-------BB----------------------------------------------------------------------------------------------------------------------------------------------------------------------XXXX---------------------
-----------BB-----------------------------------------------BBB-----------------------------------------------------------------------------------------------------------------------------------------
--------------------------------------------------------------------------------------------------------------------------------------------------------------------------------------------------------
--------------------------------------------------------------------------------------------------------------------------------------------------------------------------------------------------------
-----?--------------------------------------------------------------------------------------------------------------------------------------------------------------------------------------------------
--------------------------------------------------------------------------------------------------------------------------------------------------------------------------------------------------------
-------------------------------------------------------------------------------------------------------------------------------------------------------------------------------------------------------v
-------------XXBBBBBBB-------------------------------------------------------------------------------------------------------------------------------M-------------------------------------------------f
-----------------------------------------------------------------------------------------------------B---------------------------------------------------------------------------------------XXXXX-----f
--------------------------------------------------------------------------------------------------------BBBB--BBBB--------------?----------------------------------------------------------------------f
-XXXXXXXX--------------------------------------------------------------------------------------------X-----BBBBBBB--------------------------------------------T------o-----------T--T------------------f
----------------------------------------------------------------------------------------------------------------------?????-----------------------------------|------------------|--|------------------f
-----------XXXX---------------------------------------------------------------------------------------------------------------------------------BBBBBBBB------|--------??--------|--|------------------f
m------------------------------------------------------B----------------------------------------------BBBBB---------------------------------------------------|------------------|BB|BBBB--------------X
XXXXXXXXXXXXXXXXXXXXXXXXXXXXXXXXXXXXXXXXXXXXXXXXXXXXXXXXXXXXXXXXXXXXXXXXXXXXXXXXXXXXXXXXXXXXXXXXXXXXXXXXXXXXXXXXXXXXXXXXXXXXXXXXXXXXXXXXXXXXXXXXXXXXXXXXXXXXXX|XXXXXXXXXXXXXXXXXX|XX|XXXXXXXXXXXXXXXXXXX
