-----------------------------------------------------------------------------------------------------------------------------------------------------------------------------------------------------X--
------------------------------------------------------------------------------------------------------------------------------------------------------------------------------------------------------B-
--------------------------------------------------------------------------------------------------------------------------------------------------------------------------------------------------------
------------------------------------------------------------------------------------------------------------------------------------------------------------------------------------------------?-------
-----T----------------B---------------------------------------------------------------------------------------------------------------------------------------------------------------------------------
-M---|-o---------------------------------------------------------------------------------------------------------------------------------------------------------------------------------------T--------
-----|----------B------------------------------------------------------------------------------------------------------------------------------------------------------------------------------|------X-
-----|-----------------------------------------------------------------------------------------------------------------------------------------------------------------------------------------|-------v
----T|-----------------------------------------------------------------------------------------------------------------------------------------------------------------------------------------|-TB----f
----||?----------------------------------------------------------------------------------------------------------------------------------------------------------------------------------------|-|-----f
----||---------X-------------------------------------------------------------------------------------------------------------------------------------------------------------------------------|-|B----f
----||X------BXXBBB---T------------------------------------------------------------------------------------------------------------------------------------------------------------------------|-|-----f
----||XX-----XXX--X---|------------------------------------------------------------------------------------------------------------------------------------------------------------------------|-|-----f
----||XXX---XXXX------|------------------------------------------------------------------------------------------------------------------------------------------------------------------------|-|-----f
m---||XXXX-XXXXX------|------------------------------------------------------------------------------------------------------------------------------------------------------------------------|-|-----X
XXXX||XXXXXXXXXXXXXXXX|-------XXXXXXXXXXXXXXXXXXXXXXXXXXXXXXXXXXXXXXXXXXXXXXXXXXXXXXXXXXXXXXXXXXXXXXXXXXXXXXXXXXXXXXXXXXXXXXXXXXXXXXXXXXXXXXXXXXXXXXXXXXXXXXXXXXXXXXXXXXXXXXXXXXXXXXXXXXXXXX---|-|--XXXX
