-------------------------------------------------------------------------------X----------------------------------------------------------------------??????BBBBBBBB------------------------------------
----o----------------------------------X----------------------------------------------------------------------------------------------------------------------------------------------------------------
-------------------------------------------------BB-----------------------------------------------------------------------------------------------------------------------------------------------------
------------------------------------------------------------------------------------------------------------------------------------------------------B--------o----------------------------------BBB---
------BB-----------------------------------------------------------------------------------------------------------------BBB----------------------------------------------------------------------------
------------------------------------------------?----------------------------------------------------B--------------------------------------------------------------------------------------------------
--------------------------------------------------------------------------------------------------------------------------------X-----------------------------------------------------------------------
-----?------------------------------------------------------------------o----------B----------------------------------------------BBBBBBBB------------------o--------o---------------------------------v
-----------------------------------------------o-----------------------------------------------------------------------M-------X-----------------------------------------------------------------------f
-----------------------------------------------------------XXXXXX--------B----------------------------------------------------XX??--------------------------------------------------?-?----------------f
----------------------------------------BB-----------------------------------------------------------------------------------XXX-------------------BBBBBBB--------M------------------------------------f
----------------------------------------------------------------------------------------------------------------------------XXXX-------------XXXX---------T----------------------------BBBB------------f
----------------------------------------------------------------------------------------------------------------T--------X-XXXXX--------------------------|---X----------------------------------------f
--------------------------------------------------------------------------X-------------------------------------|---------XXXXXX-----------------X--------|--XX------------------------------BBBBB-----f
mE------------------------------------------------------------------------XX---------------E--------------------|--------XXXXXXX---------------BXX-------X|-XXX----------------------------------------X
XXXXXXXXXXXXXXXXXXXXXXXXXXXXXXXXXXXXXXXXXXXXXXXXXXXXXXXXXXXXXXXXXXXXXXXXXXXXXXXXXXXXXXXXXXXXXXXXXXXXXXXXXXXXXXXX|XXXXXXXXXXXXXXXXXXXXXXXXXXXXXXXXXXXXXXXXX|XXXXXXXXXXXXXXXXXXXXXXXXXXXXXXXXXXXXXXXXXXXXX
