----X----XX----o-----B-BB----------o-----B--X--o-Xo-o--------------------o-o---XB---------o------------o-------oX-------------oB--BE------o?------B-------o---------o----------oo---o--B---------B-o---o
o--o------------o----o----------------X--------------------------B--B---------o--------B-------o-----B-------X--------o-----------oB--------T--------------o---o---B--oB------B----o-----o--o--------oE-
X-----------B---------B---o-o--XB---------------o-------------B----------B----o-B--?-o----?---o--E-Bo-o-o-o---X--------o-----Bo--X------T---|----o--o-------------B---------E--o-oo-B---------X---T---B-
o----------------Xo--?--o--------B------------------B----B---B--------------ooo-B----o---o--Xo-BoXX--------X------BB?------o--oo--------|---|-----o--o-oo--------X-------B--XB---Xo----B-o-o------|--o--
---------o---B--B------oX--------o-X----------oX---o--B---oo----------------------------------o--------B--B---o----o---o-B-o--X-oo---o--|-o-|--XB----EBo-B-o--oB---B--------B---o-------o-o------o|--B--
---------?-o---X--X--B-o-----o------------------o---E--o----------B----oo-----o----o------o----------oo-------------------o-------------|--B|--------X-o----B-------o---X---o----X----B---oX------|--B--
--o----B--X--X-o--X--o----------------o---o--B-----oB-o-oo-------o---o----X------------B------------o------B----oX--------------B-B-o---|---|---o----X----------E------o--------Xo---o-o---oo-B---|-----
---?--oo------oB--?--o------------------X----------o---B----X---B----------B--------?----B-------B----o-T--XB----------------------o-B-B|-B-|----------o------X-B---------------oo----------------|----v
--------------X------------B-------------o---------o---------------oB----B-Bo--------o-XX---Bo----------|-------o--o---BX-BoB--oo-----o-|---|----------oX-B------------BB----B-----------Boo--o--B|---of
-----X---B--------------------------------o---B--------oo--B--o-------ooo----o-oBo--------o-B-------B--o|-------oX---o--oB--------------|---|-------B----o----o------------o-B----X----XB---------|--B-f
o-Boo------B----B----o-------o----------B--o----o-----o-----X-o-----B--o---o------------------o-B------X|----o---------X------------o---|--o|--B-----o-o---------?-------BB-----o-------X---------|-B--f
---XB----------B---o-oX------------oXo------B----o-------------oo-XE-----B--o-B-------------E-B--B-oo---|------B--o--XX-------B------X--|---|-B---B-----------o---o--o--o-B---o----X-----XB--o---o|-BB-f
--B----o----o------B---o-o----X--B---X-o----------B-------oo-------B------o-o---------------X-oo-----B-B|------B----B-o--------o--------|---|-B-o-----o------------B----o----o--------------------|----f
--------o---Xo---B----o---------o------------B------o--------o---B--------o------B-B----B-X------oB----B|---B-BoB------o--o----X---E----|-o-|--------B------oX--o------oo-B-o-oX--X----E-XoX------|----f
m--X--ooo------------o----B-X----o--o----B-----oB-E---E-B--o-o---BX---------------o----o----Xoo--------X|---o--o--------B-----oX---B----|---|-----oE--oo---E--X--------E----oo-----E-o-B-----oE---|--B-X
XXXXXXXXXXXXXXXXXXXXXXXXXXXXXXXXXXXXXXXXXXXXXXXXXXXXXXXXXXXXXXXXXXXXXXXXXXXXXXXXXXXXXXXXXXXXXXXXXXXXXXXXXXXXXXXXXXXXXXXXXXXXXXXXXXXXXXXXXXXXXXXXXXXXXXXXXXXXXXXXXXXXXXXXXXXXXXXXXXXXXXXXXXXXXXXXXXXXXXXX
