------------------------------------------------------------------------------------------------------------------------------------------------------------------o-------------------------------------
-------------------------------------------------------------------------------------------------------------------------------------------B-----------------B-----------?-----------------X------------
-----------------------------------------------------------------------------------------------------------------------------------------------------------B-----?---------------------?????X-----------
------------------------------------------------------------------------------------------------------------------------------------------------------------------------B----X--------------------------
----------X------------------------------------------------------------------------------------------------------------------B------------X-----------------X-B-T---X-----?--------X---------B----------
----------------------------------------------------------------------------------------------------------------------------------------------------B-----------|----------XXXXXX---------o-----oo------
------------------------------------------------------------------------------------------------------------------------------------------BB----------------B---|-----------X--------------------T------
----------------------------------------------------------------------------------------------------------------------------------X----------X------------------|------------?-------------------|-----v
--------------------------------------------------------------------------------------------------------------------B-----------------------------------X-------|----X-X------------?----------X-|-----f
------------------------------------------------------------------------------------------------------------------------------------------------------X-XX------|----XX--------------------------|-----f
----------------------------------------------------------------------------------------------------------------------------------------------T------XXXXXXX----|----XXX-------------------------|-----f
---------------------------------------------------------------------------------------------------------------------------------------------B|--B----XXXXXX---T|o---XXXX------------------------|-----f
----------B----------------------------------------------------------------------------------------------------------------------------------B|-------XXXXXXX--||---BXXXXX-----------------------|-----f
-------------X--------------------------------------------------------------------------------------------------------------------------------|-------XXXXXXXX-||----XXXXXX---X------------------|-----f
m---------------------------------------------------------------------------------------------------------------------------------------------|-------XXXXXXXXX||----XXXXXXX-EXX---E---E----B--E-|-B---X
XXXXXXXXXXXXXXXXXXXXXXXXXXXXXXXXXXXXXXXXXXXXXXXXXXXXXXXXXXXXXXXXXXXXXXXXXXXXXXXXXXXXXXXXXXXXXXXXXXXXXXXXXXXXXXXXXXXXXXXXXXXX-------XXXMXXXXXXX|-XXXXXXXXXXXXXXX||BXXXXXXXXXXXXXXX----XXXXXXXXXXXX|XXXXXX
