---o---o----------o------oo----o-o----o------B-----B---o-------X--o---o------------B---------o---------o---B-------o--o----B---o--o---o------o-o---X-----oo-BXo----------oB----------B---o---BB-------oo
--B----o---B-------------o----------B----o------B---------Xo-------------X-------o--o----o-------X-o--o------o-----B----X--o-o-----B------o-----oBBo-------------------B--oX--E----X-o--B-------Bo-----o
-B--o--o---B-----o----BE-----------------Bo-X-B-Bo------------X---o-B--BX--oB---B-X--B----------------o-o------X----------o----B-----B-B-----B--oB---o----B------oo-------B---B-------X-----oB-oBB---o--
----o---------o------XBB-------X-----Eo----oo----o-------o------o--B------------oB--o-------o----B-----o-X--oBX-----o-B---oXoX-------o-----T---------T--Boo----B------B----o---?--o--Bo-B---------oo-B--
----Xo---------o---------------X---o-X-o---------o--------Eo---------T-----o-B-B------o---o-------B-------oB--o-----Bo--o---B--------X--B--|------o-o|----B---B-------BBXX-E-----X-----T---B----------o-
-X----------------X--------------X-B--BB--o--------o----o-B---------E|--o----------X----------o--B---E-oB---BX-----oB---X-------ooo------B-|---T-o---|--o-----o----------o-B----o--o---|---------------o
-o------------o-B---o---------B----X----------Bo--------oo--o-------B|---------oo-------------o-------------Xo----B----oX----------o--B----|---|---XX|------------B-----o----o---------|----o-----------
------B---E-BBB------o---oo-------X-oo----B-----E-----B-------------B|----B------BX------------------X---B--o----X--B----------X----Bo-B---|---|----B|-o----------X------B---------X---|-X---BB------?-v
--X-o--B--Bo-------o----X----o---------o--------B-o-o---o---o-------o|---------B-o---B--o------X-------o-------B--B--------X--X-o--X------?|-B-|---o-|----o--oo---------oo-------------|---B--------o-Bf
---X-------o--o-X-----o-B---XX--o----------Bo----o----------Bo---B--B|----oo-o----?---o----------X------------o------X-------o----o--o-BB--|---|--o--|-o-----o---------o-o?-----------B|-B-X---------o-f
---B--o--------------o--------B-----o-----Boo-B-----XB----oo--?------|-o-----Xoo----o-----E-o--X-BB-B-oX---X---B------------o--B---T-------|---|---B-|------X-------B--------XX--T----o|----------o----f
----Bo----o------o---------B-----X--B---Xo---o--B-----------B--oBB--E|------o-----BX------B-o---Eo-----B-B-B-B------o----o---------|-------|---|-B---|-------B--BoB--X-X---------|-Bo--|------X------B-f
------o-------------o-----------B-B------o-oB-----o---o-B-----------B|-----X--o-o---------------X--o------B--oB-------------oB-----|-B---oB|---|-----|--o-------B--------B---E--B|-----|----B-o-X------f
-o----oX----------o-B----------BT-------B-X---o------------o----B----|---------------B--------o----?-----------o-o-----------o--X--|-----XB|---|-----|--------------B-X------X---|-----|-----B---o---o-f
m-------oo--oX-B----o----------B|--o--o--------BX----o-----X-oE------|----------E---o---------o--o------E-----X--------X---B-oo----|-----o-|---|--X-o|--XB-----------o-o--Bo-B---|---B-|---oB--E------EX
XXXXXXXXXXXXXXXXXXXXXXXXXXXXXXXXXXXXXXXXXXXXXXXXXXXXXXXXXXXXXXXXXXXXXXXXXXXXXXXXXXXXXXXXXXXXXXXXXXXXXXXXXXXXXXXXXXXXXXXXXXXXXXXXXXXXXXXXXXXXXXXXXXXXXXXXXXXXXXXXXXXXXXXXXXXXXXXXXXXXXXXXXXXXXXXXXXXXXXXX
