-------------------o-------B----------?B-o--o-------XX-X-------------B-------B--X---------o---oo--B--o--o-----BXX----------o---------------o---o--oo--B----------o--ooX----------------oo----oo---B---o-
-X---o-oo---M----------X--------X------BB---o-o-----o-----------o---X-----o---B----B-------oX-----B---o-B-----o------o-o---o--------X---E---------B--X---------B-----X--------B--oBo--------------BB----
----------B--B--E-----------------oo-------T----------B---o-Bo-X-----Eo-B------o---------Bo-o--o----o--oB---o---B---------------B---B---X-------BBX-X----oX---------oBo----------Bo--------oB---X-------
--B-------------B-B-------Bo-----oo--------|---oX---X-B----B--------------Xo------------X--o---X-----X-----------oB-o-X-------------------o-----------o-----------------o----XB---B---o----X-oo--o------
-------BX----B-----B-E--B----Bo-o----X---o-|---XB---oX-----------X--B-oo-----------------BBoX-------------ooo-o------X----------------oB----B----B------ooo----------------o-----------o--oo---E--------
?-o--o--o-------X------------o-----oo-----o|--Boo-o--------B-B-------oB----B--oo-B--o-----------X--o--Bo--------o-B--------------X----------oE-----B--X-------T-----------------Xo-----o----------oo---B
--------------X?--X----o-------o-----o-B-X-|--------oB-------B---B-B----------X----X------Xo------XX---EoX--o------o-B----Bo-o--------o------------------o----|------BB--------------XB-----o-----------
o--oo----X----o--X----B-----X--------------|--------X-B-X-o---------B---oBB-------o------B----XX----Xo-----------B-B-------X--XXo-oX----------oX-------Bo-o-o-|----X-----B-----------------o--------E--v
-----E----X--o---------o-----o--o-B--oB---o|--B------ooX----B-----B-------B---B--------------?----o------oX-B----XBBo----B--oB-o------------o---o--o-o-------o|--oo----X----------o--o----X-----B-B-B--f
---o---------Boo---o---o-o--o---o--------B-|---------------X-----B----oo-B---------X-----------X--------o--B-----o--oo--B---------------B---B-----------o-B---|--oBB----------o----o--------------o---Bf
o----o---BBo--oo-----------T-B--oB--X-----B|-B----B-----B------oo-E----o----oB-B--B-o-o----B--B----o--o----o--o---B-o-X----X--------X----------B--------o-----|--------------o-----B------o-----B-B--X-f
-----B-----XX-E---B---o----|--oT---------XX|--B-----oB---B--B-o-o---------B-----------o?-o----?------------BB-o-----B-----------oo----X------XB----o-o---o--o-|-------E----?---B--o--o-B---------------f
------oo--------o--B---B---|-oB|--oB-------|---X-----------o------o---o----oo--o---B----o-------o---o---XX--B----X-X----EX-----o-Eooo----oB----oEX-----B------|-o--o-----------o--------X-----B--E-----f
-X------B-----E-------o----|---|-----o--B-o|----oo---o--B-o------o---B-o---B--------X-o-X-o-------Xo-B-----B---B-B-o--BE--o-----oo-----X---------------Bo-----|--oo--oo--o-----EB--B---X-----BXB--X---of
m----------------B-B--o----|-B-|----ooX--E-|-B------Bo---------------E-X-----B--o--o-E-XB-------o--o-----B--o-B--o----B---B----o-ooE-B-----X--o-o----o---B----|--o-----B-EBo-B-X--------o--o-B----oX----
XXXXXXXXXXXXXXXXXXXXXXXXXXXXXXXXXXXXXXXXXXXXXXXXXXXXXXXXXXXXXXXXXXXXXXXXXXXXXXXXXXXXXXXXXXXXXXXXXXXXXXXXXXXXXXXXXXXXXXXXXXXXXXXXXXXXXXXXXXXXXXXXXXXXXXXXXXXXXXXXXXXXXXXXXXXXXXXXXXXXXXXXXXXXXXXXXXXXXXXX
