---o--oE--o--o---?-X---B-----o-----B-----------o-----------B-o-----oo-o----Eo---o-B-------o--------BX-------o---X-------B-oo--o-o---------o-T--------Xo------------o--------o---------o--o--Xo---oX-----
-BXBB--B-----X-----oB-----Bo-ooB-------o-B------------------?------------?-X--o--oX------o------o---Bo------------o----B----o-o--------o--X-|---------B--X-XBo------------------o-------o--o-------oB--B
o------B--B--------------o-------B-XB-----B----B------BX--oo--X---ooo-------B-----BX------------o----B-o--------------o--o-----------B------|----o--o-Boo-oB------B--------o---o--E----EB--o----X---o---
-X---BB---?-o---oo-B----BX--------o-oB-------------B-------BB-Bo-----B-X-------------B------o--B-----o---B-B-o----------oo---o--X--------X--|------o-B---o----o-------o---------X-B----B--B-------?--B--
X--o-----B--------------B-----oBo------o-B----oBB-o-----------B--------B----o------------B-----B-B--B---------o---------o-------oBo------B--|--BX------------------X--------X-o--o---------------------X
-----oooo--o----B--------------o-----o-------o---X-----B----B---oo----------------o---------E---o----------B--X--B-----------XXo--EX-XBB----|--XX-B-B---B----X-----E-----Xo--------B----o---------o---X-
o--X----------o--o--o----BB----B---------o----X----o-o------o----X--oB--------BX-------o-oo-X-------?o-----------------------o----B--o--B---|---o-------------oX-oXBo-oo-------B-o-------T-X-----X------
-----------------o-----o-o-----o--------------------B-----X------B-B---------o----oo--------Xo--o---------------B------?---oB------------o--|--------oB------------------o-B------B-B----|-----B-------v
---B-----oB--o--?-------------B--o-o--o----------------B--------B------B----------o------------X---B---o-------X----?-----o---------------Bo|-----------B-----------------o--------------|---oX---o-o--f
B---------o-o-B--------BXB-----------------B-----o------X---------o-----------B-o-o-o----o------------B-Xo-B-Bo-BB-o----oo-----o--B-o-----oo|---o---B-------------------X----B------oo---|--B--Bo------f
---------o------------ooo-------o--B-----------o--X----o---o---X-X----------------Xo---o-o-----oBo------E----------o----E---X----BB----X-o--|---B---BX----X-o-X---------o-----T-o-----B--|-------o-X--of
o-B-----X-o-----Bo------------o-o-------B-B---BXoo------o----o------------B-B----X----B------o--B-----X-BB------------X-B---------------o---|--------B------o---------------o-|----------|-X-------o---f
o------oo------------X-B---X------------o--------o---o------------B-----------o--o-o-oo--------------B-X---BX--------------------o--o---oB--|-B---?-X----E-------------------o|----------|-X---o---B-o-f
----------o----BB--B----BE--o-o-X--Xo--o-o--------B----------o--Bo---o-Eo-------o-B-----------------------?---o------------------oo----o----|-o-o--------B-o------B---o----B--|----------|-----B-------f
m-----o--BBX--BB---------X----EX-----oX-X----o-------Boo------E--------X----oB-------B------E-o-X------EE--oo-Eo-o--oo----------E-----X-BB--|----------B--EE-EB-o---------E---|---o----o-|-------------X
XXXXXXXXXXXXXXXXXXXXXXXXXXXXXXXXXXXXXXXXXXXXXXXXXXXXXXXXXXXXXXXXXXXXXXXXXXXXXXXXXXXXXXXXXXXXXXXXXXXXXXXXXXXXXXXXXXXXXXXXXXXXXXXXXXXXXXXXXXXXXXXXXXXXXXXXXXXXXXXXXXXXXXXXXXXXXXXXXXXXXXXXXXXXXXXXXXXXXXXX
