-----------B-------------------------------------------------------------------BBBB------------------X----X---B------------B---M--X---------------------------------B---------X-B--o---???MBBBBBB--o----
-----BX-----o----------B------------------------------------------------------------------------------?o---X-M-----B----X--M----X----------------M--------------------------X-X-------------------B-----
--------X----X--X----------------------------------------------------------------------------X------B-----------------------------------------------------------------?--BX-------X--B--X---------------
------------B-------------------------------------------------------------------------------------B-o--------------X----------XB----o------------------------------------------------------------X----o-
--------B-----X------------------------------------------------------B------------X-------------X---X-----T-------------X-----B-----B----X-----------------------------------------X----BB--------------
-----X-----------------------------------------------------------------B------------X--X---------B---T-T--|------------XX--B--B---X-------------------------------------------X-------------X-----------
----B-BX---------X-B----------------------------------------------------------------T-XX--XT-X-----XX|X|XX|---BB---BBBXXX?----B-T------------------------------------BBB------XX-B----B-----XX---??????-
--------X---------------------X------------------------------------o----------------|XXX---|--?------|-|--|--BX?---BXXXXX-------|---------X----X------------------B-----------XXX-------X---XXX--------v
-------------B---------------XX---------------------------------------------------X-|XXX-BB|-XXXXBX--|-|--|---------XXXXX-------|-----M-------XX------------------------------XXXX-------B--XXXXTBB----f
------T--------X------------XXX----------------------------------------XXXXX------BX|XXX---|B-----X--|-|--|--T---X-XXXXXXBB-----|-----X------XXX---X--------------------------XXXXX------X--XXXX|------f
------|----o---------------XXXX-----------------------------------------------B---XX|XXX---|----X----|-|--|--|----XXXXXXX--X-B--|-----------TXXX---XX-------------------------XXXXXXX-------XXXX|X----Xf
------|-----------B-------XXXXX--------------------------------------------------XXX|XXX---|----X----|X|-X|??|??MXXXXXXXX--XX---|-X--------X|XXXX--XXX--------X---------------XXXXXXXX-B----XXXX|XX----f
--T---|------------------XXXXXX-------------------------------------------------XXXX|XXX---|----XX---|X|-X|-X|--XXXXXXXXX--XXX--|----X---XXX|XXXX--XXXX---------B-------------XXXXXXXXXBT---XXXX|XXX---f
--|---|-X---------------XXXXXXX------------------------------------------------XXXXX|XXX---|----XXX-X|X|-X|XB|BTXXXXXXXXX--XXXXX|-------XXXX|XXXXX-XXXXX----------------------XXXXXXXXXX|---XXXX|XXXX--f
m-|-E-|----------------XXXXXXXX--------------------------------------------E-oXXXXXX|XXXE--|-B-XXXXXX|X|-X|XX|X|XXXXXXXXX-XXXXXX|---o--XXXXX|XXXXXXXXXXXX-----E-E-------------XXXXXXXXXX|E--XXXX|XXXXXMX
XX|XX-|-XXX--B-X------XXXXXXXXXXXXXXXXXXXXXXXXXXXXXXXXXXXXXXXXXXXXXX---XXXXXXXXXXXXX|XXX---|BXBBXXXXX|X|-X|XX|X|XXXXXXXXXX-XXXXX|-XX-XXXXXXX|XXXXXXXXXXXXXXXXXXXXXXXXXXXXXXXXXXXXXXXXXXX|XB-XXXX|XXXXXXX
