--------------------------------------------------------------------------------------------------???????B--------------BBB-?????-----------------------------------------------------------------------
-----------------------------------------------------------------------------------------------------XXXXXX----------------------------------------?????---B--------------------------------------------
-----------------------------------------------------------------------------XXXXXXXX--------------BBBXXXXXXX--------------XXXXXXX----------------------------------------------------------------------
------------------------------------------------------------------------------------------------BBB??????------------------------????----------B----------------XX-------------------BBBBBBBB-----------
-----------------BBBBBBBB-------------------------------------------------------------------------------------------???????-----------------X---?????---------------------------------------------------
----------------------------------------------------------------------------------------B--------------????---------------------------------------------------------------------------------------------
-------------------------------------------------------------------------------------------------------------------------------------------------------XXXXXX-------------------------------------------
----BBBBBBBB------------------------------------------------------------------------------???????-------------X---------------------------------------??------------------------------------o----------v
----------------------------------------------------------------------------------------------------------XXXX-----------------------------------------------------------------------------------------f
-BBBB------?????-------------------------------------------------------------------------------------------------XXX----------------XXXX-???????---------B---------------------------------------o----Xf
--????----------------------------------------------------------------------------------------------------------------------------------?????---------------------------------BBBB---------------------f
-X?-------------------------------------------------------------------------------------------------??-----------------------------------------------o-?????---------------XXXXX--------------BBBB-----f
--------XXXXXXX--------------------------------------------------------------------------------------------------------------????o----------------------------XT---?B???------o-------------T----------f
--------????????--------------------------------------------------------------------------X-------BBBBBBB-----XXXXX-----------------------------------------TXX|------------------------X---|----------f
m--??------------------------------------------------------------------------------------XX------------BB?B--XX------BBoBBBB--------o------E-X---M----E-----|-X|X----------------------XX---|-E----?---X
XXXXXXXXXXXMXXXXXXXXXXXXXXXXXXXXXXXXXXXXXXXXXXXXXXXXXXXXXXXXXXXXXXXXXXXXXXXXXXXXXXXXXXXXXXXXXXXXXXXXXXXXXXXXXXXXXXXXXX----XXXXXXXXXXXXXXXXXXXXXXoXXXXXXXXXXX|-X|XXXXXXXXXXXXXXXXXXXXXXXXXXXX|XXXXXXXXXXX
