--------------------------------------------------------------------------------------------------------------------------------------------------------------------------------------------------------
------------B??????------------------------------------------------------------------------------------------------------XXXXXXX--------------BBBBB-----------------------???????-----------------------
---------------------------XXXXXXX-----------------------------------------------------------------------------------------------------------------BBB--------------------------------------------------
---------------------------------------------------------------------------------------------------------------------------------------------------------------------o-------------------------------B--
----BBBBBB----BBBBBBB-------B-----X----------------------------------------------------------------------------------------------------------------??????------------------------BBBBBBBBBBBB-----------
--------------------------------------------------------------------------------------------------------------------------------------------------------------------------------------------------------
----------------------------------------------------------------------------------------------------------------------------XX----------------------------X----------------------------------------o----
-------------------------------------------------------------------------------------------------------------------------------------------------------------------------------------------------------v
--------------?????XXXXXXXX------------------------------------------------------------------------------------------------------------------------------------------------X---------------------------f
-------------------------------------------------------------------------------------------------------------------------------------XXXXX------------????????-----------------------------------------f
-------------------------------------------------------------------------------------------------------------------------------------------------------------------------------------------------------f
------XXX----------------X--------------------------------------------------------------------------------------------------------------------------------------------------T-------------------------Bf
--T---------------------XX---------------------------------------------------------------------------------------------------------------o----------------------------------|--------------------------f
--|--------------------XXX-------------------------------------------------------------------------------------------------------------------------------------BBB----------|??------------------------f
m-|-------------------XXXX----------------------------------------------------------------------------------------------------------------X-X-----------E--------------X----|--------E-----------------X
XX|XXXXXXXXXXXXXXXXXXXXXXXXXXXXXXXXXXXXXX------XXXXXXXXXXXXXXXXXXXXXXXXXXXXXXXXXXXXXXXXXXXXXXXXXXXXXXXXXXXXXXXXXXXXXXXXXXXXXXXXXXXXXXXXXXXXXXXXXXXXXXXXXXXXXXXXXXXXXXXXXXXXX|XXXXXXXXXXXXXXXXXXXXXXXXXXX
