--------------------------------------------------------------------------------------------------------------------------------------------------------------------------------------------------------
-------------------------------------------------------------------------------------------------------------------------------------o------------------------------------------------------------------
-----------------------------------------------------------------------------?--------------------------------------------------------------------------------------------------------------------------
------------------------------------------------------------------------------------------------------X------------------------------------------------------------------------------X------------------
-----------------------------------------------------------------------------------------------------------------------------------------------------------------------------?????----------------------
-M----------------------------------------------------------------------------XXXXXXX-------------------------------------------------------------------------------------------------------------------
-----------------------------------------------------------X---------------------------------------------------------------------------------o----------------------------------------------------------
------------------------o---------------------------------o---------------------------------------------------X---------------------------------------------------------X-------X----------------------v
----T-----------------o--------------------------------------------------------------------------------------------------------------------------------------------------------------------------------f
----|---------------------------------------------------------------------X----------------------------------------------------------------------------------------------------------------------------f
----|X----------------------------------B---------------o-----------------XX-----------------------------------------------------X---------------------------------------------------------------------f
----|XX-------------------------------------------------------------------XXX--------------------------------------------------------------------------------------------------------------------------f
----|XXX------------------------------------------------------------------XXXX-----------------------------------------------------B---------------------------------?---------------------------------f
----|XXXX-----------------------------------------------------------------XXXXX------------------------------------------------------------------------------------------------------------------------f
m---|XXXXX--------------------------------------------E----------X--------XXXXXX-------------------------------------------------B------E------o-------------------------------------X--------o--E-----X
XXXX|XXXXXXXXXXXXXXXXXXXXXXXXXXXXXXXXXXXXXXXXXXX---XXXXXXXXXXXXXXXXXXXX--XXXXXXXXXXXXXXXXXXXXXXXXXXXXXXXXXXXXXXXXXXXXXXXXXXXXXXXXXXXXXXXXXXXXXXXXXXXXXXXXXXXXXXXXXXXXXXXXXXXXXXXXXXXXXXXXXXXXXXX----XXXX
