----------------------------------------------------------------------------------------------------------------------------X--M--X---B----B---------------------------------------------BB-X--M--------
--------------------------------------------------------------------------X----------------------------B--------B------------X--XBXXX-----------B---------------------------------------Xo-------BBBX---
-------------------------------------------------------------------------------------------------------B--------------------------BB-----X--o-------------------------------------------B---?---B--B----
----------------------------------------------------------------------------------------------------------------X-----------------X-----????-----------------------------------------------X????------X-
-X---------------------------------------------------------------------------------------------------------XB---------------B---B-??-BBBBBBBBB-----------------------------------------XBXX-?-X---X---X-
-----------------------------------------------------------------------------------------------------------------BB----------X-B---MXB---X-------------------------------------------X--XXXXTXMXX-XBBBX-
--------------------------------------------------------------------------------------------------------------X---B-----------B----------------------------------------------------B---X----|XXBXXXX--X-
---------------------------------------------------------------------------------------------------B------------------------------BB--BX--M---------------------------------------------X---|X--XXXXX-Xv
------------------------------XXXX-----------------------------------------------------------------------------------------T---X-----o-XX-X-------------------------------------------T-XX-X|XX--BXXXXXf
------------------------------------------------------------------------------B------------------T----------------XXXX-----|---B-------XXXXX------------------------------------------|-XXX-|XXXBXXXXXXf
---X---------------------------------------------------------------?-----------------------------|-------------------------|---?-------XXXXXX----------------------------------------B|-XXXX|XXXX?XXXXXf
------------------------------------------------------------------------------------------------B|-----X---------B-X-------|---------TXXXXXXXXBBBBB----------------------------------B|-XXXX|XXXXXXXXXXf
-------------------------------------------------------------------------------------------------|-------------------------|-XBB-B---|-XXXXXXXX--------------------------------------B|BXXXX|XTXXXXXXXXf
-------------------------------------------------------B-----------------------------------------|-------------------------|---------|BXXXXXXXXX--------------------------------------|-XTXX|X|XXXXXXXXf
m------------------------------------------------------------------------------E----------E------|-----M----------E-------E|-X--B-EXE|XXXXXXXXXXX-----------------------------------X-|-X|XX|X|XXXXXXXXX
XXXXXXXXXXXXXXXXXXXXXXXXXXXXXXXXXXXXXXXXXXXXXXXXXXXXXXXXXXXXXXXXXXXXXXXXXXXXXXXXXXXXXXXXXXXXXXXXX|XXXXXXXXXXXXXXXXXXX-XXXXX|XXXXXX--B|-XXXXXXXXXXXXXXXXXXXXXXXXXXXXXXXXXXXXXXXXXXXXXXX|XX|XX|X|XXXXXXXXX
