--------------------------------------------------------------------------------------------------------------------------------------------------------------------------------------------------------
--------------------------------------------------------------------------------------------------------------------------------------------------------------------------------------------------------
------------------------------------------------------------------------------------------------------------------------------------------------------------------------B-------------------------------
--------------------------------------------------------------------------------------------------------------------------------------------------------------------------------------------------------
--------------------------------------------------------------------------------------------------------------------------------------------------------------------------------------------------------
--------------------------------------------------------------------------------------------------------------------------------------------------------------------------------------------------------
---------------------------------------------------------------------------------------------------------------------------------------------------X----------------------------------------------------
-------------------------------------------------------------------------------------------------------------------------------------------------------------------------------------------------------v
-------------------------------------------------------------------------------------------------------------------------------------------------------------------------------------------------------f
---------BBBBB-----------------------------------------------------------------------------------------------------------------------------------X-----------------------------------------------------f
----------------------------------------------------------------------------------------------------------------------o-------------------------XX-----------------------------------------------------f
------XXXXXXX----------------------------------------------------------------------------------------------------------------------------------XXX-----------------------------------------------------f
----------------------------------------------------------------------------------------------------------------------------------------------XXXX--XXXXX----------------------------------------------f
---------------------------------------------------------------------------------------------------------------------------------------------XXXXX-----------------T--------------------------------X--f
m--------------------------------------------------------------------------------------------------------------------------------------BBBBBXXXXXXBBBBB------------|-------------------------------XX--X
XXXXXXXXXXXXXXXXXXXXXXXXXXXXXXXXXXXXXXXXXXXXXXXXXXXXXXXXXXXXXXXXXXXXXXXXXXXXXXXXXXXXXXXXXXXXXXXXXXXXXXXXXXXXXXXXXXXXXXXXXXXXXXXXXXXXXXXXXXXXXXXXXXXXXXXXXXXXXXXXXXX|XXXXXXXXXXXXXXXXXXXXXXXXXXXXXXXXXXXX
