------------------o------------------B---------o---o----o--------B--------B-----o---o-------------------------------X------------------o---------------o-o----o---------B----B--------------------o-----
--------------------X---B---B------------------------------X-----------------Xo--o----------------------------o----------------o------o-----------------X--o--o--o---B--o-------------------------o-----
-------oo----Bo-----o--?--E--------------o-------------------o--------o--------X-----------------o-B---B----oo-B-o-------E-X-----BB---o------------------B------------------------B--------B---B-------o
BX--o-o----------X--------------------X-B--E-o-------------B--------B---o-----o-B--------------o-EBo-----BBB-o------------o-------------------------o----------o--------B?o-X-----o-----B----o--B--B--o-
----------------B---X-----------X-B-oX---X----X------------B-------------------o-o-X---o---------------------------oo--o---o--B-o-----o---o-----E------o------------B-----o-----------------o----ooo---o
-----o---B------------o-o--------B-oB----B---------------Xo--o---B--------------o----E--o------------------o----------E------------X----XB--o-?----o---------------B--Bo--------o---E-X-----o----B-----B
-----o---o------B-X--------oo---o------------o------------Bo------o----------oBo------------X----------------B-B-----B-----o-----------o--oX---------------o---o--o--B--------B-----o----B-----B-o------
-----B--o-X--oB--o--oo----o-o-?----o-------------X--------B-------oB-----------o-o------------B--oBo------------X--------------------B-o---------o---------X--oB-------o---oB----------BB-o----o-o-----v
---------o----------B-o---------------X-o---------o--o------------------------B---o----------Bo------------------------X--------------B--X--o----------------oo--B------------X---oBo--o-----B--o------f
o----------------B--oo-------------XB--oB-B-B--------B-X---------o--BB----o---------------------o---o---------B---X-----o----o------B----oX-----------------------B-------------o----B-----------------f
---E-----B------B-------------------------E-----------B-------o---------o----B-oo------------BE--B-------------------o--------E------------------B-B--------------------B-----X----B-------o---------o-f
-----X-o-----------------X----o----o-o-o-----------M--B-o------oE----------------------------------Xo-----------------o---------B-o---------o--------B--X----o----------o--X----o--oo----X-----------B-f
------------X------o-----X-B----------oo--------o-----------o---B--------o---B----------B---------B----Xo----B--B-X------X---------o-------oo-o--o--------o-B----o------X--B----BB---X--X---------o--o-f
----o-------------o---------o---o----o-o--------------o------o--------------------------o----B-------------X-o--E-o----o------------E-E--------o-------------------EXo-B------------------------------of
m----X-----o---------------B--o---E--E-oX-X----o--X----o--------oB----B-------------X-o-------B-----------X--------------------B------B----B-X-o-----X------X-------X---?------X--o-o--o--o-BBBo--Bo---X
XXXXXXXXXXXXXXXXXXXXXXXXXXXXXXXXXXXXXXXXXXXXXXXXXXXXXXXXXXXXXXXXXXXXXXXXXXXXXXXXXXXXXXXXXXXXXXXXXXXXXXXXXXXXXXXXXXXXXXXXXXXXXXXXXXXXXXXXXXXXXXXXXXXXXXXXXXXXXXXXXXXXXXXXXXXXXXXXXXXXXXXXXXXXXXXXXXXXXXXX
