------------------------------------------X-----------------------------------o---------------B----------------------B-------o--BBB--BBBBB-------M---XXXXX-----B--------------X?----X--B--------------X-
-------------------------M----------XXXXXX-----------------------------------M----------------B-----o----------BX-B---M-----B--B-----o--XB-M--?--BXBBBBBB---B---B----------X-B--------------------------
---------------------------------------------------------------------------------B----------------------------B----------M------B-X---------------?----X----------XX-------B------------------XXXXXXX---
---------------------------------------------------------------------------X----------------X-------------X---T-------B------------T------------------o----------B-X-------------B----------------------
----------------------X-----X-------------------------------------------------------XXX-----B--------------o-T|----o?-----------X--|B-X-------oXB---X-B--------------B----------------------o--------X--
--------------------TXX----XX------------------------------------T--X-----------------o-----------------X-X--||--XT--------XM--XX--|-----X------??--?-??????o------?-X----B-BBBBBB-BB---------------XX--
--------------------|XX---XXX--------------X---------------------|---------------------------------X--o------||-T-|TX----B?---XXX--|---------B---------------X-T---?-XX----B-----------------------XXX--
-------------------X|XX--XXXX--------XXBBBBXX------------------X-|-------------o------------------------T----||-|-||XX----TT-XXXX--|-o---------X-----BXB-----?-|--???XXX?-------------------------XXXX-v
------------??????XX|XX-XXXXX-----------X-XXXX----------------XXB|------------------o--X----B-----------|----||-|-||XXT---||XXXXX--|---X----B-BXX-----XX-BT---X|-----XXXX------------------------XXXXX-f
-----------------XXX|XXXXXXXX-----------XXXXXXX--------------XXX-|----------B-----X----------o----X-----|----||-|-||XX|X--||XXXXTB-|B??????X?--XXX--M-XXX?|----|o--X-XXXXXBBBBBX----------------XXXXXX-f
------?---------XTXX|XXXXXXXX-----------XXXXXXXX------------XXXX-|---o----B---B---X-B----------?--XX-?--|----||-|-||XX|XX-||XXXX|--|-X-----XXBXXXXX---XXXX|---M|---XXXXXTXX----XX---------X----XXXXXXX-f
---------------XX|XX|XXXXXXXX----------XXXXXXXXXX----------XXXXX-|-----------------------B--------XXX--X|----||-|-||XX|XXX||XXXX|X-|?-BX---XXXXXXXXX--XXXX|-B--|---XXXXX|XXX---XXX-------XX---XXXXXXXX-f
--------------XXX|XX|XXXTXXXX---------XXXXXXXXXXXXo-------XXXXXX-|---------B-----X--T-------------XXXX-X|----||-|X||XX|XXX||XXXX|XX|--XXB--XXXXXXXXXX-XXXX|XBBB|---XXXXX|XXXX--XXXX--B?-XXX--XXXXXXXXX-f
-------------XXXX|XX|XXX|XXXX--------XXXXXXXXXXXXXX------XXXXXXX-|-------------X----|-------------XXXXXX|X---||?|X||XX|XXX||XXXX|XX|-XXX---XXXXXXXXXXXXXXX|XX-B|--XXXXXX|XXXXXXXTXXX---XXXX-XXXXXXXXXX-f
m-----------XXXXX|XX|XXX|XXXX-------XXXXXXXXXXXXXXXX----XXXXXXXX-|---------B--------|-------------XXXXXX|XX--||X|X||XX|XXX||XXXX|XX|XXXX-EXXXXXXXXXXXXXXXX|XXX-|-XXXXXXX|XXXXXXX|XXXX-XXXXXXXXXXXXXXXX-X
XXXXXXXX---XXXXXX|XX|XXX|XXXXXXXXXXXXXXXXXXXXXXXXXXXXXXXXXXXXXXX-|XX-XXXXXXXXXX-----|--XXXXBB-----XXXXXX|XXX-||X|X||XX|XXX||XXXX|XX|XXXX-XXXXXXXXXXXXXXXXX|XXXX|XXXXXXXX|XXXXXXX|XXXXXXXXXXXXXXXXXXXXX-X
