---------------------------X-----------------------------------------------------------------------------------------o-------X----------------o-----X-----------------------------B----M-B--------------
--------------------------------????????----------------------------------------------------------------------------------------------------B---B------------------B---------------o---------------?----
--------------------------------------------------------------------------------------------------------------------------------------------------------------X--B--------------------------------------
---------------------------------------------------------------------------------------------------------------------------------?---B--T---X--XXTXo?T?MX---B---------X------------T----------B---o-----
-------------B----------------------------------------------------------------------------------------------------B---X---o--------B-BXo|X-----?-|B--|X----X-----o-----------X-----|---B--B---X---------
-------------------------------------------------------------------------------------------------------------------------------------XX-|-X--T--B|X-o|----XX?????T----------XX---B-|-----????XX---------
-------X------------------B---------------------------------------------------------------------------------------------------------XXX-|----|---|--X|---XXX-----|---------XXX-----|X-------XXX-------X-
-------------------------------BT---B----------------B-----------------------------------------------------------------------------XXXX-|XB--|---|B-X|--XXXX--TX-|B-X-----XXXX-----|-------XXXX--------v
--------------------------------|------------------------------------------------------------------------------------------------XXXXTX-|----|-TX|---|MXXXXXT-|--|--B----XXXXX----T|------XXXXX--------f
--------------------------X-----|------------------------------------------------------------------------------------------------XXXX|X-|----|-|-|---|XXXXXX|-|--|------XXXXXX----||-----XXXXXX--------f
----------------------X------X--|----------------------------------------------------------------------------------------BB--X??XXXXX|XB|----|-|-|---|XXXXXX|-|--|-----XXXXXXX----||-B--XXXXXXX--------f
-----------------XX------------B|-------------------------B------XXXXXXXX------X-------------------------------------------????XXXXXX|X-|---T|-|-|--X|XXXXXX|-|--|----XXXXXXXX----||---XXXXXXXX-------Bf
--------------------------------|---X------------------------------------------------------------------------------------o-T--XXXXXXX|X-|--X||M|X|BXX|XXXXXX|B|BB|B--XXXXXXXXX----||X-XXXXXXXXX-----M--f
--------------------------------|----------------------------------------------------------------------X-------------------|-XXXXXXXX|X-|-XX||-|B|XXX|XXXXXX|-|--|--XXXXXXXXXX----||-XXXXXXXXXX--------f
m---------------------------E---|-------E--------------------E----------------------------------------MXX---X------------EB|XXXXXXXXX|X-|XXX||E|X|XXX|XXXXXX|E|--|-XXXXXXXXXXX----||XXXXXXXXXXX------X-X
XXXXXXXXXXXXXXXXXXXXXXXXX----XXX|XXXXXXXXXXXXXXXXXXXXXXXXXXXXXXXXXXXXXXXXXXXXXXXXXXXXXXXXXXXXXXXXXXXXXXXXXXXXXXXXXXXXX-XXXX|XXXXXXXXX|X-|XXX||-|X|XXX|XXXXXX|X|--|XXXXXXXXXXXXXXXX||XXXXXXXXXXX--------X
