---------------------------------------------------------------------------------------------------------------?-----------------------------------------------------------------------XXXXXXXX---------
---------------------------------------------------------------------------------------------------------------------o---------------------------------B-----------------------------------?----X-------
--------------------------------------------------------------------------------------------------------------------------------------------------------------------------------------------------------
--------------------------------------------------------------------------------------------------------------------------------------o------------------------------------------------------------?----
-------------------------------------------------------------------------------------------------------------------?----------------------X---------------------T---------------------------------------
---------------------------------------------------------------------------------------------------------B------------------------------------------------------|---------------------------B-----------
--------------------------------------------------------------------------------------------------------------------M-------------------------------------------|---------------------------------o-----
----T-----------------------------------------------------------------------------------------------------------------------------------------------------------|---------?--?-------------------------v
----|------------------------------------------------------------------------------------------------X----------------------------------------------------------|-----------------------------BB-------f
----|M---------------------------------------------------------------------------------------------------o-----------------------------X------------------------|--------------------------------------f
----|-----X-----------------------------------------------------------------------------------------------------------------------------------------------------|--------------------------------------f
----|----XX------------------------------------------------------------------------------------------------------------------B----------------------------------|-------------------------------T--M---f
----|X--XXX-----------------------------------------------------------------------------------------------------------------------------------------------------|-------------------o-----------|------f
----|XXXXXX-----------------------------------------------------------------------------------------------------------------------------------------------------|----B--------------------o-----|------f
m---|XXXXXX---------------------------------------------------------------------------------------------------------------E----E--------------------------------|------------------------------E|--E---X
XXXX|XXXXXXXXXXXXXXXXXXXXXXXXXXXXXXXXXXXXXXXXXXXXXXXXXXXXXXXXXXXXXXXXXXXXXXXXXXXXXXXXXXXXXXXXXXXXXXXXXXXXXXXXXXXXXXXXXXXXXXBXXXXXXXXXXXXXXXXXXX-------XXXXXXXXXX|XXXXXXXXXX------XXXXXXXXXXXXX--|---XXXX
