-----------B-------------------------------------------------------------------BBBB------------------X----X---B------------X---MX-X---X--XXB---B--------?????-----------------X----o-?-????BBBBBB-------
-----BX-----o----------B------------------------------------------------------------------------------?o---X-M-----B----X--M----X---------?---BX-M-------------------------BBBBBBB-----------X-------X--
--------X----X--X----------------------------------------------------------------------------X------B-----------------B--------------X-------X------?------X---X-X----?--------------B------------------
------------B-------------------------------------------------------------------------------------B-o--------------X----------XB-----?--X---------------------------------------------------------------
--------B-----X------------------------------------------------------B------------X-------------X---X-----T-------------X--B-BB-----B----Xo-------X--X-------?---X-----------------X--------------------
-----X-----------------------------------------------------------------B------------X--X---------B---T-T--|------------XX--B--B---XX-B----------X-------T----------X------------------------X-------XBB-
----B-BX---------X-B----------------------------------------------------------------T-XX--XT-X-----XX|X|XX|---BB---BBBXXX?----B-T---XT-X---B---?BB-X-B--|------------BBB--------------B-----XT--X???XXX-
--------X---------------------X------------------------------------o----------------|XXX---|--?------|-|--|--BX?---BXXXXX-------|---?|--B-X-T--XBBBBBBX-|------------?---------XXXXX-------BX|X--B-----v
-------------B---------------XX---------------------------------------------------X-|XXX-BB|-XXXXBX--|-|--|---------XXXXX-------|----|----X-|XXX--------|---X--B--------------B----------B--X|XXBBB----f
------T--------X------------XXX----------------------------------------XXXXX------BX|XXX---|B-----X--|-|--|--T---X-XXXXXXBB-----|----|X-----|XXX---X--T-|T--BB------------BB------X--XX--X--X|XXX------f
------|----o---------------XXXX-----------------------------------------------B---XX|XXX---|----X----|-|--|-B|----XXXXXXX--X-B--|---B|XB----|XXX---XX-|-||----------------------------------X|XXXXBBBBBf
------|-----------B-------XXXXX--------------------------------------------------XXX|XXX---|----X----|X|-X|??|??MXXXXXXXX--XX--X|----|XBBB-X|XXXX--XXX|X||--B-X-------------------X-----B---X|XXXXX----f
--T---|------------------XXXXXX-------------------------------------------------XXXX|XXX---|----XX---|X|-X|-B|--XXXXXXXXX--XXX--|---B|XX-XXX|TXXX-BXXX|X||XXX--XB----------------------B----X|XXXXXX---f
--|---|-X---------------XXXXXXX------------------------------------------------XXXXX|XXX---|----XXX-X|X|-X|XB|BTXXXXXXXXX--XXXXX|----|XXXXXX||XXXXXXXX|X||--XXXX-----XX--X---------------B--X|XXXXXXX--f
m-|-E-|----------------XXXXXXXX--------------------------------------------E-oXXXXXX|XXXE--|-B-XXXXXX|X|-X|XX|X|XXXXXXXXX-XXXXXX|---o|XXXXXX||XXXXXXXX|X||--XXXXEM---E----E---------E-E-----X|XXXXXXXXMX
XX|XX-|-XXX--B-X------XXXXXXXXXXXXXXXXXXXXXXXXXXXXXXXXXXXXXXXXXXXXXX---XXXXXXXXXXXXX|XXX---|BXBBXXXXX|X|-X|XX|X|XXXXXXXXXX-XXXXX|-X-B|XXXXXX||XXXXXXXX|X||XXXXXXXXXXXXXXXXXXXX--------B--BB-X|XXXXXXXXXX
