----------------------------------------------------------------------------------------------------------------------------X--X--X-----------------------M-B-----o-BB--M---------------B-B-X-----------
--------------------------------------------------------------------------X----------------------------B--------B-----------------X-----------X--X-----B?----B------------X-------------Xo-------BBBX---
-------------------------------------------------------------------------------------------------------B--------------------------------------B---------M---X--B--------B---------------B---------------
----------------------------------------------------------------------------------------------------------------X-----------------------------B------------XX-BBBB---B---B------------------?B??------X-
-X---------------------------------------------------------------------------------------------------------XB-------------------B--------------------------TBTBBB-o??????--T-X---------XBX--?-X---X-T-X-
-----------------------------------------------------------------------------------------------------------------B-------------B---MXX----------------o--B-|-|BoB--X-------|XX-------XXXXXXXXXXX--X-|-X-
------------------------------------------------------------------------------------------------------------------B-----------B-----------------------o--XX|X|-B-oB--------|XX-------XXX-B---XXB-TXX|XX-
---------------------------------------------------------------------------------------------------B-----------------------------------------------T------X|-|-BBBX----M--X|XX------XXXXX----XXXX|XX|XXv
------------------------------XXXX-----------------------------------------------------------------------------------------------------------------|--oT-BX|X|X-B--------XX|XX-----XXXTXXXM--XXXX|XX|XXf
------------------------------------------------------------------------------B------------------T----------------XXXX---------B-------------------|-MX|X-X|X|--X-------XXX|XX----XXXX|XXXX-XXXXX|XX|XXf
---X---------------------------------------------------------------?-----------------------------|-----------------------------?-------------------|-BB|XXX|X|X?-----XXXXXX|XXX--XXXXX|XXXXX-XXXX|XX|XXf
------------------------------------------------------------------------------------------------B|-----X---------B---------B------------------BBBBX|--X|XXT|X|XXT----XXXXXX|XX--XXXXXX|XXXXXXXXXX|XX|XXf
-------------------------------------------------------------------------------------------------|---------------------------X---B-----------------|--X|XX||X|XX|--X-XXXXXX|XX-XXXXXXX|XXXXXXXXXX|XX|XXf
-------------------------------------------------------B-----------------------------------------|-------------------------------------------------|--X|XX||X|XX|X--XXXXXXX|XXXXXXXXXX|TXTXXXXXXX|XX|XXf
m------------------------------------------------------------------------------E----------E------|----------------E-------E-----B-----XXXXXX-------|-BX|XX||X|XX|XXXXXXXXXX|XXXXXXXXXX||X|XXXXXXX|XX|XXX
XXXXXXXXXXXXXXXXXXXXXXXXXXXXXXXXXXXXXXXXXXXXXXXXXXXXXXXXXXXXXXXXXXXXXXXXXXXXXXXXXXXXXXXXXXXXXXXXX|XXXXXXXXXXXXXXXXXXX-XXXXXXXXXXXXX------XXXBXXXXXX|-XX|XX||X|XX|XXXXXXXXXX|XXXXXXXXXX||X|XXXXXXX|XX|XXX
