--------------------------------------------------XXXXXXX-----------------------------------------???????-----------------------------------------------------------------------------------------------
--------------------------------------------------------------------o--------------------------------XXXXXX----------------------------------------------------------------------BBBBBBB----------------
-----------------------------------------------------------------------------BBBB-----------------------------------------------------------------------------------------------------------------------
--------------------------------------------------------------------------------------------------------------------------------------------------------------------------------------------------X-----
-----------------BBBBBBBB-----------------------------------o-------------------------------------------------------------------------------------------------------------------------------------------
---------------------??????-----------------------------------------------------------------------------------------------------------------------------------------------------------------------------
--------------------------------------------------------------XXXXX-X------------------------------------------------------------------------------------------------o--------------------BB----?-------
-------------------------------------------------------------------------------------------------------------------------------------------------------------------------------------------------------v
-----------------------------------------------------------------------------------------------------------????????----------------------------------------------------BB---------?????---------------Xf
-------------------------------------------------------------------------------------------------------------------------------------------------o---------------------------------------------------XXf
------------------------------------------------------BBBBBB----------------------------------------------------------------------------------------------------------------------------------------XXXf
-----------------------------------------------------T---------------------------------------------------------------------------------------------X------------------o------------------------B---XXXXf
--------------------------------------------------BBB|X------T------------------------------------------------------------------------------------------------------------------------------------XXXXXf
-----------------------------------------------------|X------|-----------------------------------------------------------------------------------------------------------------------------------XXXXXXf
m--??-----------------------------------------------X|X------|--------------???????BBBB------------------------------------------------------------------------------?--------------------------XXXXXXXX
XXXXXXXXXXXXXXXXXXXXXXXXXXXXXXXXXXXXXXXXXXXXXXXXXXXXX|XXXXXXX|XXXXXXXXXXXXXXXXXXXXXXXXXXXXXXXXXXXXXXXXXXXXXXXXXXXXXXXXXXXXXXXXXXXXXXXXXXXXXXXXXXXXXXXXXXXXXXXXXXXXXXXXXXXXXXXXXXXXXXXXXXXXXXXXXXXXXXXXXX
