--BB----o----X--Bo------o-----X--------X--o-----------oB---o-----o---o-----B----B-------------o---B--------X-XT-o-B-B-B---oBo?--B---------B---o-------o--X-----B-oT------B------------o-----------B--Bo-
------o-o------o------------o-B-o---------------X--X---o----B-------X------B--o---o-------------o-o-----------|--B------B-----------o-o------B--o------X-o------oo|-------------o---o------------oX-o-BB
------o--X-Bo----T------o---------o-----o-o------X-B---?-B--o------------o-o---oo-o---B-o------B--B-E---------|------o-----o-oo--o----oB-o-------o-------o----X-o-|-------------T----X-----B-----Bo-E---
-------o-BB--o---|-----B-----B-----E-E-----B-------oB-----o----o----------------------------o-------B---X-----|---oo-----o--X-------Bo----o---o--------B-----Boo--|---B---------|--o----o---X-------B--B
----X-----X------|-------oB-o-----oX-B-----o-------o--oX--------X--------B-----BX-B----o------------------BB--|--X---o---E----X----------B-ooX----o-------B-----B-|-------------|---------------------o-
---X---B---------|---o-----------oB---X--------------o-o-B--B--E-o-----------X-------------------B--------B---|--B-------B-----X--X--------------o--B-?-Xo----B-B-|---o-----o---|------oo---------o---BB
B--X-----------B-|--o-----o------o------------B---------o-o--B-B--------------o--B-----------------B--------o-|----B-------XB------Bo-----o-------------E--B---X--|----o----E---|---oB-----o------------
--o------X---Bo-o|---------oB---oE------o-------B---------B--B-----o-----------B-----o------B---B--o------o---|--o--o-------o-B----o-?-----o--X----o----X---XB----|-oB-----oB-oB|----o-BB-Xo--B--------v
---B-B---o--o----|---T---o-X-----B--o-X-----------oB---o----E--o----X----o--o-X--------------o----------------|-B---o----o-------------Boo---oB-------------------|--B---------o|-------oBo---B---o----f
o-------B---B----|-B-|--E----T---------o---X-oo---o-B-X--o--X----o----BB----------X-----oB---Bo-----B---------|----------X--Boo-----------o-o-----X---oo----B-----|-o---Bo-oo-X-|---oB---------X-------f
--B----B---------|---|-oB----|-o-------B--BB--------------oXo-X---E---X----o------o--o---X---------X----------|------------oo-o---X-Bo-----------X------o-----oT--|-o---X-------|----B-----o-----B-o---f
---B---B-B------o|-o-|-o-----|-o----B--o---------------B----------B------o-----o-o---B--o-------o--------B----|-o----o----o-----X-BX-----B-------o--o-------o--|--|---B-Bo-----X|-oX--B--oo--BXX--o----f
---o-----------o-|-B-|-------|---o----------o---oB-o-----o--oo------o-----oX-----X---------------oooX---------|--oB----ooB-o--o-----o--oBX------o--------------|-B|-E-o---Eo----|-----B-----------B----f
-------o---------|---|-----B-|---------oo-o-?-------o-----B-o-------B---o----------B-oB---------BB---o--------|-----B--X-------o---B-o-o----------------B--o---|--|-BB----X-----|--------o---o--X-X-X-Xf
m-B------------E-|---|-------|------------o--o---------------------o---oE-------------B-------B-Eo----B------E|--B------E--BB-B------o-o-----o--B---o-----XXXo-|--|------o-X----|-------------B-----B-oX
XXXXXXXXXXXXXXXXXXXXXXXXXXXXXXXXXXXXXXXXXXXXXXXXXXXXXXXXXXXXXXXXXXXXXXXXXXXXXXXXXXXXXXXXXXXXXXXXXXXXXXXXXXXXXXXXXXXXXXXXXXXXXXXXXXXXXXXXXXXXXXXXXXXXXXXXXXXXXXXXXXXXXXXXXXXXXXXXXXXXXXXXXXXXXXXXXXXXXXXX
