-------------------------------------------------------------------------------------------------------------------------------------------B-----------------------X---------------------------o-B------
--------------------------------------------------------------------------------------------------------------------------------------------------------------------------------------------------------
------------------------------------------------------------------------------------------------------------------------------------------------------B-----------------------B------B----------BBBBBBB-
---------------------------------------------------------------------------------------------------------------------B-------------------------------------------------M-----------------------------B--
--------------------------------------------------------------------------------------------------------------------------------------------------------------------X-----------------------------------
------------------------------------------------------------------------------------------------------------------------------------------------------------------------------------B-------------------
-B----------------------------------------------------------------------------------------------------------------------------------------------------------X-------------------------------------------
-------------------------------------------------------------------------------------------------------------------------------------o---------------------------------B------------------------B------v
-----------------------------------------------------------------------------------------------------------------------B------------------------------------------------------------B------------------f
-B----------------------------------------------------------------------------------------------------------------------------------------------------------------------------------------------T------f
----------------------------------------------------------------------------------------------------------------------------B----------------------------------------------B----------X---B-----|------f
------------------------------------------------------------------------------------------------------------------------------------------------------------------------------------------------|------f
-------------------------------------------------------------------------------------------------------------------------------------------------o----------------------------------------------|------f
----------------------------------------------------------------------------------------------------------------------------B---------X-----------------------------------------------?---------|------f
m--------------------------------------------------------------------------------------------------------------------------E------------------------------------------------------------M---E---|------X
XXXXXXXXXXXXXXXXXXXXXXXXXXXXXXXXXXXXXXXXXXXXXXXXXXXXXXXXXXXXXXXXXXXXXXXXXXXXXXXXXXXXXXXXXXXXXXXXXXXXXXXXXXXXXXXXXXXXXXXXXXXXXX-------XXXXXXXXXXXX----XXXXXXXXXXXXXXXXXXXXXXXXXXXXXXXXXXXXXXXXXXX|XXXXXXX
