--------------------------------------------------------------------------------------------------------------------------------------------------------------------------------------------------------
--------------------------------------------------------------------------------------------------------------------------------------------------------------------------------------------------------
--------------------------------------------------------------------------------------------------------------------------------------------------------------------------------------------------------
--?-----------------------------------------------------------------------------------------------------------------------------------------------------------------------------------------------------
--------------------------------------------------------------------------------------------------------------------------------------------------------------------------------------------------------
-----------------------------------------------------------------------------------------------------------------X---------------???B-------------------------------------------------------------------
----------------------------------------------------------------------------------------------------------------XX--------------------------------------------------------------------------------------
---------------------------------------------------------------------------------------------------------------XXX-------------------------------------------------------------------------------------v
--------------------------------------------------------------------------------------------------------------XXXX-------------------------------------------------------------------------------------f
-------------------------------------------------------------------------------------------------------------XXXXX-------------------------------------------------------------------------------------f
------------------------------------------------------------------------------------------------------------XXXXXX-------------------------------------------------------------------------------------f
-----------------------------------------------------------------------------------------------------------XXXXXXX-------------------------------------------------------------------------------------f
------------------------------------------------X---------------------------------------------------------XXXXXXXX-------------------------------------------------------------------------------------f
------------------------------------------------XX-------------------------------------------------------XXXXXXXXX-------------------------?--------------T--------------------------------------------f
m----------------------------o------------------XXX-----------------------------------------------------XXXXXXXXXX----------------------------------------|-----BBBBBBBB---------------------------EE--X
XXXXXXXXXXXXXXXXXXXXXXXXXXXXXXXXXXXXXXXXXXXXXXXXXXXXXXXXXXXXXXXXXXXXXXXXXXXXXXXXXXXXXXXXXXXXXXXXXXXXXXXXXXXXXXXXXXXXXXXXXXXXXXXXXXXXXXXXXXXXXXXXXXXXXXXXXX|XXXXXXXXXXXXXXXXXXXXXXXXXXXXXXXXXXXXXXXXXXXXX
