--------------------------------------------------------------------------------------------------------------------------------------------------X---X------------------------------------B------------
------------------X--------------------------------------------------------------------------------------------------------------------------------------------------o----------------------------------
--------------------------------------------------------------------------------------------------------------------------------------------------------------------------------------------?-----------
-----------------------------------------------------------------------------------------------------------------------------------------------------------------------------------------------BB-------
----------------------------------------------------------------------------------------------------------------------------------------------------B-o-------------------------X-B-------------B---X---
-----------------------X-----------------------------------------------------------------------------------------------------M-----------------------------------------o----------------XB---------XX---
------------------X-----------------------------------------------------------------------------------------------------------------------------------o--X------M----T-------X-B----B-------------XXX-B-
---------------------------------------------------------------------------------------------------------------------------------------------------------XX----------|---T---X---X----XXXXoXXXXXXXXXX--v
-----------------------------------------------------------------------------------------------------------------------------B---------------------------XXX---------|---|??XX---XX---B---X-----XXTXXXXf
---------------------------------------------------------------------------------------------------------------------------------------------?-----------XXXX------B-|---|-XXX---XXX---?-XX---BXXX|XXXXf
-----------------------------------------------------------------------------------------------------------------------------------BX----------------B---XXXXX-------|---|XXXX---XXXX---XXX---XXXX|XXXXf
-------------------------------------------------------------------------------------------------------------------------------X-------------------------XXXXXX------|---|XXXX-X-XXXXXBXXXXX-XXXXX|XXXXf
----------------------------------------------------------------------------------------------------------------------------------------------------B----XXXXXXX-----|--X|XXXX---XXXXXXXXXX-XXXXXX|XXXXf
---------------------------------------------------------------------------------------------------------------------------o------------------------M----XXXXXXXX----|-XX|XXXX---XXXXXXXXXXXXXXXXX|XXXXf
mM---B--------E----B--------------------------------------------------------------------------------------------------------------X------E-X-E----E------XXXXXXXXX---|XXX|XXXXXBXXXXXXXXXXXXXXXXXX|XXXXX
XXX------XXXXXXXXXXXXXXXXXXXXXXXXXXXXXXXXXXXXXXXXXXXXXXXXXXXXXXXXXXXXXXXXXXXXXXXXXXXXXXXXXXXXXXXXXXXXXXXXXXXXXXXXXXXXXXXXXXXXXXXXXXXXXXXXXXXX----XXX-----XXXXXXXXXXXX|XXX|XXXX--XXXXXXXXXXXXXXXXXX|XXXXX
