------------------------------------------------------------------------------------------------------B--------------------------------------o----------?--------------X--------------------------------
---------------------------------------------------------------------------------B--------------------X---------------B---------------------------------------------------------------------------------
------------------------------------------------------------------------------------------------------------------------------------------X-----????----------------------------------------------------
--X-------------------------------------------------------------------------------------------------------------------------T---------------------------------------------------------------------------
-------------------------------------------------------------------------------------------------------------o--------------|--------------B-T------o---------------------------------------------------
-----------------------------------------------------------------------------------------------------B----------------------|---------------B|o----------------------------------------X----------------
-----------------------------------------------------------------------------------------------------------X----M-----------|-------B------B-|--B--------------------------------------X----------------
---------------------------------------------------------------------------------------------------------------------------X|----------------|--------------o------------X-----------------------------v
--------------------------------------------------------------------------------------------------------------------------XX|XBB-------------|---------------------B-----------------------------------f
-----------------------------------------------------------------------------------------------------T---------------T--o-X-|X---------------|-BBBBBBB-------------------------------------------------f
-----------------------------------------------------------------------------------------------------|---------------|------|-----B-----B----|-------XX------------------------------------------------f
--------------------------------------------------------------------------------------------------T--|---------------|--X---|-------------X--|-------XX------------------X-----------------------------f
-----------------------------------------------------------------------------------------T--------|--|---------------|--XX--|----------X-----|------XXX--?????-----------------------------------------f
--B--------------------------------------------------------------------------------------|--------|--|-----?---------|--XXXo|----------XX----|-----XXXX------------------------------------------------f
m----------------------------------------------------------------------------------------|--------|--|---------B-----|BBXXXX|--E-------XXXE--|---EXXXXX---EE-------------------------------------------X
XXXXXXXXXXXXXXXXXXXXXXXXXXXXXXXXXXXXXXXXXXXXXXXXXXXXXXXXXXXXXXXXXXXXXXXXXXXXXXXXXXXXXXXBB|BBBBB--X|XX|XXXoXXXXXXXXXXX|XXXXXX|XXXXBXXXXXXXXXXX|XXXXXXXXXXX-------XXXXXXXXXXXXXXXXXXXXXX-----XXXXXXXXXXXXX
