---------------------------------------------------------------------------------------------------------------------------------------------------------------------------------------?????------------
--------------------------------------------------------------------------------------------------------------------------------------------------------------------------------------------------------
----------------------------------------------------------------------------------------------------------------------------------------------------------------------------------------XXXBB-----------
---------------------------BBBB-------------------------------------------------------------------------------------------------------------------------------------------------------------------------
--------------------------------------------------------------------------------------------------------------------------------------------------------------------------------------------------------
-------------------?????-------------------------------------------------------------------------------------------------------------------------------------------------------X------------------------
--------------------------------------------------------------------------------------------------------------------------------------------------------------------------------------------------------
--------------------------X----------------------------------------------------------------------------------------------------------------------------------------------------------------------------v
---------------------------------------------------------------------------------------------------------------------------------------------------------------------------------XXXXXXX--------------?f
-------------------------------------------------------------------------------------------------------------------------------------------------------------------------------------------------------f
----------------------------X---??????-----------------------------------------------------------------------------------------------------------------------------------------------------------------f
---------------------------XX--------------------------------------------------------------------------------------------------------------------------------------------------------------------------f
--------------------------XXX--------------------------------------------------------------------------------------------------------------------------------------------------------------------------f
-------------------------XXXX--------------------------------------------------------------------------------------------------------------------------------------------------------------------------f
m-----------------------XXXXX--------------------------------------------------------------------------------------------------------------------------------------------------------------XXXXXXX----XX
XXXXXXXXXXXXXXXXXXXXXXXXXXXXXXXXXXXXXXXXXXXXXXXXXXXXXXXXXXXXXXXXXXXXXXXXXXXXXXXXXXXXXXXXXXXXXXXXXXXXXXXXXXXXXXXXXXXXXXXXXXXXXXXXXXXXXXXXXXXXXXXXXXXXXXXXXXXXXXXXXXXXXXXXXXXXXXXXXXXXXXXXXXXXXXXXXXXXXXXX
