B------B----B-B----------------o-oX----oB-----oo--X-----------oo-----X------o---------o----------------oB-oB------------X------BB---B----oB----o------------B-o-o-----oB-------BB-o----o--Bo-----------o
--------B--------------oB--X-o--o----X---B--------------------B-X--------------o--------o---o-B-Xo---------------BT---B-----------X-o------Bo--B----o----B---------B-----B---o-o-----o----------------o-
-o---o----o-o---B------B--o-----oX-o---oB-----EX----B-Xo--------B---o--------X-B-X-X-------o-------------o-X------|-----o-X-------------?B-o-B----Eo--------B-----B-----E-----E-oXB-------------------o-
-----------B-B-o--o---------B-B-X-------------B--------------B------E---BB-o---oo----B--o-----oB--ooX-----o-B--o--|-----X------B-------B-o----o---B-B-o--------------X--B----oBo--o--B---Bo-B-B---------
----o-B-X--X-o-----X-----------o-oBo---o----------------o-----------X--o-XB---------E-o-B----o-Xo------o-o-o------|-----------o-------o----------------------o-XB--ooo---o-----X-X--------X-oB-B-oBo---o
-X---X---------------o---X---o----Xoo----------------------BB-------------X--o------B-o-X------B-X--B------B------|--oo--o-XX-B--------o----o----------B-----B----------o-------o-------X------------o--
------o-B--------------B-B--o----------X--o---oB-----XB-------------o--o---o---------B----------Bo---o----X--o----|---o--B------------o----------------Bo---?-------o----oB-----o-X-----X-o--X---B-o----
-------------oo---B-----B---B---X---------X----------------B----------o--------o--Boo--------------o----oo----o--o|---Bo----X----B-B-o---B---B-------------------------------B------B-----------o----Bov
o-E-------oB-----oB-BB----------o-----------------o-o----X----X-B---B-----------B-o-o-----X--B--------o-o--------B|--o--Boo--o-o-----------o-o---------X---------Bo---o--o----o------B--X-o-------Bo-X-f
--B-o-oB----X---------------o--o-X--------------o----------Xo------------B-B-o--------------------------X---------|-B------------o--------o-------o------B---------X---------------o--------------o----f
--------o----o-T----oB-B----Bo---------B----------Bo--B----o----o-------o-o----------oo------------o--B--o----o-o-|-o--o----------X----B-oB-----o------B----o----o---------BE-X--B-B-XB-o-------B------f
------o--------|-X---------Xo---oo--------o-o---B-------B------o------------------B------o---B-----T-E---X------X-|-----o-------------XoB---?-o--o---X---o----o---Bo--------B----------o--------oE-----f
BB---o------X--|----B------------B----B-o-oo---X-o------BEX----------EB--B-----Bo------------X--B--|-B---B-B---o--|----X-o----o---------------?-o-----B------------------E---X-oo----------X-----B----of
--B-o-o--------|--------------------E------o-------------X-XoX--o----B-o-Bo--o----BB---B----o-X--oX|--B----oo-----|-------------B------B----o----------------oX--------o-B-----o-------B----oB-------oof
m-oo------o-BE-|--------X------Eo-X-B--T------------E---BB--o--oBXo----B------o------E--o-o-X------|-o-o-o-X-o----|---E----B--X--------o----------oB---------X--o--o--o-E-Xo--o-o-----E---B--E--o--oE--X
XXXXXXXXXXXXXXXXXXXXXXXXXXXXXXXXXXXXXXXXXXXXXXXXXXXXXXXXXXXXXXXXXXXXXXXXXXXXXXXXXXXXXXXXXXXXXXXXXXXXXXXXXXXXXXXXXXXXXXXXXXXXXXXXXXXXXXXXXXXXXXXXXXXXXXXXXXXXXXXXXXXXXXXXXXXXXXXXXXXXXXXXXXXXXXXXXXXXXXXX
