-------------------------------------------------------------------------------------------------------------------------------------------------B-----------------------------?-------B----------------
----------------------------------------------------------------------------------------------------------------------------------------X---------------------------???---------------------------------
-------------------------------------------------------------------------------------------------------------------------------XB-o-----------?????----X------------------------------------------------
-----------------------------------------------------------------------------------------------------------------------------------------XX????T??M--------------------------o------------o-------------
------------------------------------------------------------------------------------------------------------------X---------------o------------|--B----B-----------------------????????--------------X--
-M---------------------------------------------------------------------------------------------------------------------------------------------|-?--------------------------?BBBBB-B----------------XX--
-------------------------------------------------------------------------------------------------------------------------------------B-------o-|M----T-T-------------------B-----------------------XXXX-
-------------------------------------------------------------------------------------------------------------------------------------o-??X?????|-----|-|-------M--???????-------------------------XXXX-v
---------------------------------------------------------------------------------------------------------------------------B------MB-----XX-B-X|--X--|X|-B--------------------------------B------XXXXX-f
------------------------------------------------------------------------------------------------------------------------------------X-B--XXX--X|o----|X|-B---X--------------------o-------------XXXXXX-f
-----------------------------------------------------------------------------------------------------------------------------------------XXXX-X|X----|X|X----XX--------BB----------------------XXXXXXX-f
------------------------------------------------------------------------------------------------------------------------------------?-B--XXXXXX|XX-o-|X|XX---XXX------X-----------------------XXXXXXXX-f
--------------------------------------------------------------------------------------------------------------------------X--------------XXXXXX|XXX--|X|XXXX-XXXX----XX----------------------XXXXXXXXX-f
-----------------------------------------------------------------------------------------------------------------------------------------XXXXXX|XXXX-|X|XXXX-XXXXX--XXX---------------------XXXXXXXXXX-f
m-------------------------------------------------------------------------------------------------------------------------------X--EE----XXXXXX|XXXXX|X|XXXXXXXXXXXXXXX----E---X---------EXXXXXXXXXXXX-X
XXXXXXXXXXXXXXXXXXXXXXXXXXXXXXXXXXXXXXXXXXXXXXXXXXXXXXXXXXXXXXXXXXXXXXXXXXXXXXXXXXXXXXXXXXXXXXXXXXXXXXXXXXXXXXXXXXXXXXXXXXXXXXXXXXXX-o---XXXXXX|XXXXX|X|XXXXXXXXXXXXXXXX-------XX------XXXXXXXXXXXXXXXXX
