--------------------------------------------------------------------------------------------------------------------------------------------------------------------------------------------------------
--------------------------------------------------------------------------------------------------------------------------------------------------------------------------------------------------------
--------------------------------------------------------------------------------------------------------------------------------------------------------------------------------------------------------
--------------------------------------------------------------------------------------------------------------------------------------------------------------------------------------------------------
--------------------------------------------------------------------------------------------------------------------------------------------------------------------------------------------------------
--------------------------------------------------------------------------------------------------------------------------------------------------------------------------------------------------------
---------------------------------------------------------------------------------------------------------------------------------------------------------o----------------------------------------------
-------------------------------------------------------------------------------------------------------------------------------------------------------------------------------------------------------v
---------------------------------------------------------------------------XXXXXXXX----------X----------------------------------o----------------------------------------------------------------------f
--------------------------------------------------------------------------------------------XX------------------------------------------------------------------X--------------------------------------f
-------------------------------------------------------------------------------------------XXX-----------------------------------------------------------------XX--------------------------------------f
------------------------------------------------------------------------------------------XXXX----------------------------------------------------------------XXX--------------------------------------f
-----------------------------------------------------------------------------------------XXXXX---------------------------------------------------------------XXXX--------------------------------------f
----------------------------------------------------------------------------------------XXXXXX--------------------------------------------------------------XXXXX--------------------------------------f
m-------------------------------------------------------------E--------E---------------XXXXXXX-------------------------------------------------------------XXXXXX------------E---------------------E---X
XXXXXXXXXXXXXXXXXXXXXXXXXXXXXXXXXXXXXXXXXXXXXXXXXXXXXXXXXXXXXXXXXXXXXXXXXXXXXXXXXXXXXXXXXXXXXX-XXXXXXXXXXXXXXXXXXXXXXXXXXXXXXXXXXXXXXXXXXXXXXX-XXXXXXXXXXXXXXXXXXXXXXX--XXXXXXXXXXXXXXXXXXXXXXXXXXXXXXXX
