------------------------------------------------------------------------------------------------------------------------------------------------------XXXXXX--------------------------------------------
---------------------------------------------------------------------------------------------------------------------------------------------------------------------------B----------?XX??-------------
------------------------------------------------------------------------------o---------------------------------------------------B-----------------BBBBBB-------------BBBBBB---------------------------
---------------------------????------------------------?????-----------------------------------------------------------------?--XXXXXX------------------------------------------------------------------
------------------B--------------X-----------------------------------------------------------------------------------------------------XXXXXX-------B-------------------------------------X-------------
-------------------------------------------------------------------------BBBBB-----------------------------B-----------BBBBBBB------------?????--??B???--XX---XX-------XXXX-----------------------------
----------------------------------------------------------------------------------------------------------------------------------------------------B---------------------------------------------B--??-
-----------------------------------------------X--------B---------------------------------------------------------------------------------------------XXXX---------------------------------------------v
---------------------------------------------------------------------XXX----------------------------------------------------------X----------------------------------------???-------??------BBBBB--B--f
----BBBBB-----------X---------------------------------------------------------------------------------------------------------------------------------------o------------------------XXXXXXXX----------f
-------------BBB-----------------------------------------------------------------------------------------------------?--------------------------------------------------------------BBBB---------------f
----------------------------o-------------------------T-------------------X---------------------------------------------------------------------------------------X--------------BBBBBBBBBBB-----------f
----------B????------------------BMB------------------|-----------------------------------------------------------------------???????-------------------o----T--BXXBB??B????---------------------------f
-------????????---------------------------------------|------------------------------------------------------------------------------------------------------|--XTX-----------------------T------------f
m-----???????-----------------------------------------|--------???---------------------------------X--------------------E---------???E??--------------B------|BXX|X-----------------------|------------X
XXXXXXXXXXXXXXXXXXXXXXXXXXXXXXXXXXXXXXXXXXXXXXXXXXXXXX|XXXXXXXXXXXXXXXXXXXXXXXXXXXXXXXXXXXXXXXXXXXXXXXXXXXXXXXXXXXXXXXXXXXXXXXXXXXXXXXXXXXXXXXXXXXXXXXXXXXXXX|XXX|XXXXXXXXXXXXXXXXXXXXXXXX|XXXXXXXXXXXoX
