---------------------X------------------B--------------------o--o------------------------o------------B---------B----------------B------------------B--------------------B--------X---------o-------o---
------------------------X----o------------------B----B-o-------o------------o--B-o--o---o---X---o---------X-----------X--B----------B-----B------o-------------------o---------o----oB---------B--------
-------B--------o----B--------o--------o------B?----------------o----------oB------------------------------B--X-----o------X-------X----B-----------B---o---X----o------------------o---o--B-Bo---------
----B-----------------o----X---------------B---X-----B-------------B----o---X-------B---B-----X-----o------X----oB---X-----------------Xo---------o--E--------o---o----o---X---X-----------B------oX-o--
---B-o------ooB-Bo----Xo--------o----B----X-B---------X-----o-------o-----------------------oM---B------B-----o--o------------X-B---Bo--Xo-B------------X------oB-B-------------------B----------oB--o--
---B----o-------o-X------o--BB------Xo-------------------------------?---------o--------------------B------B---------------X----B--o--B-----------------------B----o-o--B------o-Bo--o------------------
-------------B-Bo------oo----X----------------------B------------B-----B--o-----------B----o---o--------Xo--------o---o----o----o---------oo--------------oB--------------o-------------B--oB---B------o
---------B--BB---o--o----o--E-o--B--------B-o--XX-----XB-B--o------------o-----o------BX----Xo---o------o------E-----------o-------X---------E---oo---------------------B------o-----X-------------X---v
-o--B-B---o-----?---------o-B------X--o----o---------oB--------------o---X--------------o-----------------------oo-X----BooB----X--o-------o--B----------------o-----B-------o-----------------B---BX-Xf
---------------o--X---o--------o--Eo--B-o--o-o----------oX--o-o-----------------X---------------------B----------B---BBo---o----Xo--------------o--o-------oX-E-X--B---------o-----------o-----oo-X---of
--o---o-o-oo-Xo--X--X--B--o--------o-o------------X---o---B---------B---oB--o---B-------oo----o-o--B-ooBo-o-o-----------------o-----o--o---------E--B---------o------o---o--o--------X----------o------f
-X----------------X----X-o--B-B---o---------B------o----B---o--oo-----o--------------B-------B-----------o--B--X--Bo----X------B-X-----o-o-----B---Xo-------o-o-o-------B---------B------o----------o--f
--------EB-------o---X---X----------E--B--------------------------o-------o--X---X----E-------B-----------------------o-------o-o--oX--o-X--o-o-o-------o--o-----o---B-----B-o--o---o---o---o---BB---XBf
-----B----------------B----X-Bo---------B---X--------------E----------o-o---o-----Bo------X-------o-X--B-------o--o---o----B---o----o---X----------o----B--o--o-o---Bo---o-----E---E----------oX-------f
mB-B-B----------o----B---o----B--------oo---B------ooo--X--o------Bo----X-B-------------EBE------oX-------o--B--o--B------B--------B----o-o--------oo---B----X------BB--oo---o-o-----B--B-BoX---o-oo--X-
XXXXXXXXXXXXXXXXXXXXXXXXXXXXXXXXXXXXXXXXXXXXXXXXXXXXXXXXXXXXXXXXXXXXXXXXXXXXXXXXXXXXXXXXXXXXXXXXXXXXXXXXXXXXXXXXXXXXXXXXXXXXXXXXXXXXXXXXXXXXXXXXXXXXXXXXXXXXXXXXXXXXXXXXXXXXXXXXXXXXXXXXXXXXXXXXXXXXXXXX
