----------------------------------------------------------------------------------------------------------B----------B--------BBBB-----------X----------oXX---------------------------------------------
--------------------------------------------------------------------------------------------o---------B-M-----BBBBB---Bo-B---X-B-------B-X-B-B-----o---B-X-----------------------------------------o----
----------------------------------------------------------------------------------------------X--------X---?B--?--------Xo---X--B---X-----B-----------------B-------------------------------------------
-------------------------------------------------------------------------------------------T--B------------------X----T----M-----oB-----------------------BBBBBBBB----------------?-------BBBBXBXBX--B--
----------------------------------------------X------------------M-------------------------|------------XXXXXXXXX-----|----XX--X--X---------------------T-------------X-----------------------T---------
----------------------------B-------------------------------------------B-M----------------|---B--XX------XX------B-TB|X--X----B-----T-BBBBXB-------o---|T-----------XX----------X-----?------|-B---T---
-------------------------------------------------------------X------------X---------B------|----------oB-XXX------BX|M|--B---TTXB---X|----XX------------||----------XXX----------XX----X----M-|-----|---
--------------------------------------------------------------------------T--------------T-|-----B--B-T-XXXX---BB-X-|B|-BB---||-----X|---TXXXX--------B-||-X-------XXXX----------XXX----------|--???|??v
----------------------------------------------------------B------------B--|-B------------|B|-X--?----X|XXXXX-----XXX|?|-BB---||----BX|X-X|XX----------T-||-XX-----XXXXX----------XXXX---------|-----|--f
--------------------------------------------------------------------------|--------------|-|----------|XXXXXBXB---XX|-|oT-X-T||-BX--X|XXX|XX----------|-||-XXX---XXXXXX------X---XXXXX--------|-X?--|--f
--------------------------------------------------------------------------|--o-----------|-|------TX-X|XXXTXXXX-B-XX|X|-|B--|||--XXXX|XXX|XX----------|-||TTXXX-XXXXXXX----------XXXXXX-X-----|-----|--f
---------------------------------------------------------------------?----|--B----X------|-|------|-XX|XXT|XXXXXo-XX|X|-|-M-|||--XXXX|XXX|XX----------|-||||XXXXXXXXXXX----------XXXXXXX-X-B--|-B-XB|--f
--------------------------------------------------------------------------|---???XXX-----|-|--B-??|XXX|XX||XXXXTX-XX|X|X|--?|||--XXXX|XXX|XXXXX-------|-||||XXXXXXXXXXX----------XXXXXXXX--B--|-----|--f
---------------------------------------------------------------------X----|-------XXX----|X|--B---|XXX|XX||XXXX|TXXX|X|X|---|||-TXTXX|XXX|XX---------X|X||||XXXXXXXXXXX----------XXXXXXXXX----|---X-|--f
m---------------------------------------------------------E---------XX----|--EE---XXXX-E-|X|---E-X|XXX|XX||XXXX||XXX|X|X|XBB|||-|X|XX|XXX|XXX-------XX|X||||XXXXXXXXXXX----------XXXXXXXXXX-E-|---EE|--X
XXXXXXXXXXXXXXXXXXXXXXXXXXXXXXXXXXXXXXXXXXXXXXXX----XXXXXXXXXX-----XXX----|--XXXXXXXXXXXX|X|XXX-XX|XXX|XX||XXXX||XXX|X|X|XX?|||-|X|XX|XXX|XXXXXXXXXXXX|X||||XXXXXXXXXXXXXXXXXXXXXXXXXXXXXXXXXX|-----|XXX
