--------------------------------------------------------------------------------------------------------------------------------------------------------------------------XXXXXXXX----------------------
--??--------------------------XXXXo------------o------------------------------------------------------------------------------------------------------------XXXX----------------------------------------
--------------------------------------------------------------------------------------------------------------------------------------------------------------------------------------------------------
------------------------------------------XXX??---------------------------------------------------------------------------------------------------------------------------------------------------BBBBB-
-----------------------------------------------------BBBB???B------------------------------------------------------------------------------XXXX---------------------------------------------------------
---------------------------------?-----------------XXXXX-------------------------------------------------------------------------------------------------------------BBB--------------------------------
-------------------------------------------??-----------------------------------------------------------------------------------------------------------------------------------------------------------
----------------------------------o-----------------------------------------------------------------------------------------------------------------------X--------------------------------------------v
-------------------------------------------------------------------------------------------------------------------------------------------------------------------------------------------------------f
-------------------------------------------------------------------------------------------------------------------------------------------------------------------------------------------------------f
-------------------------------------------------------------------------------------------------------------------------------------------------------------------------------------------------------f
------------------------------------------------------X-----T--------------------------------------------------------------------------------------BBBBB---------------------X---------------X--T-----of
------------------------------X----------------------XX-----|----------------------------------------------------------------------------------------------------------------XX-------------XX--|------f
----------------------------------------------------XXXX----|-------------------------------------------------------------------------------------------------T--------------XXX----------oXXX--|------f
m--------------------------------EE----------------XXXXX----|---------------E--------------------------------------------------------------------------E------|--------------XXXX---------XXXX--|------X
XXXXXXXXXXXXXXXXXXXXXXXXXXXXXXXXXXXoXXXXXXXXXXXXXXXXXXXXXXXX|XXXXXXXXXXXXXXXXXXXXXXXXXXXXXXXXXXXXXXXXXXXXXXXXXXXXXXXXXXXXXXXXXXXXXXXXXXXXXXXXXXXXXXXXXXXXXXXXX|XXXXXXXXXXXXXXXXXXXXXXXXXXXXXXXXX|-XoXXXX
