-------------------------------------------------------------------------------BBBBM---------Mo----o------M----XoXXXXo---?--o-o--------B---o------------------------------------------------------------
-------------------------------------------------------------------------o-----------o---------------?-------XXX----oBBBBBB-----------------------------------------------------------------------------
--------------------------------------------------------------------?------------????M?----------o?????-?XoBBBBB---???M-------o-----M-------------------------------------------------------X-----------
-------------------------------------------------------------------------T-------T----B------T-B--B------T--?--T--TBBBBo-TT?TT????--????????------------------------------------------------------------
----------------------------------------------------------------?--------|-------|---o???????|-T-XoTo--TT|-B---|-T|oX?B?X||X||---------------X----------------------------------------------------------
-------------------------------------------------------------------------|-------|o-MBXBTXBBB|M|M--|XX?|||TT---|?||XX-XXX||-||------T-------XX----------------------------------------------------------
--------------------------------------------------------------------T----|------X|BX-TXX|-T--|-|o-T|XXX|||||X-X|-||XXXXXX||?||---X--|---o--XXX----------------------------------------------------------
--------------------------------------------------------------T-?---|----|-T----X|XX-|XX|B|--|T|-X||XXT|||||XX-|X||XXXXXX||X||--XX--|-----XXXX---------------B-----------------------------------------v
-------------------------------------------------------------X|-----|--X-|-|XT--X|XX-|XX|X|--|||XX||TX||||||XXX|X||XXXXXX||X||BXXXXX|BB--XXXXX------------------------------------------------------X--f
-------------------------------------------------------------X|-----|-XX-|-|X|--X|XXX|XX|X|-X|||XX|||X||||||XXX|X||XXTXXX||X||XXXXXX|---XXXXXX-----------------------------------------------------XX--f
---???--------------------------X---------------------------XX|-----|XXX-|-|X|XXT|XTX|XX|X|XX|||TX|||X||||||TXX|X||XX|XXX||X||XXXXXX|--XXXXXXX----------------------------------------------------XXX--f
-----T----------------------------------T------------------XXX|-----|XXX-|-|X|XX||X|X|XX|X|XX||||T|||X|||||||XX|X||XX|XXX||T||TXXXXX|-XXXXXXXX---------------------------------------------------XXXX--f
-----|----------------------------------|--------------T--XXXX|----X|XXX-|-|X|XX||X|X|XX|X|XX||||||||X|||||||XT|X||XX|XXX||||||XXXXX|XXXXXXXXX--------------------------------------------------XXXXX--f
-----|----------------------------------|--------------|-XXTXX|---XX|XXX-|-|X|XX||X|X|TX|X|XX||||||||X|||||||X||X||XX|XXX||||||XXXXX|XXXXXXXXX-------------------BBBBBBBB----------------------XXXXXX--f
m---E|----------------------------------|--------------|XXX|XX|--XXX|XXX-|-|X|XX||X|X||X|X|XX||||||||X|||||||X||X||XX|XXX||||||XXXXX|XXXXXXXXXBBB---------------------E-----------------------XXXXXXX--X
XXXXX|XXXXXXXXXXXXXXXXXXXXXXXXXXXXXXXXXX|XXXXXXXXXXXXXX|XXX|XX|XXXXX|XXXX|X|X|XX||X|X||X|X|XX||||||||X|||||||X||X||XX|XXX||||||XXXXX|XXXXXXXXX-XXXXXXXXXXXXXXXXXXXXXXXXXXXXXXXXXXXXXXXXXXXXXXXXXXXXXXXXX
