-----------------------------------------------------------------------------------------------???------------------------------------------------------------------------------------------------------
---------???????---------???--------------------------------------------------------------------------------------------------------------------------------------------------XXX-----------------------
------------------------------------------------------------------------------------------------------------------------------------------BBB?----------------------------------------------------------
---------------------------------------------------------------------------------------------------------------------------------------------------------------o----------------------------------BBB---
----------------------------------????-------------------------------------------------------o---??----------------------------------------------------------------------------------------XXXX---------
-----------------------------------------------------------------------------------------------------B--------------------------------------------------------------------------------------------------
-------XXXXX---------------????-----------?---------???????-----------------------------------------------------------------------------XXXX------------------------------------------------------------
-------------------------------------------------------------------------------------------------------------------------------------------------------------------------------------------------------v
-X-----------------------------------------------------------------------------------------------------------------------------------------------------------------------------------------------------f
---------??XXXXXXX-?------X---------------------------------------------------------------------------------------------------------------------------------------------------------?--??????BBBBB-----f
--------------B----------XX---------------------------------------------------------------------------------------------------------------------------------------------------------------------o------f
------------------------XXX-----------------------------------------------------------------------------------------------------------------------T--------------------------???????-------------------f
---------?-------????--XXXXBBBBB------------------------------------------------------------------------------------------------------------------|----------------------------------------------------f
--------------------XXXXXXX-----------------------------------------------------------------------------------------------------------------------|-----------------------------------T----------------f
m--------------------XXXXXX----X-------------------------------------------------------------------o----------------------------------------------|-----------------------------------|BBBBBEB---------X
XXXXXXXXXXXXXXXXXXXXXXXXXXXXXXXXXXXXXXXXXXXXXXXXXXXXXXXXXXXXXXXXXXXXXXXXXXXXXXXXXXXXXXXXXXXXXXXXXXXXXXXXXXXXXXXXXXXXXXXXXXXXXXXXXXXXXXXXXXXXXXXXXX|XXXXXXXXXXXXXXXXXXXXXXXXXXXXXXXXXXX|XXXXXXXXXXXXXXXXX
