--------------------o---oo------------------------o------------------------------------------------------B--B--------B---X-----------X---------------------------------------------------B---B----------
-----o------------------B--------B--B-------------o-----o----------------B-----------------------o--o-----X--o----------o--X----------o----X--------------B--------------BB-----o--B--------------------
-------B--BX---B--o--------o---o-B---------------------oB--B-----B-------o--------X-------E-----------------B---o--o-----o--B-o-B-------o--------------o-------o----------------------------B---B---o---
--o--------o---------o-------X--B------------------o--BBB---B-o--------oo----------------X----E-o-----------o---o----------B------------E-------B-B-----oo----------o--X-------B----o-------------B-----
--------------------------o-------------?-------o-------------------------B-----oo--o-B--------------------B-----------oo-o-------o----o---o----o-X---B--------------------------------------oB------o--
--------------------------o-----------------------X--o-o------BX-o----------------------------------B-o-----------------X---o-------B----o------X-----B-----X-----------B------------------o-o---------B
-B-X-----X----B-----X------------------o---------------------o----o-----o--B-----------------o----------------------------------B---o---------------o----------o------o------o----XE-----o-----X--------
--oo------------------?----B-----------oX-----------oo--B-o------------------------------B-----B-------------------------o----------------------o---------------------o--B---o-Xo--o----X---o-------o--v
-----------B---------o---B---------X--o-----------oB--------------------o----------------------B---o-o--B----------------------------o----------B--o-------oB---B-------B---o--X---------------o-o----of
--------------------------o------------o---------X-oo-o------------------------XX----B--------Bo--------------o-------o-o-------------------?--------------o--o----oB-------------------------------o-of
-----B----------o------o--o-o-oB-------X------------------o---------o----o--------o-B-----------X--------------------o-o----------B---o-----------o-----o----------X--o---------------o--------B---o--Xf
--o-----B-B-------------o--------------------------X----o-----o---------o----------------------------------------oo-oo-------------------------------------o--------------------B--------B---------o---f
-----------------------X---o--X-B--------------------------o--X-B---------------------X--B-------------o-o---X------------------B--B------X------------o-o---------o-----------o-o------------------o--f
----B-----B--oBE-X--o--------X----o----------o-o--------------o------------B---------B------------oo-----------------B-------X-----------------X--X-----o-----o--XB---------Xo---------X---o--X------X-f
m-----X-----------o-------o----B-------o-o-Xo---B--o----o----------Xo----X---o------------X-o----o------------o----o--------B-------B--------------------------------------B----Xo--------------------oX
XXXXXXXXXXXXXXXXXXXXXXXXXXXXXXXXXXXXXXXXXXXXXXXXXXXXXXXXXXXXXXXXXXXXXXXXXXXXXXXXXXXXXXXXXXXXXXXXXXXXXXXXXXXXXXXXXXXXXXXXXXXXXXXXXXXXXXXXXXXXXXXXXXXXXXXXXXXXXXXXXXXXXXXXXXXXXXXXXXXXXXXXXXXXXXXXXXXXXXXX
