-------------XXX------o--------------------------X-------------------------o----------------------------------------------B-----------------------------------------------------------------------------
---------------------------------------------------------------------------------------------------------------o------------------------------------------------BBBBBBB---------------------------------
---------------------------------------------------------B---------------------------------------------M------------------------B---------------BBBBB-X------------B----?--------------B-----------o----
------------------------------???--------BBBBB-o-------------------B---------------------------BBBB-------B--------------------------------------X------------------------XX----------------------------
-----------------T-----?-T---------------------------------------X---------------------------------------------------XXXXXXXX-------------X----------------------------T--X--X-------------------B------
------------BB---|-----T-|-------------------------------------TXX--------X---------------------------------------------------------------??B-------------XXXX-X-M-----|-XX-XX--------------------------
-----------------|---B-|T|----B-------------------X------------|XX---------------o----------o-----------X-------------------------------T-------B----M--------XX-----B-|XXXXXX-----?----o---------------
-----------------|-----|||-----------------------XX-----------X|XX-------------------------------------X-----B-------------------B--B---|-B-----BBBBBBB------XXX-------|XXXXXXB----X--------M----------v
-----------------|-T---|||T------------X---M----XXX-B-X--X---XX|XX------------------------B-----------------------------------BB--------|-----T-----------T-XXXX------X|XXXXXX---------------------B---f
----------X------|-|---||||-----B------XX------XXXX--XX-----XXX|XX--------M----------------------------X------------------------B---?---|-----|BBBBBBB----|XXXXX-----XX|XXXXXX----------------T--------f
-----------------|-|--X||||--------???-XXX---XXXXXX-XXX----XXXX|XX--X---X--------------BBBBBBB------------------------------------------|-----|-----------|XXXXX----XXX|XXXXXX----------------|--------f
-----------------|-|-XX||||------------XXXX--XXXXXXXXXX---XXXXX|XX-XX-------------------------BBBBB-------------------------------------|-----|BB--X-----X|XXXXXT--XXXX|XXXXXX----------o-----|--XXo---f
-----------X-----|-|XXX||||---o-------XXXXXXXXXXXXXXXXX--XXXXXX|XXXXX---------------------T-----------------------X--B------B-----------|-B---|---XX----XX|XXXXX|-XXXXX|XXXXXX-------------X--|--------f
-----------------|-|XXX||||------------XXXXXXXXXXXXXXXX-XXXXXXX|XXXXX----XXXXX-----X-----X|-----------------------XX---------------o----|--?-X|XXXXX---XXX|XXXXX|XXXXXX|XXXXXX----------------|--------f
m-----------BBBBE|X|XXX||||------E-X--EXXXXXXXXXXXXXXXXXXXXXXXX|XXXXX--X------E----XX---XX|-E--------EE-----------XXX----EE----E-----o--|-----|-XXXX--XXXX|XXXXX|XXXXXX|XXXXXX--E-?---E-------|--------X
XXXXXXXXXXBXXXXXX|X|XXX||||XX------XXXXXXXXXXXXXXXXXXXXXXXXXXXX|XXXXXXXXXXXXXXXXX--XXXXXXX|------XXXXXXXXoX-----XXXXXXXMXXXXXX--MX--XXXX|XXX--|XXXXX-XXXXX|XXXXX|XXXXXX|XXXXXXB---------XXXXXX|XXX-----X
