--o--XB---BB--?---o-----oBB------o----B-X-----------o------Boo-BX----------o-------B--o---X-X----B--B-----oo-o------------------BBBX-o---------BB---o--------o---------------------B---------o-B-----Xo-
o---------oo---X------oE-B---------------o--B-o----o-------X-------------B-X---T-----o--o--X----T-------T-------XB---o-------X-------------------o--------?T----------X--B-----o--B--B-o-----X---------o
------B----------B---XoBoo-o------o--B-B------------X-o--o----o----Bo---o------|------Bo---oB---|-o-----|-----B-------o--o--------B--X-------------B--oB---|-------BB-ooo-B--o---o---B--------X-----X-o-
X---B---B----------o-----------X-----------B--o--o--------oX-------X-o---------|--------B----oX-|--BX-o-|--o------o---X-B--X------BXo----o----B--BBo-BB----|--o-----------B-------------B-----B--o------
---------------B----o----o-o----------------------o------X---o--o-------oo-----|----------o----B|-------|----oo-B---oB--BB-----------X--oo--------XE-----B-|----------o--o-----X------------------------
--oX--X------o-oo-----B--B----oXo----B----X-----------Xo-----o-o------o-------o|--XX---------o--|--B----|-B-XB------------B-B---B--B-----X------B--B--o----|--------------o---oo---------o-----------o-o
-----X----------------B--?---oo--X-o-B------o----------o---B---X---o-Xo----o---|-o--?---o-------|-------|-o------o---BB-B-X--------o---B--o-------------o-o|--oX----o--X----------Bo--------ooo---X-----
Bo----X-o---B---X-B--o-o----B---B-o----------X-----B------T------BB-Xo-o--o-o--|------X--------o|--o---o|---------BB-B-------o-------o-----------o--------o|------------oo----------------o---o--------v
---o--------o------XoB-----B-------o--XB----X-o------Bo---|--------------B-----|---------------X|---?-E-|-----o---o-o-o-------o-------X-------o----oo---o-E|-o---------o--------X--o------o-----------Bf
---o-o-T-o--------o-----o---o--Xo----o------E--B-B--------|---Xo---oX----X--o--|-o---------o----|----BB-|-B---------B--B--o----B--------oo-oX----o-------oX|------o-----X------ooB----o----o-------o---f
oX--B--|-B-------------------------o---o----B-B-----------|-----------X---o----|-B-----o-B------|-----o-|-o------o-BX-------B---X------------o-------------|--------X--------o-------------o----------of
----XB-|-----B-------oB-o--------------------------B--Eo--|------------------B-|-B-o--o-o-------|-B----o|-o-------B---o-----------------o----BB----Bo----o-|--X--------o-o---------E--X---X--------BB--f
X-X----|-----o----X--X--B--X----------------X-----X-------|-Bo--o--B---------o-|-------oB-------|-X--E-B|-----o---o-----------B--B--------o-----BoBo---oB--|-oo--BB----------------B---o--oo-----------f
o----o-|--o---------------B-------------------------------|---------o-------oB-|--X---B---o----o|----X--|---------o-o------B---------------Bo--o--o----oE--|------B---oB--B-----------o-------------B-of
m--ooB-|-T------o-o--BBX-X-----EoB------X--o---------o----|----E-------o-oo----|-----------B--o-|------B|--o---BE-X---------B-o------B-X-EE-E----o-----BXoX|-B--------------------oo-----------o--B---EX
XXXXXXXXXXXXXXXXXXXXXXXXXXXXXXXXXXXXXXXXXXXXXXXXXXXXXXXXXXXXXXXXXXXXXXXXXXXXXXXXXXXXXXXXXXXXXXXXXXXXXXXXXXXXXXXXXXXXXXXXXXXXXXXXXXXXXXXXXXXXXXXXXXXXXXXXXXXXXXXXXXXXXXXXXXXXXXXXXXXXXXXXXXXXXXXXXXXXXXXX
