X---o------BBBB-----B-o-B-Bo----XB----------------------o---Xoo-------B-----o---B---oB----oX-B------o---o---B---------X----B-B---------------B--------BB--------------------B------o---o----T----o------
------o-X-------BX---------B-----B---X----------B---------o-X-------B----oB-oX-o-------o---o--------o---------------o--B---------o--X--------o-------B------------o-------B-X----oo---------|----------X
----------o-------BBBB--oX-oBo--oo-----B-------B---B---B----o-X---B--o------o---XB-------oB--B-o-----o---o-----o-o--X----X----o---o------E-X---------B---------o--oo-----BX---------B-oo----|-----------
X------o-------o-----o-------Bo---B--B--B-o--------o--B-B---o----o---B----Xo---B--o-o----o---------------B--o--Bo---oBB----BoX--o----XX--------B-----X-B--------o--------B-----o---B--B-----|----B-X----
-X--------------------B---------ooo-X--B--B-------o--o---o----o-------B-------------------B-----o-o--------------------X--------ooX-o-----o--BX---o-B--o-BX--oE--o---B-------B-----------o-B|------X----
-T-----oB-------oo-------------o-XBoo----o-o------B---o-o---o----------------Xo----------------o---------Xo-o----Bo----?--o------o-o--X--B--------B--B----o-o-------Bo------------X---------|---T---B---
B|------B-o-----------------------------oB-------o-------BBB-X--E----o-------X-------o--X----B------------o--o-oB-----o--BB----------------B---------------------B---B-X--------oo---o-X----|-oX|-B-----
-|---BB---o-------------oo------X---o-----o--------o------o-o-------Bo-------oo-----E----------B-o-------o---X------B----o--B---o-------------B--Bo----B----B-----B----------o--------o-X---|---|------v
B|----X------T----------B-B----------oB--B-oo---------B--------------B----------o--------B--B----o--Bo-----o--B-----------------------oB-X--o-B-X----------------o-Bo--o--B-o----o-B---B-o--|---|------f
-|--B--------|--X----oB------B--X--------------oXoo-BB---X-o-oXB------o--o-X---------X-B--------B-------oo-------------------o-------oo----o-E-o--B--o-X-oB--o-X--------o--------B-o-BX--B--|---|------f
o|------oo---|----o-B---B-o-o----o--X---o?---------o-X-oB-------------B-BB-B---------BoX----BB-X----B-B----B-------o-----o--B-----B--------o----------o--------B------------o---------o-----|-B-|------f
-|-X---X----o|---------------------------------o--------------B---o------------B--X--o------o--BB--B--------X--------Xo-oB-o---X------o----X---B--BooB-B------B-B--o-------------o---o------|---|--BBBXf
-|--EBX-----o|-o------B------o?------------------B----o--?-X-o-------X---------B-------X------------------B---To--B-E-X-B-----BB-o----------o----X---------------B-E---o-------B--o--------o|---|---o--f
-|--o-------o|---------BBo-Bo--B-o-oX---B------o----E------o--------B-B------o--o-o---X-------X------------oB-|-----------XB--o--B-T--------E--------o-----------oBM-B--o---o----B-oEooB----|---|------f
m|----o------|------B--BB-B--o----XE-o-o----B----o---o-o------o----B--E-E-----------o----E--B-----ooo-o--o----|-o-EX---BX--oM-B--EX|--BB--E----------EB----------o-oXX----oo------o----o----|-o-|-------
XXXXXXXXXXXXXXXXXXXXXXXXXXXXXXXXXXXXXXXXXXXXXXXXXXXXXXXXXXXXXXXXXXXXXXXXXXXXXXXXXXXXXXXXXXXXXXXXXXXXXXXXXXXXXXXXXXXXXXXXXXXXXXXXXXXXXXXXXXXXXXXXXXXXXXXXXXXXXXXXXXXXXXXXXXXXXXXXXXXXXXXXXXXXXXXXXXXXXXXX
