--------------B-------------------o----------------------------------------------o---------o-----o----X--X-------------XB-------------------B---------------------o--oo----------o----------------------
--------o---o-------------o--o------E----o-----------o----------o------o------oo----B---B----o---------o--oBo-o-oo-----------B---------------BB-------------Eo----------oBo-----------------B-----oo----
-----X----B--o--o-------X-B-----------------Bo-------------B---B--X------o----o----o--B-----------o-----X-BB----------------X--Bo----------Xo---o-B----------o-o----o-o----o--o--------------------BoX--
--X---------B---B--o-----oo-----oBo----B-Xo-------o---o--o---------XBB----o----------B------o-----o-X-oo--X-B-----------B----X---------B-----X--------------Bo-------B-----o-B---B--o------------X------
---------------------o-----X---B--------------------o--------------o-----BB-------oBo-----X-------------X-X---------o-----------o--B-----B------X-B---------o-oB--------B-X-o---B----o------------------
--o------X---------Xo------o-------------------o-o-o-o------o-----------o-oo------------X-----B-------o-o---------B--------------------B---X-----------o--oB-------------o-----------BX----E---o--------
-------------B-X-X--o--o------------------------------B-------------B-----------E--------B-------o---o-----B--o---oB-----B---X---------------o-------o-------------o--------B----------------X------o---
--o--B--------------oB-------------Xo----------o------o-----------o----------B------B--------------?--X-X-----------o-----------B-o--o---BE-----------o------BMo-E---X-----o-o------o------------o-B---v
---B--------X--oX---B----BoB------o-------X--Bo-------o--------------o----o-X---------o-o------ooB-----o---B------B-B---------o------------------------------o--X--B-----B-------B---------------------f
--B-----X----oB-----------------o----o-----Xo--------B--B----o---B----B---B------------oX--o---B-------------o----o-X--XoB---B-----------------o?B------o------------o---B---Bo--------o-o----------B-Bf
--------------------Xoo--------o-o-----o----o-B-o------o---------------o-----------oB-?BoBB------XoB--oo--------o---X-----o-------B--------B---o-o----o-o--B---o---------------------------B-----E-o---f
----------o-oo--o-oB--o-X---o-----------?-----oB-----------E---o--------o-----o------B-X----o---B--o---oB-------------o----o---oo?-o---E---oo-----B-----B-------o-o---------E------o--------o--B---?-B-f
---------------oXo----------------------------B------------o---o-----------o-o-------------Xo------o---o-----------------o--oX----E----------BB-----o-----o----------B-X-o---------X-------------------f
---------B--------oo--------------Xo--------------o----B---o-----------E-o-------------------------o-o----E-o--oo---------------------------------------------------------B-E------B-------------------f
m--X-----X----oo-----oB-o----E-o--oB--Bo--X-----o----o-o-----X---Bo-------------o-------o-o--------o-Bo----Xo----B--o-----------------BB---------o-o----o-----X--------------------o-----------E-------X
XXXXXXXXXXXXXXXXXXXXXXXXXXXXXXXXXXXXXXXXXXXXXXXXXXXXXXXXXXXXXXXXXXXXXXXXXXXXXXXXXXXXXXXXXXXXXXXXXXXXXXXXXXXXXXXXXXXXXXXXXXXXXXXXXXXXXXXXXXXXXXXXXXXXXXXXXXXXXXXXXXXXXXXXXXXXXXXXXXXXXXXXXXXXXXXXXXXXXXXX
