X----------B--B-----oo--------o-BBB-----------B--X--------o-X------B---o--X-B---Xoo-o-------------------o-?-------B---X----oB----------------B-------------o--X------oB---XBB--o---o--oB-B--T----o-o-X--
-----Bo--o---X-o----B---XB----------B-----o---o------BB-------ooBo--B-----B-BXoo---X--Xo--B----X-----o-o---oo---------o----------oo--B-----------------Xo------B-B----B------oB--o----------|----------X
--B--E---o---oo---oEBoB-X------X-----------o-X-oo---o---E---o-------Xo------o--B-XBo------B---X-X---oo--B-X---o----o--o------------X---------------X-B---B---X-----------Xo-BB---o-o---X-BX-|-----o-o---
X----ooB--X---X----X----o-----B------B----B---------B--------------B--B--------------o-B------------------------o-------o-oB--o-o-------B--B---------Xo---o-B---B----X----X-----Bo---E------|--B--------
----o-o--------o---B-X-o-B----Bo-B-----B----oo---B-X--------o-o--E----B--oB-B----------------BB-------------X------B---o---B--o-----o-B-B--------Bo------Bo----o--o-------------XBo----B-X--|--o------B-
-T--------------Bo------------Xo---X-B---------o--B---o-----B--o---o-------o-------B----BooB-o---------------------XB----B----o--X-------B--B-B-o--o-------B----o---X-B--o--------E---o-----|--oT--B----
B|------o-oB----------o--------Xo--oX---------o--o---------------oB----------B-B--------------------------X-B---o--------B---B-------o-------E--------o---o----Bo---------------------X---o-|---|----o--
-|-B--M-----BX-B----o--BXo----------BX--------Bo----o-------B-oo-----------X--o--B------------B--o---o-------Xo----------o--------B-o----------B---o-o-Bo-o---------X------------o--B---E---|--E|---B--v
B|-----X-----T-------------o-------XB------BX-----o--------X--B-------------------o-----------X--oX-B---o----------o------------------oo--oo---------oX-o--o---------o-B----------X--B------|---|------f
-|--BXo-o----|--X-----------------------X----X---B------ooBB-E-o--B----B------------o----B-B-B-B--o---------B-----o--X-----o------o-o-X--------B---B--------------X-o-B-o-oo---------------X|-oX|------f
o|-------o-o-|--B-o-B-X--Bo--B---------------------o---o----o---o-X---oB-Xo----o------------------o---o------o---------------------o--o---o---B-------X--oXB----------------X---oo------oo--|---|-BBX--f
-|-----o-----|----------X---------------------------B-------oo-o--------B-----X-----o-----oB--o---XXo-----B----------B-B-B----Bo---B----B------B---o----------------XB--oo------------Eo-X--|---|--o---f
-|---------o-|-o-o---------------o------oX-------B-B-----o-X-------o-XX-----o-B-B--------------------o-o------T---Bo---X----------o--o------------BB---o-------o---BB-------------oo--o-o-o-|--B|------f
-|-oB-------o|-----------o------B---X-----B----------X--oX-------X-----B----o---E---B-------o-EB---o------BB--|-----M-------------oT------o--------B----------X-o---o--------------o-o-B-B-B|--X|------f
m|--E-B---X--|--E---E-----B-------o--B--X--E--Bo--o------------o---o--o---------E---o------EB-o-------X-X-----|-o-----o-X-oo-------|-B---------oBBE-----X-----o--E-----------EB----o--E---EB|---|--o----
XXXXXXXXXXXXXXXXXXXXXXXXXXXXXXXXXXXXXXXXXXXXXXXXXXXXXXXXXXXXXXXXXXXXXXXXXXXXXXXXXXXXXXXXXXXXXXXXXXXXXXXXXXXXXXXXXXXXXXXXXXXXXXXXXXXXXXXXXXXXXXXXXXXXXXXXXXXXXXXXXXXXXXXXXXXXXXXXXXXXXXXXXXXXXXXXXXXXXXXX
