-----o--X-----------oo--B-X-----------------------------X----------o---o--B----X--------------------B-----------o---------------X-----------Bo---------B--o--B----------o------o---------BBo---T----Bo--
-o--o---B-B-------o-----BB---E------o--X-o-----o----o--------o----o-----B-------------------o-oB-Xo-------B--XX---------o---------------------X---B---o--B-----oo------------o----o-o---X--o-B-|--o-B-o-
---E-------o-----o------o----XB-Bo-oB-----B-------B----o---o--B---------o-----o----X-------o----T--B---B--oo-o-o----XE-----o-----X----o-B-X-------oB------o----oo--------o--------E--o---------|----o---
o--X-B---X----o-o--------?------------------B-----------B------B----o--X-o-X---------o---------o|--BB---o--B------o--X-----------B--------Bo------B-o----EX--------o-------T------X---X-oo----o|--B-----
-----o----o-------------o--B-----E------o--------o-X-------B---oB-X-B----B--o-----B--X-o-------o|-------------B----------o------o--o-----o---------o--o--Xo------B---------|-o--o-?------------|-----o--
-------o---o------X--XB--o---XB--BB-B------------o-----------o--XXBo----B-----------------o-----|--X-o--o--oo----o--o----o---------B--------B---------------------o--B--o--|---------B-B-o-----|-o---X--
---------B-o-----------o--X---------B----XBB---------------BX-B-------------B-------------------|----Eo-oX---B------XB-----o--------oo--B---o--------o---BB-BB---B------E--|-----B----X-----T--|---o----
--B------------B-B----------------E--------o-o--B--o---o-----------X-----------o----Boo---o-----|----Xo--o-o------E-------B---B------XX-------------------X-------o-----XX-|-------------o-X|--|-oB----v
E-----------B------B------B-------Bo----------o---B---------X----o-----o---------------o--------|-----------------BX-o-----------------B---o---ooB----X------------------o-|---B--X-----X--B|--|-------f
B---Xo------------o---X-oT--oBo-T---o-o---o-----B--o-----BB---Bo---oX--B---------X-o-o----o---o-|--B----------oB--BX?o-----EB---------Xo-----------oB-B--------------o----o|--o--o----------|--|--o----f
-o----------B---oo------o|----o-|--------o----o--------oo--------------B--?--Bo----B--T-o-------|-------o----o-B-o-----BX--X--------------o----------X-----oo-X-o-T--B--o--|---------o------|--|--o---Xf
o-B----o--B--oX----------|----EX|--o-o-----------------o----o---o----X-B-----o-o-----o|--Xo---X-|-------B-o------o--o--B------------Bo-----ooBBo-B----------------|---o----|----------o--o--|-B|-------f
X--------Boo----o----B-BB|----Bo|-X-o-------B--B-----------o----------oB--o--o-oo---o-|---------|---------B------BB-B-----X---o---B-o--------------------o--------|---X--o-|----B-------o---|-o|--B----f
---------o-------------X-|------|-----X-------X--------oo----Boo------------B----o--o-|----B---o|---B--B----------o--------o----------o---------------------------|----oXo-|----BB--B------B|--|---oo--f
mET------E---E-o---------|------|------BT-o-o-B------B--------------EB-------X--------|---B-----|-B--XE-B---E---B-----------------------T------X-B-oXoE---T-------|--E--X-E|-X-B-o----B---E-|--|------EX
XXXXXXXXXXXXXXXXXXXXXXXXXXXXXXXXXXXXXXXXXXXXXXXXXXXXXXXXXXXXXXXXXXXXXXXXXXXXXXXXXXXXXXXXXXXXXXXXXXXXXXXXXXXXXXXXXXXXXXXXXXXXXXXXXXXXXXXXXXXXXXXXXXXXXXXXXXXXXXXXXXXXXXXXXXXXXXXXXXXXXXXXXXXXXXXXXXXXXXXX
