--------------------------------------------------------------------------------------------------------------------------------------------------------------------------------------------------------
------X------------------------------------------------------------------------------------BBBB---------------------------------------------------------------------------------------------------------
-------------------------------------------------------------------------------------------------------------------------------XXXXX--------------------------------------------------------------------
--------------------------o-----------------------------------------------------------------------------------------------------------------------------------------------------------------------------
--------------------------------------------------------------------------------------------------------------------------------------------------------------------------------------------------------
-------------???---------------------------------------------------------------------------------------------------------------------------------------------------XXXXXX-------------------------------
--------------------------------------------------------------------------------------------------------------------------------------------------------------------------------------------------------
-------------------------------------------------------------------------------------------------------------------------------------------------------------?????-------------------------------------v
---------------------------XXXXX----------------------------------------------------------------------------B------------------------------------------------------------------------------------------f
---------------------------X---------------------------------------------------------------------------------------????????----------------------------------------------------------------------------f
---------B----------------XX---------------------------------------------------------------------------------------------------------------------------------------------------------------------------f
-------------XXXXXX------XXX-----------------------------------------------------------------------------------------------------------------------------T---------------------------------------------f
------BBBBBBB-----------XXXX------------------------------------------------------------------------------------------------------------------BB---------|----------T--------------o-------------------f
------???????----------XXXXX------------------------T----------------------------------------------X-----------------------------------------------------|----------|----BB----------------------------f
mE--------------------XXXXXX------------------------|---------------------------------------------XX-------------------E----------X----------------------|----------|----X-----------------------------X
XXXXXXXXXXXXXXXXXXXXXXXXXXXXXXXXXXXXXXXXXXXXXXXXXXXX|XXXXXXXXXXXXXXXXXXXXXXXXXXXXXXXXXXXXXXXXXXXXXXXXXXXXXXXXXXXXXXXXXXXXXXXXXXXXXXXXXXXXXXXXXXXXXXXXXXXX|XXXXXXXXXX|XXXXXXXXXXXXXXXXXXXXXXXXXXXXXXXXXXX
