--------------------------------------------------------------------------------------------------------------------------------------------------------------------------------------------------------
--------------------------------------------------------------------------------------------------------------------------------------------------------------------------------------------------------
----------------------------------------------------------------------------------------------------------------------X-----------------------------------------------------------o---------------------
--------------------------------------------------------------------------------------------------------------------------------------------------------------------------------------------------------
-------------o------------------------------------------------------------------------------------------------------------------------------------------------------------------------------------------
-----------------------------------------?--------------------------------------------------------------------------------------------------------------------------------------------------------------
--------------------------------------------------------------------------------------------------------------------------------------------------------------------------------------------------------
-------------------------------------------------------------------------------------------------------------------------------------------------------------------------------------------------------v
-------------------------------------------------------------------------------------------------------------------------------------------------------------------------------------------------------f
-------------------------------------------------------------------------------------------------------------------------------------------------------------------------------------------------------f
-----------------------------------------------------------------------------------o-------------------------------------------------------------------------------------------------------------------f
------------------XX-----------------------------------------------------------------------------------------T-----------------------------------------------------------------------------------------f
----------------T--------------------------------------------------------------------------------------------|-----------------------------------------------------------------------------------------f
----------------|--------------------------------------------------------------------------------------------|-----------------------------------------------------------------------------------------f
m----E----------|--------------------------------------------------------------------------------------------|-----------------------------------------------------------------------------------------X
XXXXXXXXXXXXXXXX|X---XXXXXXX---XXXXXXXXXXXXXXXXXXXXXXXXXXXXXXXXXXXXXXXXXXXXXXXXXXXXXXXXXXXXXX-------XXXXXXXXX|XXXXXXXXXXXXXXXXXXXXXXXXXXXXXXXXXXXXXXXXXXXXXXXXXXXXXXXXXXXXXXXXXXXXXXXXXXXXXXXXXXXXXXXXXX
