--------------------------------------------------------------------------------------------------????--------???????---------------------------------------------------BB------------------------------
-----------------------------------------------------------------------------------------------------------------------XXXX-----------------------------------------------------------------------------
---------------------------------------------------------------------------------------------X-------????--BB----------------BBBB-------------------------------------------------BBBBB-----------------
--------------------------------------------------------------------------------------BBBBB----------B--------------------------------------------------------------------------------------------------
-------------------------------------------------------------------------------------M------------------------------------------------------------------------------------------------------------------
--------------------------------------------------------------------------------------XXXXXXXX-----------------??---------BBBB--------------------------------------------------------------------------
-------------------------------------------------------------------------------B---------B---------------------XXXX---------------------------------------BBBBBBB---------------------------------------
-BBB---------------------------------------------------------------------------------------o??????---????------------------------------------X--------------------------------------------XXXX---------v
--------------------------------------------------------------------------------------------------------------????-----------------------X-------------------------------------------------------------f
------------------------------------------------------------------------------------------------------------???????------XXXXX----------XX------------XXXXXX-------------------------------------------f
--------------------------------------------------------------------------------------------XXXXXX-------------------------------------XXX--------------------M----------------------------------------f
--------------------------------------------------------------------------------------------------------M-----------XXXX--------------XXXX--BBBBBB---------------------------------------------------BBf
------------------------------------------------------------------------------------------------------------X------------------------XXXXX-----------------------------------------------------XXXXXXX-f
------------------------------------------------------------------------------------------------------------------------------------XXXXXX-------------------------------------------------------------f
m-----o--------------------------------------------------------------------------------------------------E---------------------E---XXXXXXX-------------------------------------------------------------X
XXXXXXXXXXXXXXXXXXXXXXXXXXXXXXXXXXXXXXXXXXXXXXXXXXXXXXXXXXXXXXXXXXXXXXXXXXXXXXXXXXXXXXXXXXXXXXXXXXXXXXXXXXXXXXXXXX----X---XXXXXXXXXXXXXXXXXXXXXX---XXXXXXXXXXXXXXXXXXXXXXXXXXXXXXXXXX------XXXXXXXXXXXXX
