--------------------------------------------------------------------------------------------------------------------------M-----------------------------------------------------------------------------
--------------------------------------------------------------------------------------------------------------------------------------------------------------------------------------------------------
-----------------------------------------------------------------------------------------------------------------------------?--------------------------------------------------------------------------
--------------------------------------------------------------------------------------------------------------------------------------------------------------------------------------------------------
----------------------???????---------------------------------------------------------------------------------------------------------------------------------------------------------------------------
-------------------------------------------------------------------------------------------------------------------------------------------------------------------BBB----------------------------------
-------------------------------------------------------------------------------------------------------------------------------------------------------------X------------------------------------------
-----------------------X------------------------------------------------------------------------------------------------------------------------------------XX-----------------------------------------v
----------?-----------XX-----------------------------------------------------------------------------------------------------------------------------------XXX-----------------------------------------f
---------------------XXX----------------------------------------------------------------------------------------------------------------------------------XXXX-----------------------------------------f
--------------------XXXX--------------------------X------------------------------------------------------------------------------------------------------XXXXX-----------------------------------------f
-------------------XXXXX---------------T---------XX------------T----------------------------------------------------------------------------------------XXXXXX-----------------------------------------f
------------------XXXXXX---------------|--------XXX------------|---------------------------------------------------------------------------------------XXXXXXX---------------------------X-------------f
-----------------XXXXXXX---------------|-------XXXX------------|-----------B----------------------------------------------------------??????----------XXXXXXXX---------------------------XX------------f
m---------------XXXXXXXX---------------|------XXXXX---------E--|--------------------------------------------------E-----------E----------------------XXXXXXXXX---------------------------XXXo----------X
XXXXXXXXXXXXXXXXXXXXXXXXXXXXXXXX-XXXXXX|XXXXXXXXXXXXXXXXXXXXXXX|XXXXXXXXXXXXXXXXXXXXXX-------XXXXXXXXXXXXXXXXXXXXXXXXXXXXXXXXXXXXXXXXXXXXXXXX?????XXXXXXXXXXXXXXXXXXXXXXXXXXXXXXXXXXXXXXXXXXXXXXXXXXXXXX
