-----------------------------------------------------------------------------------------------------------------------------------B---B-----------------XX----?--X--------XXXXXoX------X---------------
-----------------------------------------------------------------------------------------------------------------------X----B--------X-------------X-----B-XXXX----X----X--B----B----X------??M?????----
----------------------------------------------------------------------------------------------------------------------------M---o----BXX-B-----X--B---BBB----------------M?------?--B--X-----------BBoB-
--------------------------------------------------------------------------------------------------------------------------B---B---BM----B----------B---T-X--T-----------?BB--XXXXXXX---X----------------
--------------------------------------------------------------------------------------------------------------------B---------X----------X-BM--o------B|----|X-------X--T--X--------BBBBXXXM-?-B----B-B-
-----------------------------------------------------------------------------------------------------------------------------XXX--B-XXXXXXX--Xo--------|----|XX-----XX--|---B--B--BBBXBX---B----T--X----
----------------------------------------------------------------------------------------------------------------X-----------XXX----B-XTB--------BB--X-B|---X|XX---XXXX??|B------X----XXTX-o-----|-XXT---
-------------------------------------------------------------------------------------------------------------------------M-XXXX---T--?|X?-----T---XBMM-|BBXX|XX---XXXX--|-T----XX--XXTX|XX------|---|--v
--------------------------------------------------------------------------------------------------------------------------XXXXXX--|---|-------|--X--B--|BXXX|XX??XXXXTX-|-|---XXX-XXX|X|XXX--X--|---|-Xf
-------------------------------------------------------------------------------------------------------------------------XXXXXXXXT|---|?????T?|-----B-o|XXTX|XX-XXXXX|--|-|--XXXTXXTX|X|XXXX-XXT|---|-Xf
------------------------------------------------------------------------------------------------------------------------XXXXXXXXX||--X|--T-B|-|-MXX----|XX|X|XXXXXXXX|??|?|-XXXX|XX|X|X|XXXXXXX||---|-Xf
-----------------------------------------------------------------------------------------------------------------------XXXXXXXXXX||---|BB|XX|B|-XX----X|XX|X|XXXXXXXX|--|X|XXXXX|XX|X|X|XXXXXXX||---|-Xf
----------------------------------------------------------------------------------------------------------------------XXXXXXTXXXX||XBB|BB|X-|-|XXXX--XX|XX|X|XXXXXXXX|X-|-|XXXXX|XX|X|X|XXXXXXX||X--|-Xf
---------------------------------------------------------------------------------------------------------------------XXXXXXX|XXXX||XX-|--|-B|-|XXXXBTXX|XX|X|XXXXXXXX|-B|X|XXXXX|XX|X|X|XXXXXXX||XX-|-Xf
m--------------------------------------------------------------------------------------------------------------B----XXXXXXXX|XXXX||XXX|XX|E-|X|XXXXX|XX|XX|X|XXXXXXXX|E-|X|XXXXX|XX|X|X|XXXXXXX||XXX|-XX
XXXXXXXXXXXXXXXXXXXXXXXXXXXXXXXXXXXXXXXXXXXXXXXXXXXXXXXXXXXXXXXXXXXXXXXXXXXXXXXXXXXXXXXXXXXXXXXXXXXXXXXXXXXXXXBXXXXXXXXXXXXX|XXXX||XXX|X-|XX|X|XXXXX|XX|XX|X|XXXXXXXX|XX|X|XXXXX|XX|X|X|XXXXXXX||XXX|-XX
