------------------------------------------------------------------------------------B--------------B-B------------X-X---?--B----------------B-----------?????----B--M---------o--------?-----------X----
-------------------------------------------------------------------------------------------X--X------?------XB--B---------o------------------X---------X--------B-----M--?--------------?--B--B---------
-------------------------------------------------------------------------------------XXXX---------o------------------X----X-X--------X-X----X--B---M---X------------B------B---------------BBBB---------
--------------------------------------------------------------------------------------------X--X----T------XXXXXXoo-------B----------------------X----o-------------TX--------X---o--X------------------
--------------------------------------------------------------------------------------X---X------X-X|-BT--X--?---XXX-------------X-BB--XBXT--TM--------B------------|T---XX----------XB--TB---------Xo--
-------------------------------------------------------------------B---------------------XX--------?|-T|-Mo-XX---X---T--X--X-X-X--X-----TX|--|-X----B---B--X--------||--XX--TX-M--B------|---------MX-B-
--------------------------------------------------------------------------------------o-XXX---------|-||-XTT---X--X-T|-------XXBXBXBBB--|X|--|-X---------?----X--BBX||oXXX--|oX-X-X-?o---|--T----BBX----
---------------------------------------------------------------------------------------XXXX-------B-|-||X-||B-X----X||---o--XXXX-B-----X|X|--|--XBBB-?X---X--BB-XB--||XXXX--|-X---XX-----|--|-X----B---v
--------------------------------------------------------------------------------------XXXXXB-------X|-||--||----?BT?||-------TXXX-----XX|X|X-|X---B-XXXXXXX----XX---||XXXX-?|--o--XXX----|--|-????????-f
-----------------------------------------------------------------------------------T-XXXXXX---------|-||--||-----X|-||---XXX-|XXXX-B-XXX|X|XX|------XBXXX------XX---||XXTX--|-----XXXX---|X-|----------f
-----------------------------------------------------------------------------------|XXXXXXX----X----|-||--||------|-||B-X-X--|XXXXX-XXXX|X|XX|-o----XXXXXXX----XX--X||XX|X--|----TXXXXX--|X-|------B-B-f
-----------------------------------------------------------------------------------|XXXXXXX----XX---|?||??||?-B-BT|-||-XXXTXX|XXXXXXXTXX|X|XX|X-----XXXXXXT-?XXXXXXX||XX|X-B|BBB-|XXXXXXX|X-|------B--Mf
----------------------------------------------------------------------------------X|XXXXXXX----XXXXX|-||-?||---B-||B||XXX-|--|XXXXXXX|XX|X|XX|XX-X-XXXXXXX|X--XXXXXX||XX|X--|----|XXXXXXX|X-|-------X--f
---------------------------------------------------------------------------------XX|XXXXXXX----XXXXX|-||-B||?BBBB||-||XXX-|X-|XXXXXXX|XT|X|XX|XXXXXXXTXXTX|XX--XXXXX||XX|XX-|B---|XXXXXXX|X-|--B-------f
m-------------------------------------------------------------------------------XXX|XXXXXXX-X--XXXXX|X||--||-X-E-||-||XXX-|--|XXXXXXX|X||X|XX|XXXXXXX|XX|X|XXXEXXXXX||XX|XXX|-E-E|XXXXXXX|XB|E--------EX
XXXX-------XXXXXXXXXXXXXXXXXXXXXXXXXXXXXXXXXXXXXXXXXXXXXXXXXXXXXXXXXXXXXXXXXXXXXXXX|XXXXXXX---oXXXXX|X||B-||XXX-X||X||XXXX|oX|XXXXXXX|X||X|XX|XXXXXXX|XX|X|XXXXXXXXX||XX|XXX|X--M|XXXXXXX|XX|X?XXX-----X
