-----------------------------------------------------------------------------------------B---------B-B------------X-----?B-B----------------------------?????---XB--M-----X------------?-----------X----
-------------------------------------------------------------------------------------------------------------B-----------------------------------------X---o-----------------------------XXoXXX---------
--------------------------------------------------------------------------------------------------------------------------X------------X--------------------------------X----------X--------------B-B---
--------------------------------------------------------------------------------------------X-----------T--XXXXXXX--------B----------------------X---------------------?----------o--B--X---------------
---------------------------------------------------------------B-----------------------------------X---T|--------XXX----------------B-----X---X--------B-----------X------X-----------B--------------oX-
-------------------------------------------------------------------------------------------------X----T||-o--------------------X---------XX--X--------------------XX-----------M-------M------X----MX-X-
----------------------------------------------------------------------------------------------------B-|||--------------------X----------XXX----------------------XXX---------o--X-X--------------BB---X-
-----------------------------------------------------------X------------------------------X-------B---|||-----X-------------o----------XXXT------BBB------X-----XXXX--------?-----XX------------------Xv
--------------------------------------------------------------------------------------------------o---|||---------T----------------X--XXXX|X--X----------------XXXXX-?------------XXX---------------B-Xf
-----------------------------------------------------------------------------------T----X-----------X-|||---------|----------------XXXXXXX|XX-----------------XXXXXX----T---B-----XXXX-----B----X-----Xf
-----------------------------------------------------------------------------------|-----------X------|||---------|----------------XXXXXXX|XXX---------------XXXXXXX----|--------TXXXXX---------------Xf
-----------------------------------------------------------------------------------|-----B-----XX----?|||????-----|----------------XXXXXXX|XXXX-----------T-XXXXXXXX-B--|--B---B-|XXXXXT-T---------BXXXf
----------------------------------------------------------------------------------B|B---------XXXXX--X|||---X-----|---------------XXXXXXXX|XXXXX---------T|XXXXXXXXXT---|--------|XXTXX|X|----------XXXf
-----------------------------------------------------------------------------------|-----------XXXX-XX|||---------|--------------XXXXXXXXX|XXXXXX--B-----||XXXXXXXXX|T--|----B--T|XX|XX|X|---------XXXXf
m----------------------------------------------------------------------------------|---E-------XXXXXXX|||---------|-------------XXXXXXXXXX|XXXXXXX----E-E||XXXXXXXXX||--|E------||XX|XX|X|XB-E---EXXXXXX
XXXX-------XXXXXXXXXXXXXXXXXXXXXXXXXXXXXXXXXXXXXXXXXXXXXXXXXXXXXXXXXXXXXXXXXXXXXXXX|XXXXX-----XXXXXXXX|||-XXXXXXXX|-----oXXXXXXXXXXXXXXXXX|XXXXXXXX-XXXXX||XXXXXXXXX||XB|-------||XX|XX|X|XX-XXXXXXXXXXX
