----------------------------BBB--------------------------------------------------------X--------------------BXo---B--?-B???X---------o-----------------------------------------------------B-----B?-----
----------------------------------------------------------------------------------------X------------------M----------X---B--B-------------------------------------------------------X------------------
----------------------------------------------------------------------------------------------------------M----X-o-XB--B--???----B---B-----------------------------------------------------------?------
------------------------------------------------------------------------------------------------B---B-BX---------T-XX-B-X-TX-B-T-oo---B-----------------------------------------------------------B-----
-------------------?-----------------------------------------------------------------------------X-XB------XBB--B|--Xo-BXB|XBBX|----B-X---------------------------------------------?--------------B--X-
-------------------o-------------------------------------------------B-----XB-M----T----X---------XX-----o-B--BXB|-XX--BXB|-B--|XXTX?-----------------------------------B-----------------X-----------X-
-----------------------------------------------------------------------------------|------------MXXX---------X-X-|XXX-X---|---B|XX|-----------------------------------------------o-----B--X----------X-
------------------------------------------------------------X-B--------------------|----X-----B-XXXX------B-----B|XXXX----|----|XX|--B-----------------------------------------------------XX---------Xv
---T-------------------------------------------B-----------XX-----------------M---?|????-T-----XXXXX--X---B-----X|XXXXX-T-|XTX-|XX|X-B-BX--------------------------------------------------XXX--------Xf
---|--------------B--------------------------------T------XXX------X--------T------|----X|----XXXXXXX-BBBBX?--XXX|XXXXTX|-|X|XX|XX|XX---XX---------------------X---------------------------XXXX-------Xf
---|-----------------------------------------------|-----XXXX------XX-------|------|X--XX|---XXXXXXXT-T--XX-B-XXX|XXXX|X|-|X|XX|XX|XXX--XXX--------------------------------------------B---XXXXX-----XXf
---|-----------------------------------------------|B---XXXXX------XXX------|------|-----|X-XXXXXXXX|-|-XXX-XXXXX|XXXX|X|X|X|XX|XX|XXXX-XXXX-----------------------------------------------XXXXXX---XXXf
---|------------T----------------------------------|---XXXXXX------XXXT-----|------|-----|XXTXXXXXXX|-|XXXX-XXXXX|XXXX|X|X|X|XX|XX|XXXXXXXXXX----------------------------------------------XXXXXXX-XXXXf
---|------------|----------------------------------|--XXXXXXX------XXX|X----|-X----|-----|XX|XXXXXXX|-|XXXXXXXXXX|XXXX|X|X|X|XX|XX|XXXXXXXXXXX-------------------------------------B-------XXXXXXXXXXXXf
m--|------------|----------------------------------|-XXXXXXXX------XXX|XX---|X-----|B-EE-|XX|XXXXXXX|X|XXXXXXXXXX|XXXX|X|X|X|XX|XX|XXXXXXXXXXXX-----------------------------------B--------XXXXXXXXXXXXX
XXX|XXXXXXXXXXXX|XXXXXXXXXXXXXXXXXXXXXXXXXXXXXXXXXX|XXXXXXXXXX----XXXX|XXXXX|XXXXXX|B---X|XX|XXXXXXX|X|XXXXXXXXXX|XXXX|X|X|X|XX|XX|XXXXXXXXXXXXXXXXXXXXXXXXXXXXXXXXXXXXXXXXXXXXXXXXXXXXX--XXXXXXXXXXXXXX
