--------------------------------------------------------------------------------------------------------------------------------------------------------------------------------------------------------
-----------------------------------------------------------------------------------------------------------------------------------------------------------------------------------B--------------------
--------------------------------------------------------------------------------------------------------------------------------------------------------------------------------------------------------
--------------------------------------------------------------------------------------------------------------------------------------------------------------------------------------------------------
--------------------------------------------------------------------------------------------------------------------------------------------------------------------------------------------------------
-------------------------------------------------------------------------------------------------------------------------------------------------------------------------------------------------X----o-
--M--------------------------------------------------------------------------------------------------------------------------------------------------------------------------------------o------XX------
-----------------------------------------------------------------------------------------------------------------------------------------------------------------------------------------------XXX-----v
--BBBBB---------------------------------------------------------------------------------------------------------------------------------------------------------------------------------------XXXX-----f
---------------------------------------------------------------------------------------------------------------------------------------------------------------------------------------------XXXXX-----f
--------------------------------------------------------------------------------------------------------------------------------------------------------------------------------------------XXXXXX-----f
-------------------------------------------------------------------------------------------------------------------------------------------------------------------------------------------XXXXXXX-----f
------------------------------------------------------------------------------------------------------------------------------------------------------------------------------------------XXXXXXXX-----f
-----------------------------------------------------------------------------------------------------------------------------------------------------------------------------------------XXXXXXXXX----Bf
m---------------------------------------------------------------------------------------------------------------------------------------------------------------------------------E-----XXXXXXXXXX-----X
XXXXXXXXXXXXXXXXXXXXXXXXXXXXXXXXXXXXXXXXXXXXXXXXXXXXXXXXXXXXXXXXXXXXXXXXXXXXXXXXXXXXXXXXXXXXXXXXXXXXXXXXXXXXXXXXXXXXXXXXXXXXXXXXXXXXXXXXXXXXXXXXXXXXXXXXXXXXXXXXXXXXXXXXXXXXXXXXXXXXXXXXXXXXXXXXXX-----X
