-----------------------------------------------------------------M------------------------------------------------------------------------------------------o-------------------------------------------
----------------------o-----------------------------------------------------------o-------------------------------BBBBB---------------------------------------------------------------------------------
-----------------------------------------------------------------------------------------------------------------------------------------------------------------------B--------------------------------
----------------------------?????-----------------------------------------------------------------------------------------------------------------------------------------------------------------------
----------------------------------------------------------------------------------------------------------------------------o--------------------------------------o------------------------------------
--------------------------------------------------------------------------------------------------------------------------------------------------------------------------------------------------------
------------X-------------------------------------------------------------------------------------------------------------------------------------------------------------------------------------------
-----------XX--------------------------------------------------------------------------------------------------------------------------------M---------------------------------------------------------v
----------XXX-----------------------T------------------------------------------------------------------------------------------------------------------------------------------------------------------f
---------XXXX-----------------------|------------------------------------------------------------------------------------------------------------------------------------------------------------------f
--------XXXXX-----------------------|-----o--------------?---------------------------------------------------------------------------------------------------------------------------------------------f
-------XXXXXX-----------------------|-----------------------------o------------------------------------------------------------------------------------------------------------------------------------f
------XXXXXXX---------------------T-|-------------------------------------------------------------------------------o----------------------------------------------------------------------------------f
-----XXXXXXXX---------------------|-|-----------------------------X------------------------------------------------------------------------------------------------------------------------------------f
m---XXXXXXXXX---------------------|-|-----------------------BBB--------------------------------------------------------E----------E----------------------E--------E------------------------------------X
XX-XXXXXXXXXXXXXXXXXXXXXXXXXXXBBXX|X|XXXXXXXXXXXXXXXXXXXXXXXXXX---XXXXXXXXXXXXXXXXXXXXXXXXXXX-XXXXXXXXXXXXXXXXMXXXXXXXXXXXXXXXXXXXXXXXXXXXXXXXXXXXXXXXXXXBBBBBBXXXXXXXXXXXXXXXXXXXXXXXXX-XXXXXXXXXX--XXX
