--------------------------------XX--------X---------------------------------------------------B--------------------------------------BBBBB---------------------BXB---X-------------?-------B------------
-----------------------------------------??????---------------------------------------------------------B-------X-----------------------X---------XB----------o-------------XB--------X-----------o---B-
--------------------------------------------------------------------M--------?------?----------------?--------------------------------------------B----X------------------------------------??X?X??-o---
-------------------------------------------------------------------------------------X----T-X-----------------T----B------B-----------------------------BB-------BB-------------o----------B------------
--------------------------------------------X---------------------------------------------|--B---------------T|---X---------------------------------X----X--B------------------------BB-BBBBBBBB--------
------------------------------------------------------------------------------XXXXXXXT----|-------------T----||------------X-----B---------------?--?-???X??-------?-------X?------B------------X--X----
-------------------------------------------------------------------------------------|----|--------X--o-|----||-T-BBBBBBBB-----B-------------o---T-----T-XX--X-------------XX--------?------?T?????XX---
-------T-----------------------------------------------------------------------------|----|----------B--|----||-|---------X--X--------B----------|----B|XXXX-?T---??o??B?-TXXX-------B-------|--X--XXX-v
-------|----------------------------?------------------------------------------------|-X--|-----------MT|----||-|B---X-------XX---------????B?---|-XB--|XXXXX-|X----------|XXXX--------------|XXXTBXXXXf
-----B-|---------------------------------------------------------------------X-------|-B--|------------||----||-|o---XX------XXXTB---------X-----|-XXB-|XXXXXX|?-XB---X---|XXXXX--------X----|XXX|-XXXXf
----T--|-------------------------------------------B--------------------------------X|----|-?--?-------||B---||-|----XXX-----XXX|X---------XX----|-XXX-|XXXXXX|-XX-BBXXBB-|XXXXXX------XX-X-X|XXX|-XXXXf
----|--|-----------------------------------------------------------------------M----X|----|o-----------||----||X|XX--XXXX---XXXX|X--?------XXX---|-XXXX|XXXXXX|XXX--XTX---|XXXXXXX----XXXXXXX|XXX|-XXXXf
----|--|-----------------------------------------------------------------------X----T|X---|----------BB||BBB-||X|----XXXXXBX-XXX|XX-----o--XXXX--|-XXXX|XXXXXX|XXX-XX|X-?-|XXXXXXXX--XXXXXXXX|XXX|-XXXXf
----|--|-----------------------------------------------------------------------XX---||XX--|------------||X---||X|X---XXXXXX--XXX|XXX-------XXXXX-|-XXXX|XXXXXX|XXXXXX|X---|XXXXXXXXXXXXXXXXXX|XXX|-XXXXf
m---|--|-----------------------------EE------------E-E-------------------------XXX--||XXX-|-E-----E----||X---||X|XX--XXXXXXX-XXX|XXXX------XXXXXX|BXXXX|XXXXXX|XXXXXX|XE--|XXXXXXXXXXXXXXXXXX|XXX|EXXXXX
XXXX|XX|XXXXXXXXXXXXXXXXXXXXXXXXXXXXXXXXXXXXX----XXXXXXXXXXXXXXXXXXXXXXXXXXXXXXXXXXX||XXXX|BX---XXXXXXX||X---||X|XXX-XXXXXXXXXXX|XXXXX-----XXXXXX|-XXXX|XXXXXX|XXXXXX|XX--|XXXXXXXXXXXXXXXXXX|XXX|-XXXXX
