-----------------------------------------------------------------------------------------------------------------------------------------------------XXXXXX---------------------------------------------
----o----????????------------------------------------------------------------------------????????----------------BB--??-----------XXXXXXXX-?----?????-----------------?????-----------------------------
----------------------------------------------------------------------------------------------------------------------------????-------------??---BB??BBB------------------------B----------------------
------------------?-----------------BBBBB--??-----------------------------------------------------------------------------------------BBB????B-------------------------------------------------?--------
------BB-----------------------------------------------------------------------------M------------------------------------------------------------------------------??----------------------------------
-------------------------------------------------------------------------------------------------------------------??-----BBBB----------------------------XXXXBBBBBBBB------------------------??---XXX--
---------XXXX----------------------------------------------?----------------o-----------------------------------------------------------XXXX------------------------------------------------------------
-----XXXXXXX------------------------------------------------------------o---------------------------------------------------------------------------------------------------o-BBBBB-------------B------v
------------------------------------------------------------------------------------?????---------------------------------?--------------BB----------------------------------------------???????-------f
-------------------X--------------------------------------------------------------------------------------------------------------------------------------?----------------------------????????--------f
-------X------B----------------------------------------------------------------------------------------------------------------BBBBB-----------------X-------------------------------------------------f
------T-BBBBBBBB------------------------------------------------------------------------?----------------------------X--------------????????--------XX-------------------------------------------------f
------|--------------------------------------------------------------------------------------------------------------XX-------------------????-----XXX-----T-------------------------------------------f
-----B|--------XXX---------------------------------------------------------------------------------------------------XXX--------------------------XXXX-X---|-------------------------------------------f
mE----|E-----------------------------------------------------------------????----------------------------------------XXXX----XXXXXXX-----------BBXXXXXXX-BB|B-B--X-------------------------------------X
XXXXXX|XXXXXXXXXXXXXXXXXXXXXXXXXXXXXXXXXXXXXXXXXXXXXXXXXXXXXXXXXXXXXXXXXXXXXXXXXXXXXXXXXXXXXXXXXXXXXXXXXXXXXXXXXXXXXXXXXXXXXXXXXXXXXXXXXXXXXXXXXXXXXXXXXXXX|XXXXXXXXXXXXXXXXXXXXXXXXXXXXXXXXXXXXXXXXXXXX
