---B--B---oB----o-o------X-------B--B-B---o----oB------B---------oBo-BB-------------o-------------B--B----o-----Bo---B--o--o---B-B-B----oo---oB--B--------B--?o----B--------------B---B---------o--X--o-
----------------o-----------o---B----X-----------B------o------B--B--o------B------------o--o------------X-------Bo----oo-o---X-B--B---B-----------BB-oo-------o----X---------X------o--oB--oE--X-----X-
--B--o------------BB----------o-------X---B-------o-----B-------o--------o-----o-X-o-------o----X----o---T----o----X-o-o------B---B---------------o---B--------B-o---E---X----B-----------oo-------B----
----o-BE----E--oo-------o---ooB-------B---------B--------B------o-------B----o------------o-B----X-o---B-|--------X--o-B---oB--X-----B--o-X-----o-------------XB----o-X-oX-o---------B------------o--o--
----B-oX-X---------B-X-o-B------B---------o---B--o----BB----o--B-o------X---B---EBo---X-o-X-B--o---------|-Xo---X-------X-X-oB-----------------oo----oo-B--o-X----------o--X-BBX----T--B-o--o-----------
---B-B----B-B----------X-B-----B--------oB-------BoEB-----o------X-----o---X----B---o---B-o---B----------|-----------o--o-----o-----------B--oXo----------o-X-o--------------B---oXX|-----------B-------
---------o-----B--------B-------X-B----B---o-o----oo-E-----o--B--X------------B------XBo------B---X---o--|--------X----XX-----o-oB-----o--------XB-----B----X---o--X-B--------o-X---|---B-----oB---o--Bo
-o--------Boo------B-----o---B--------o-oo--B-------------X--------T--X--o--o--o------oo--------o--------|----------X-X---B----o------B-o------oB-B-------X--o--oX--o---o--B---o--o-|--E---------o---B-v
-?-----o--o--o--------------o---o--X----Xo--oB------X-ooB--B---o---|--------o--o----------------oo--o----|--o--B-----------------o-----------X-----------------o------o-o--o--------|----T---B-----o---f
---B-----B---T---X------BX-B--X----B------------o---oB---------X---|-------oo--oo--------o---o---B-------|-----o-----------Boo--------------B------E--B-------o----o----o--------Bo-|---B|-B------B----f
--------o--BB|--o---o---------o--o---------B-------X--B---T------oB|--B----------T--o-X----B--E---------o|--o-------oo--o----X--o---E-X------------o-------XX------------------oo-XX|----|-----------o-f
-------------|------BBo-----X---B-----B----E---------X--B-|---o---o|---o------B--|-----X-----EB----B----B|--o---------o---X-------o-Bo------------B--o--------X-B------o------------|----|-o-E-X--o-X-of
----B--------|--B-----T----------o--o------B--?------X----|--------|----------Bo-|---BT-------Bo------o--|-----------ooo--o----------B-o------o--oBX---T--o-------------------o--B--|---X|---B---X---Xof
---------B---|-----X--|-------o----E-----X--o----o-o--X---|-----T-o|-X-oB--------|-o--|-oo-----o-Xo------|--o---------o----oX----o---o--------o---o----|--B-------------------o----B|----|---Bo--B-----f
m------------|-XBo----|--o----X--E-Bo----------B---o--B-o-|--E-B|-X|---------X---|----|------o----X--X--X|----E--B-----ooo-----------X---X----X------o-|-----------E----E-E-----B---|----|---E-E--------
XXXXXXXXXXXXXXXXXXXXXXXXXXXXXXXXXXXXXXXXXXXXXXXXXXXXXXXXXXXXXXXXXXXXXXXXXXXXXXXXXXXXXXXXXXXXXXXXXXXXXXXXXXXXXXXXXXXXXXXXXXXXXXXXXXXXXXXXXXXXXXXXXXXXXXXXXXXXXXXXXXXXXXXXXXXXXXXXXXXXXXXXXXXXXXXXXXXXXXXX
