X-X---oo-o--o-----------------o----o-----X---------o-------o-B--o---------------oo-ooX-B--------------oo-o-o-------------o---o-------------B----o-oB--BX--oB---B----------o--o-B----------o-T--B-X-oX---
-o-o----o--o---B------------o---o--X-o--o----------------Bo---------X-------------oB-B--o---B---X--------------------B-----------BX-----------B---oB-o--B----o-B----B-----------------X-----|----oBB--E-
-o--------o----o-----------oB---o------oB--------------oB---BB--B-------o----------B-E-o---o------oo-------o------B---o-----B---oB-----o------o-----------------B---o----B-B-------B-------B|----o---oB-
X--------------B------B--o----oo-Bo-X---o-X------o---------B----o----------Eoo--B---X----o----B-o--------BE--o---------B---------E---X--B----o-------------o---EB----B-o-B---o----o----oB--B|---B-X-B-B-
---BBo---------o-B-----o-------------X------------X----XEo------o------o---B------B---o--B-B---------BB---X---------o-X----B--o-o------o--------------B---------X-----------o----X---Bo---B-|---B-------
-T---o-------------o-----o-o---o-Eo-----B--oo---o-------oBXBo---o-------Xo-o-o--o---B-------X--o-------o----oo-------B--B------------BB------------X--------B------o----o--B--o-------------|---T-------
B|---BooB-oo-X-----o--o----------B----o--------o--oo---BM--B----X------o-B---B--Bo-B-X-------BB-B----o-------o-o---------o---o----o-oo-----o-------o---o---o----o-----o----B------BX--------|-o-|-o----X
-|-o-------o--Bo------------X-B-o----B---------B--BB-------o----oo-----B----------o-BB----B--B-------o----o------o----o-------X--X-----o----B---B-----------------X--o--B-BXo---o----X------|--X|-Bo---v
B|-----------T----o---B----?----------o-------B-------B-------------------o----Bo-----------B------------B-----B--o-----o-----o-----o--o------------B----X-Bo-------o-----------B----BooX---|--o|---BX-f
-|----oX-----|-oB------------X--B-B-B-B----o-----B-o-----B---------o---------B----o---X----B-----------o--------------E-B------E---B------B--o-----------o-X----o----o------BX-----B--------|---|-B----f
o|-o---------|--XX---oo?--------oX--B------X---B---B--X----X-o-oo-o-------o-o-------B-o-------------B--------ooX------X-X---o---------o--------?B---oXB---o---B-o---------------------------|---|----B-f
-|---o----o--|---BB-------B------o------o----o-B---------B-o--BoB--B-------o-----X----X----oo-o-------------B-------------B----XX-------------o------------o----------X---o--Xo----?o--o----|-o-|------f
-|------B----|-B----o-Bo------Bo-o--B------o-----B------X--ooX----------Bo--Xo-X------o--------B------?-------T----X-----------B---E---oXX------o------o----B---------o----o-X-B--o--oXBoo--|---|------f
-|-----o-----|----E-o-----B----------o--B------o-oX-----E----XXoX--o-B-------o----X-----B------o---o-o-----E-o|-o-E--------B-------T-----XX-B--B----E--------B-B---------------XoB--X---oo--|-Bo|------f
m|----X------|--Xo-o----o---X---o-E---B-------------o-----o----B----Eo--oE--EB----B-o--o-----X-B---o-----EE--X|-----------o--B-----|----------o-----------o-----------Xo-o----XoB---o-B-----|-o-|-------
XXXXXXXXXXXXXXXXXXXXXXXXXXXXXXXXXXXXXXXXXXXXXXXXXXXXXXXXXXXXXXXXXXXXXXXXXXXXXXXXXXXXXXXXXXXXXXXXXXXXXXXXXXXXXXXXXXXXXXXXXXXXXXXXXXXXXXXXXXXXXXXXXXXXXXXXXXXXXXXXXXXXXXXXXXXXXXXXXXXXXXXXXXXXXXXXXXXXXXXX
