---------------------------------------------------------------------------------------------------------------------------------------------------oB---------------------------------------------------
-------------------------------------------------------------------------------------------------o-----------------------------------o------------------------------B--------------------------------B--
-------------------------------------------------------------------------o---B---B----------------------------------E---B--o----------------------------------------------------------------------B-----
----------------o------------BX-----X-----------------X------------------------------------------X-----------B------------------------------B---------------------------------X-----------------o-------
---X------------------B----------------------------------------o-----------B---------------------------B-o-B------X--------------------------------------------B----------------------------------------
----------------B---------B----------X-------------X-------------------------o--------------o---B---------------------------------------------------------------------B---------B-----E-B-----------o---
-----------------------------oB----------------------------B--------------------------X-------------------------------------------------------E-B-o-B-------B-------E---B-------------------------------
---B--------------------------------------B-------?------B-------------B--------------B----B--------X--------------------X---------X-------------------------------o-----------------------------------v
-------B-------E---------------------------B--------X---------B-----------------o---------------------------------------------------B--------B--B----------B-B---------------------E-------------------f
--------------------B------B-----B----------Bo-------------------------------o---------------?-------------B---------------BX-----------------------------------------------------------------------B--f
------------oo-------------------------------------------B------------------------------------------------o------B-----------X------------------------------------------B-------------------o----------f
--------------------E----------------B----------------------------------------------------------EB----------------------oX-------------------------------oo-----------------------E----X---------X-----f
-----------------------------------------------B--------------------------------------------------------B---------------------------------B------------------------------------------------------------f
----?---------------B--------B--------------------------------E------------B---------------B---------------------------------------------------------B----------------o---------------B---B------o-----f
m------------------E-----ET-------X----------------------B--E------------B------------o-----------------E-----B------------B-------------o---X-------E-o---------B------o-----------E------------B-----X
XXXXXXXXXXXXXXXXXXXXXXXXXXXXXXXXXXXXXXXXXXXXXXXXXXXXXXXXXXXXXXXXXXXXXXXXXXXXXXXXXXXXXXXXXXXXXXXXXXXXXXXXXXXXXXXXXXXXXXXXXXXXXXXXXXXXXXXXXXXXXXXXXXXXXXXXXXXXXXXXXXXXXXXXXXXXXXXXXXXXXXXXXXXXXXXXXXXXXXXX
