---------------------------------------------------------------------------------------------------------------------------------------------------------------------------------------XXXXXXXX-o-------
------------------------------------------------------------------------------------------------------------------------------------------------------------------------------------------------X-------
----------------------------------------X---------------X-----------------------------------------------------------------------------------------------------------------------------------X-----------
--------------------------????????----------X------------------------------------------------------------------------------------------------------------------------------------------------------?----
----------X---------------------------------------------------------------------------------------------------------------------------------------------------------------------------------B------X----
-------------------------------------------------------B-----------------------------------------------------------------------------------------------------------------------X----------------o-------
----------------????????X-------------------------------------------------------------------------------------------------------------------------------------------------X-X-------------------MTo-----
-------------------------------------------X-X-------------------------??------------------------------------------------------------------------------------------------------------------------|-----v
----------------------------------?----------------------------------------------------------------------------------------------------------------------------------------------XXX?XXXX-----BB-|----Xf
--------------????-----------------B----------------------------------------------------------------------------------------------------------------------------------------------X--------------|----Xf
----------------B---------------??------------------------------------------------------------------------------------------------------------------------------------------M--------------------|----Xf
----------------------X-------------------------------------------------------------------------------------------------------------------------------------------------------------------------T|-M-XXf
----------B----------XX--o---X------------------------------------------------------------------------------------------------------------------------------------------------------------------||--XXXf
-------------X------XXX-------------------------------------------------------------------------------------------------------------------------------------------------------------------M-----||-XXXXf
m-----------E------XXXX--E------------------------E--------------------------------B----------------------------------------------------------------------------------------?E---E-----E----E--E||XXXXXX
XXXXXXXXXXXXXXXX--XXXXX------------XXXXXXXXXXXXXXXXXXXXXXXXXXXXXXXXXXXXXXXXXXXXXXXXXXXXXXXXXXXXXXXXXXXXXXXXXXXXXXXXXXXXXXXXXXXXXXXXXXXXXXXXXXXXXXXXXXXXXXXXXXXXXXXXXXXXXXXXXXXXXXXXXXXXXXXXXXXXX||XXXXXX
