----------------------------X--------------------------B----------------------------X--------------------------------------------------------B----------------------------------------------------------
------------------------------------------X--------------------------------------------------------------------------------------------------X----------------X-----------------------------------------
-------------------------------------------------------------------------------------------------------------------------------------X------------------------------------------------------------------
-B----------------------------------------------------------------------------------------------B----------------------B-------------------------------------X---------------------------------o--------
--------------------------------------------------------------------------------------------------------------------------------------------------------------------B-----------------------------------
--X-------------------------------------------------------------------------X--------------------------B-------------------------------------------------------B------------------?---------------------
-------------------------------------------------------------------------------------------------------------B------B--------------B---------------------B--------B------------B------------------------
-X--------------------------------------------------------------------------------------------------------------------------X--------------------------------------------------------------------------v
--------------------------------B-------------------------------------------------------------------------B-------X------X---------------------------------B-------------------------------------------f
-----------------------------------------------------------o-----------o-------------------------------------------o--------------------------------X--------------------------------------------------f
-----------------------------------X------X--------------------------------------------------X----------------------B----------------B---o----------------------o--------------------------------------f
-----X------------------B----------------XX----------------------------------------------------------------------------B------o--------------------X--------------------BB-----------------------------f
----------------------------------------XXX----------------------------------------------------------------------o--------------------------X-----XX---------------------------------------------------f
---------T-----------------------------XXXX------B----------------------------------------------------------------------B------------------------XXX---------X--BB-------------------------------------f
m--------|----------------------------XXXXX-------Bo--------------------------------------E-------B--------------------------------B----------E-XXXX-----X---------------------------------------------X
XXXXXXXXX|XXXXXXXXXXXXXXXXXXXXXXXXXXXXXXXXXXXXXXXXXXXXXXXXXXXXXXXXXXXXXXXXXXXXXXXXXXXXXXXXXXXXXXXXXXX--XXXXXXXXXXXXXXXXXBXXXXXXXXXXXXXXXXXXXXXXXXXXXXXXXXXXXXXXXXXXXXXXXXXXXXXXXXXXXXXXXXXXXXXXXXXXXXXXX
